STATE/UT,Year,CAUSE,Male,Female,Transgender,Total
ANDHRA PRADESH,2001,Never Married,819,591,0,1410
ANDHRA PRADESH,2001,Married,5135,3135,0,8270
ANDHRA PRADESH,2001,Widowed/Widower,183,236,0,419
ANDHRA PRADESH,2001,Divorcee,47,43,0,90
ANDHRA PRADESH,2001,Seperated,195,138,0,333
ANDHRA PRADESH,2001,Total,6379,4143,0,10522
ANDHRA PRADESH,2002,Never Married,908,689,0,1597
ANDHRA PRADESH,2002,Married,5435,2503,0,7938
ANDHRA PRADESH,2002,Widowed/Widower,847,704,0,1551
ANDHRA PRADESH,2002,Divorcee,72,77,0,149
ANDHRA PRADESH,2002,Seperated,309,149,0,458
ANDHRA PRADESH,2002,Total,7571,4122,0,11693
ANDHRA PRADESH,2003,Never Married,1205,774,0,1979
ANDHRA PRADESH,2003,Married,5673,2633,0,8306
ANDHRA PRADESH,2003,Widowed/Widower,324,274,0,598
ANDHRA PRADESH,2003,Divorcee,88,58,0,146
ANDHRA PRADESH,2003,Seperated,223,157,0,380
ANDHRA PRADESH,2003,Total,7513,3896,0,11409
ANDHRA PRADESH,2004,Never Married,1464,675,0,2139
ANDHRA PRADESH,2004,Married,6577,3154,0,9731
ANDHRA PRADESH,2004,Widowed/Widower,321,232,0,553
ANDHRA PRADESH,2004,Divorcee,142,65,0,207
ANDHRA PRADESH,2004,Seperated,578,318,0,896
ANDHRA PRADESH,2004,Total,9082,4444,0,13526
ANDHRA PRADESH,2005,Never Married,1389,692,0,2081
ANDHRA PRADESH,2005,Married,6344,3114,0,9458
ANDHRA PRADESH,2005,Widowed/Widower,555,391,0,946
ANDHRA PRADESH,2005,Divorcee,83,46,0,129
ANDHRA PRADESH,2005,Seperated,494,334,0,828
ANDHRA PRADESH,2005,Total,8865,4577,0,13442
ANDHRA PRADESH,2006,Never Married,1393,840,0,2233
ANDHRA PRADESH,2006,Married,6847,3125,0,9972
ANDHRA PRADESH,2006,Widowed/Widower,256,252,0,508
ANDHRA PRADESH,2006,Divorcee,75,54,0,129
ANDHRA PRADESH,2006,Seperated,292,142,0,434
ANDHRA PRADESH,2006,Total,8863,4413,0,13276
ANDHRA PRADESH,2007,Never Married,1156,651,0,1807
ANDHRA PRADESH,2007,Married,7905,3505,0,11410
ANDHRA PRADESH,2007,Widowed/Widower,351,248,0,599
ANDHRA PRADESH,2007,Divorcee,72,66,0,138
ANDHRA PRADESH,2007,Seperated,465,463,0,928
ANDHRA PRADESH,2007,Total,9949,4933,0,14882
ANDHRA PRADESH,2008,Never Married,1533,834,0,2367
ANDHRA PRADESH,2008,Married,7357,3212,0,10569
ANDHRA PRADESH,2008,Widowed/Widower,442,362,0,804
ANDHRA PRADESH,2008,Divorcee,193,110,0,303
ANDHRA PRADESH,2008,Seperated,196,115,0,311
ANDHRA PRADESH,2008,Total,9721,4633,0,14354
ANDHRA PRADESH,2009,Never Married,1527,792,0,2319
ANDHRA PRADESH,2009,Married,7439,3340,0,10779
ANDHRA PRADESH,2009,Widowed/Widower,336,276,0,612
ANDHRA PRADESH,2009,Divorcee,164,83,0,247
ANDHRA PRADESH,2009,Seperated,421,122,0,543
ANDHRA PRADESH,2009,Total,9887,4613,0,14500
ANDHRA PRADESH,2010,Never Married,1506,669,0,2175
ANDHRA PRADESH,2010,Married,8659,3706,0,12365
ANDHRA PRADESH,2010,Widowed/Widower,315,290,0,605
ANDHRA PRADESH,2010,Divorcee,122,104,0,226
ANDHRA PRADESH,2010,Seperated,345,185,0,530
ANDHRA PRADESH,2010,Total,10947,4954,0,15901
ANDHRA PRADESH,2011,Never Married,1028,571,0,1599
ANDHRA PRADESH,2011,Married,8241,3779,0,12020
ANDHRA PRADESH,2011,Widowed/Widower,336,270,0,606
ANDHRA PRADESH,2011,Divorcee,95,97,0,192
ANDHRA PRADESH,2011,Seperated,420,240,0,660
ANDHRA PRADESH,2011,Total,10120,4957,0,15077
ANDHRA PRADESH,2012,Never Married,1136,685,0,1821
ANDHRA PRADESH,2012,Married,7813,3630,0,11443
ANDHRA PRADESH,2012,Widowed/Widower,261,210,0,471
ANDHRA PRADESH,2012,Divorcee,98,94,0,192
ANDHRA PRADESH,2012,Seperated,219,92,0,311
ANDHRA PRADESH,2012,Total,9527,4711,0,14238
ARUNACHAL PRADESH,2001,Never Married,12,10,0,22
ARUNACHAL PRADESH,2001,Married,64,22,0,86
ARUNACHAL PRADESH,2001,Widowed/Widower,0,2,0,2
ARUNACHAL PRADESH,2001,Divorcee,0,0,0,0
ARUNACHAL PRADESH,2001,Seperated,0,1,0,1
ARUNACHAL PRADESH,2001,Total,76,35,0,111
ARUNACHAL PRADESH,2002,Never Married,12,20,0,32
ARUNACHAL PRADESH,2002,Married,59,22,0,81
ARUNACHAL PRADESH,2002,Widowed/Widower,0,1,0,1
ARUNACHAL PRADESH,2002,Divorcee,0,0,0,0
ARUNACHAL PRADESH,2002,Seperated,0,0,0,0
ARUNACHAL PRADESH,2002,Total,71,43,0,114
ARUNACHAL PRADESH,2003,Never Married,11,7,0,18
ARUNACHAL PRADESH,2003,Married,41,20,0,61
ARUNACHAL PRADESH,2003,Widowed/Widower,1,0,0,1
ARUNACHAL PRADESH,2003,Divorcee,0,0,0,0
ARUNACHAL PRADESH,2003,Seperated,1,0,0,1
ARUNACHAL PRADESH,2003,Total,54,27,0,81
ARUNACHAL PRADESH,2004,Never Married,11,10,0,21
ARUNACHAL PRADESH,2004,Married,38,20,0,58
ARUNACHAL PRADESH,2004,Widowed/Widower,0,0,0,0
ARUNACHAL PRADESH,2004,Divorcee,0,0,0,0
ARUNACHAL PRADESH,2004,Seperated,0,0,0,0
ARUNACHAL PRADESH,2004,Total,49,30,0,79
ARUNACHAL PRADESH,2005,Never Married,18,7,0,25
ARUNACHAL PRADESH,2005,Married,31,14,0,45
ARUNACHAL PRADESH,2005,Widowed/Widower,0,0,0,0
ARUNACHAL PRADESH,2005,Divorcee,0,0,0,0
ARUNACHAL PRADESH,2005,Seperated,0,0,0,0
ARUNACHAL PRADESH,2005,Total,49,21,0,70
ARUNACHAL PRADESH,2006,Never Married,20,7,0,27
ARUNACHAL PRADESH,2006,Married,76,26,0,102
ARUNACHAL PRADESH,2006,Widowed/Widower,0,0,0,0
ARUNACHAL PRADESH,2006,Divorcee,0,0,0,0
ARUNACHAL PRADESH,2006,Seperated,0,0,0,0
ARUNACHAL PRADESH,2006,Total,96,33,0,129
ARUNACHAL PRADESH,2007,Never Married,33,14,0,47
ARUNACHAL PRADESH,2007,Married,65,17,0,82
ARUNACHAL PRADESH,2007,Widowed/Widower,0,0,0,0
ARUNACHAL PRADESH,2007,Divorcee,0,0,0,0
ARUNACHAL PRADESH,2007,Seperated,0,0,0,0
ARUNACHAL PRADESH,2007,Total,98,31,0,129
ARUNACHAL PRADESH,2008,Never Married,13,8,0,21
ARUNACHAL PRADESH,2008,Married,63,22,0,85
ARUNACHAL PRADESH,2008,Widowed/Widower,0,3,0,3
ARUNACHAL PRADESH,2008,Divorcee,1,0,0,1
ARUNACHAL PRADESH,2008,Seperated,0,0,0,0
ARUNACHAL PRADESH,2008,Total,77,33,0,110
ARUNACHAL PRADESH,2009,Never Married,15,9,0,24
ARUNACHAL PRADESH,2009,Married,61,21,0,82
ARUNACHAL PRADESH,2009,Widowed/Widower,0,3,0,3
ARUNACHAL PRADESH,2009,Divorcee,1,0,0,1
ARUNACHAL PRADESH,2009,Seperated,0,0,0,0
ARUNACHAL PRADESH,2009,Total,77,33,0,110
ARUNACHAL PRADESH,2010,Never Married,20,16,0,36
ARUNACHAL PRADESH,2010,Married,71,24,0,95
ARUNACHAL PRADESH,2010,Widowed/Widower,0,0,0,0
ARUNACHAL PRADESH,2010,Divorcee,0,0,0,0
ARUNACHAL PRADESH,2010,Seperated,0,0,0,0
ARUNACHAL PRADESH,2010,Total,91,40,0,131
ARUNACHAL PRADESH,2011,Never Married,38,12,0,50
ARUNACHAL PRADESH,2011,Married,61,23,0,84
ARUNACHAL PRADESH,2011,Widowed/Widower,0,0,0,0
ARUNACHAL PRADESH,2011,Divorcee,0,0,0,0
ARUNACHAL PRADESH,2011,Seperated,0,0,0,0
ARUNACHAL PRADESH,2011,Total,99,35,0,134
ARUNACHAL PRADESH,2012,Never Married,23,11,0,34
ARUNACHAL PRADESH,2012,Married,75,18,0,93
ARUNACHAL PRADESH,2012,Widowed/Widower,2,0,0,2
ARUNACHAL PRADESH,2012,Divorcee,0,1,0,1
ARUNACHAL PRADESH,2012,Seperated,0,0,0,0
ARUNACHAL PRADESH,2012,Total,100,30,0,130
ASSAM,2001,Never Married,634,263,0,897
ASSAM,2001,Married,1032,475,0,1507
ASSAM,2001,Widowed/Widower,36,27,0,63
ASSAM,2001,Divorcee,21,12,0,33
ASSAM,2001,Seperated,113,34,0,147
ASSAM,2001,Total,1836,811,0,2647
ASSAM,2002,Never Married,533,225,0,758
ASSAM,2002,Married,927,466,0,1393
ASSAM,2002,Widowed/Widower,57,40,0,97
ASSAM,2002,Divorcee,44,25,0,69
ASSAM,2002,Seperated,141,52,0,193
ASSAM,2002,Total,1702,808,0,2510
ASSAM,2003,Never Married,466,273,0,739
ASSAM,2003,Married,770,434,0,1204
ASSAM,2003,Widowed/Widower,197,106,0,303
ASSAM,2003,Divorcee,43,13,0,56
ASSAM,2003,Seperated,200,94,0,294
ASSAM,2003,Total,1676,920,0,2596
ASSAM,2004,Never Married,590,233,0,823
ASSAM,2004,Married,1076,499,0,1575
ASSAM,2004,Widowed/Widower,46,37,0,83
ASSAM,2004,Divorcee,21,13,0,34
ASSAM,2004,Seperated,212,112,0,324
ASSAM,2004,Total,1945,894,0,2839
ASSAM,2005,Never Married,559,278,0,837
ASSAM,2005,Married,1149,491,0,1640
ASSAM,2005,Widowed/Widower,87,38,0,125
ASSAM,2005,Divorcee,27,11,0,38
ASSAM,2005,Seperated,129,77,0,206
ASSAM,2005,Total,1951,895,0,2846
ASSAM,2006,Never Married,648,287,0,935
ASSAM,2006,Married,1274,533,0,1807
ASSAM,2006,Widowed/Widower,69,37,0,106
ASSAM,2006,Divorcee,23,11,0,34
ASSAM,2006,Seperated,102,47,0,149
ASSAM,2006,Total,2116,915,0,3031
ASSAM,2007,Never Married,619,331,0,950
ASSAM,2007,Married,1249,514,0,1763
ASSAM,2007,Widowed/Widower,67,62,0,129
ASSAM,2007,Divorcee,38,14,0,52
ASSAM,2007,Seperated,143,25,0,168
ASSAM,2007,Total,2116,946,0,3062
ASSAM,2008,Never Married,496,249,0,745
ASSAM,2008,Married,1146,579,0,1725
ASSAM,2008,Widowed/Widower,91,95,0,186
ASSAM,2008,Divorcee,47,24,0,71
ASSAM,2008,Seperated,190,72,0,262
ASSAM,2008,Total,1970,1019,0,2989
ASSAM,2009,Never Married,633,337,0,970
ASSAM,2009,Married,1119,652,0,1771
ASSAM,2009,Widowed/Widower,32,25,0,57
ASSAM,2009,Divorcee,4,19,0,23
ASSAM,2009,Seperated,94,51,0,145
ASSAM,2009,Total,1882,1084,0,2966
ASSAM,2010,Never Married,582,252,0,834
ASSAM,2010,Married,1267,565,0,1832
ASSAM,2010,Widowed/Widower,16,22,0,38
ASSAM,2010,Divorcee,12,21,0,33
ASSAM,2010,Seperated,149,107,0,256
ASSAM,2010,Total,2026,967,0,2993
ASSAM,2011,Never Married,577,202,0,779
ASSAM,2011,Married,1097,546,0,1643
ASSAM,2011,Widowed/Widower,34,63,0,97
ASSAM,2011,Divorcee,22,23,0,45
ASSAM,2011,Seperated,96,66,0,162
ASSAM,2011,Total,1826,900,0,2726
ASSAM,2012,Never Married,673,217,0,890
ASSAM,2012,Married,1600,579,0,2179
ASSAM,2012,Widowed/Widower,34,27,0,61
ASSAM,2012,Divorcee,21,25,0,46
ASSAM,2012,Seperated,64,24,0,88
ASSAM,2012,Total,2392,872,0,3264
BIHAR,2001,Never Married,107,84,0,191
BIHAR,2001,Married,162,170,0,332
BIHAR,2001,Widowed/Widower,17,26,0,43
BIHAR,2001,Divorcee,7,4,0,11
BIHAR,2001,Seperated,14,12,0,26
BIHAR,2001,Total,307,296,0,603
BIHAR,2002,Never Married,135,69,0,204
BIHAR,2002,Married,261,203,0,464
BIHAR,2002,Widowed/Widower,9,16,0,25
BIHAR,2002,Divorcee,8,2,0,10
BIHAR,2002,Seperated,13,4,0,17
BIHAR,2002,Total,426,294,0,720
BIHAR,2003,Never Married,113,63,0,176
BIHAR,2003,Married,217,155,0,372
BIHAR,2003,Widowed/Widower,11,10,0,21
BIHAR,2003,Divorcee,3,6,0,9
BIHAR,2003,Seperated,7,14,0,21
BIHAR,2003,Total,351,248,0,599
BIHAR,2004,Never Married,53,28,0,81
BIHAR,2004,Married,136,98,0,234
BIHAR,2004,Widowed/Widower,20,12,0,32
BIHAR,2004,Divorcee,1,1,0,2
BIHAR,2004,Seperated,2,0,0,2
BIHAR,2004,Total,212,139,0,351
BIHAR,2005,Never Married,78,39,0,117
BIHAR,2005,Married,223,163,0,386
BIHAR,2005,Widowed/Widower,18,4,0,22
BIHAR,2005,Divorcee,4,7,0,11
BIHAR,2005,Seperated,4,3,0,7
BIHAR,2005,Total,327,216,0,543
BIHAR,2006,Never Married,91,72,0,163
BIHAR,2006,Married,151,197,0,348
BIHAR,2006,Widowed/Widower,26,32,0,58
BIHAR,2006,Divorcee,8,7,0,15
BIHAR,2006,Seperated,23,11,0,34
BIHAR,2006,Total,299,319,0,618
BIHAR,2007,Never Married,173,133,0,306
BIHAR,2007,Married,310,246,0,556
BIHAR,2007,Widowed/Widower,38,30,0,68
BIHAR,2007,Divorcee,1,16,0,17
BIHAR,2007,Seperated,12,6,0,18
BIHAR,2007,Total,534,431,0,965
BIHAR,2008,Never Married,174,107,0,281
BIHAR,2008,Married,361,256,0,617
BIHAR,2008,Widowed/Widower,32,21,0,53
BIHAR,2008,Divorcee,15,10,0,25
BIHAR,2008,Seperated,27,12,0,39
BIHAR,2008,Total,609,406,0,1015
BIHAR,2009,Never Married,155,112,0,267
BIHAR,2009,Married,327,389,0,716
BIHAR,2009,Widowed/Widower,25,32,0,57
BIHAR,2009,Divorcee,5,3,0,8
BIHAR,2009,Seperated,2,1,0,3
BIHAR,2009,Total,514,537,0,1051
BIHAR,2010,Never Married,155,149,0,304
BIHAR,2010,Married,495,283,0,778
BIHAR,2010,Widowed/Widower,20,33,0,53
BIHAR,2010,Divorcee,12,8,0,20
BIHAR,2010,Seperated,30,41,0,71
BIHAR,2010,Total,712,514,0,1226
BIHAR,2011,Never Married,125,85,0,210
BIHAR,2011,Married,281,229,0,510
BIHAR,2011,Widowed/Widower,24,14,0,38
BIHAR,2011,Divorcee,0,4,0,4
BIHAR,2011,Seperated,16,17,0,33
BIHAR,2011,Total,446,349,0,795
BIHAR,2012,Never Married,95,82,0,177
BIHAR,2012,Married,316,198,0,514
BIHAR,2012,Widowed/Widower,24,8,0,32
BIHAR,2012,Divorcee,0,0,0,0
BIHAR,2012,Seperated,20,16,0,36
BIHAR,2012,Total,455,304,0,759
CHHATTISGARH,2001,Never Married,539,291,0,830
CHHATTISGARH,2001,Married,1979,1014,0,2993
CHHATTISGARH,2001,Widowed/Widower,104,65,0,169
CHHATTISGARH,2001,Divorcee,9,7,0,16
CHHATTISGARH,2001,Seperated,9,8,0,17
CHHATTISGARH,2001,Total,2640,1385,0,4025
CHHATTISGARH,2002,Never Married,498,295,0,793
CHHATTISGARH,2002,Married,1957,945,0,2902
CHHATTISGARH,2002,Widowed/Widower,139,67,0,206
CHHATTISGARH,2002,Divorcee,25,7,0,32
CHHATTISGARH,2002,Seperated,10,7,0,17
CHHATTISGARH,2002,Total,2629,1321,0,3950
CHHATTISGARH,2003,Never Married,544,312,0,856
CHHATTISGARH,2003,Married,1854,846,0,2700
CHHATTISGARH,2003,Widowed/Widower,182,154,0,336
CHHATTISGARH,2003,Divorcee,2,3,0,5
CHHATTISGARH,2003,Seperated,10,12,0,22
CHHATTISGARH,2003,Total,2592,1327,0,3919
CHHATTISGARH,2004,Never Married,647,367,0,1014
CHHATTISGARH,2004,Married,2247,1028,0,3275
CHHATTISGARH,2004,Widowed/Widower,56,84,0,140
CHHATTISGARH,2004,Divorcee,3,8,0,11
CHHATTISGARH,2004,Seperated,33,22,0,55
CHHATTISGARH,2004,Total,2986,1509,0,4495
CHHATTISGARH,2005,Never Married,519,332,0,851
CHHATTISGARH,2005,Married,2672,1130,0,3802
CHHATTISGARH,2005,Widowed/Widower,82,78,0,160
CHHATTISGARH,2005,Divorcee,15,10,0,25
CHHATTISGARH,2005,Seperated,17,26,0,43
CHHATTISGARH,2005,Total,3305,1576,0,4881
CHHATTISGARH,2006,Never Married,766,431,0,1197
CHHATTISGARH,2006,Married,2216,1047,0,3263
CHHATTISGARH,2006,Widowed/Widower,70,83,0,153
CHHATTISGARH,2006,Divorcee,0,0,0,0
CHHATTISGARH,2006,Seperated,8,5,0,13
CHHATTISGARH,2006,Total,3060,1566,0,4626
CHHATTISGARH,2007,Never Married,646,327,0,973
CHHATTISGARH,2007,Married,2520,1179,0,3699
CHHATTISGARH,2007,Widowed/Widower,78,69,0,147
CHHATTISGARH,2007,Divorcee,2,3,0,5
CHHATTISGARH,2007,Seperated,10,5,0,15
CHHATTISGARH,2007,Total,3256,1583,0,4839
CHHATTISGARH,2008,Never Married,698,379,0,1077
CHHATTISGARH,2008,Married,2430,1149,0,3579
CHHATTISGARH,2008,Widowed/Widower,93,148,0,241
CHHATTISGARH,2008,Divorcee,4,6,0,10
CHHATTISGARH,2008,Seperated,23,15,0,38
CHHATTISGARH,2008,Total,3248,1697,0,4945
CHHATTISGARH,2009,Never Married,746,408,0,1154
CHHATTISGARH,2009,Married,3106,1365,0,4471
CHHATTISGARH,2009,Widowed/Widower,89,135,0,224
CHHATTISGARH,2009,Divorcee,2,7,0,9
CHHATTISGARH,2009,Seperated,11,14,0,25
CHHATTISGARH,2009,Total,3954,1929,0,5883
CHHATTISGARH,2010,Never Married,1381,641,0,2022
CHHATTISGARH,2010,Married,3064,1210,0,4274
CHHATTISGARH,2010,Widowed/Widower,89,120,0,209
CHHATTISGARH,2010,Divorcee,2,2,0,4
CHHATTISGARH,2010,Seperated,9,4,0,13
CHHATTISGARH,2010,Total,4545,1977,0,6522
CHHATTISGARH,2011,Never Married,1491,690,0,2181
CHHATTISGARH,2011,Married,2865,1366,0,4231
CHHATTISGARH,2011,Widowed/Widower,116,118,0,234
CHHATTISGARH,2011,Divorcee,12,12,0,24
CHHATTISGARH,2011,Seperated,43,43,0,86
CHHATTISGARH,2011,Total,4527,2229,0,6756
CHHATTISGARH,2012,Never Married,1085,456,0,1541
CHHATTISGARH,2012,Married,2696,1053,0,3749
CHHATTISGARH,2012,Widowed/Widower,137,77,0,214
CHHATTISGARH,2012,Divorcee,34,22,0,56
CHHATTISGARH,2012,Seperated,62,32,0,94
CHHATTISGARH,2012,Total,4014,1640,0,5654
GOA,2001,Never Married,60,29,0,89
GOA,2001,Married,98,55,0,153
GOA,2001,Widowed/Widower,4,5,0,9
GOA,2001,Divorcee,0,0,0,0
GOA,2001,Seperated,5,0,0,5
GOA,2001,Total,167,89,0,256
GOA,2002,Never Married,101,30,0,131
GOA,2002,Married,122,47,0,169
GOA,2002,Widowed/Widower,3,5,0,8
GOA,2002,Divorcee,0,0,0,0
GOA,2002,Seperated,0,1,0,1
GOA,2002,Total,226,83,0,309
GOA,2003,Never Married,92,32,0,124
GOA,2003,Married,115,53,0,168
GOA,2003,Widowed/Widower,6,2,0,8
GOA,2003,Divorcee,0,0,0,0
GOA,2003,Seperated,0,0,0,0
GOA,2003,Total,213,87,0,300
GOA,2004,Never Married,87,34,0,121
GOA,2004,Married,123,65,0,188
GOA,2004,Widowed/Widower,1,3,0,4
GOA,2004,Divorcee,0,0,0,0
GOA,2004,Seperated,1,0,0,1
GOA,2004,Total,212,102,0,314
GOA,2005,Never Married,82,32,0,114
GOA,2005,Married,114,50,0,164
GOA,2005,Widowed/Widower,1,2,0,3
GOA,2005,Divorcee,0,0,0,0
GOA,2005,Seperated,0,1,0,1
GOA,2005,Total,197,85,0,282
GOA,2006,Never Married,74,36,0,110
GOA,2006,Married,106,51,0,157
GOA,2006,Widowed/Widower,3,5,0,8
GOA,2006,Divorcee,0,0,0,0
GOA,2006,Seperated,0,0,0,0
GOA,2006,Total,183,92,0,275
GOA,2007,Never Married,66,28,0,94
GOA,2007,Married,111,58,0,169
GOA,2007,Widowed/Widower,1,6,0,7
GOA,2007,Divorcee,0,0,0,0
GOA,2007,Seperated,0,0,0,0
GOA,2007,Total,178,92,0,270
GOA,2008,Never Married,65,34,0,99
GOA,2008,Married,105,64,0,169
GOA,2008,Widowed/Widower,1,3,0,4
GOA,2008,Divorcee,6,3,0,9
GOA,2008,Seperated,6,0,0,6
GOA,2008,Total,183,104,0,287
GOA,2009,Never Married,70,31,0,101
GOA,2009,Married,99,58,0,157
GOA,2009,Widowed/Widower,2,4,0,6
GOA,2009,Divorcee,6,1,0,7
GOA,2009,Seperated,7,0,0,7
GOA,2009,Total,184,94,0,278
GOA,2010,Never Married,88,27,0,115
GOA,2010,Married,127,55,0,182
GOA,2010,Widowed/Widower,3,3,0,6
GOA,2010,Divorcee,1,0,0,1
GOA,2010,Seperated,17,1,0,18
GOA,2010,Total,236,86,0,322
GOA,2011,Never Married,78,38,0,116
GOA,2011,Married,117,57,0,174
GOA,2011,Widowed/Widower,0,2,0,2
GOA,2011,Divorcee,0,1,0,1
GOA,2011,Seperated,0,0,0,0
GOA,2011,Total,195,98,0,293
GOA,2012,Never Married,72,30,0,102
GOA,2012,Married,112,58,0,170
GOA,2012,Widowed/Widower,10,5,0,15
GOA,2012,Divorcee,2,0,0,2
GOA,2012,Seperated,0,0,0,0
GOA,2012,Total,196,93,0,289
GUJARAT,2001,Never Married,581,449,0,1030
GUJARAT,2001,Married,1948,1562,0,3510
GUJARAT,2001,Widowed/Widower,89,109,0,198
GUJARAT,2001,Divorcee,13,12,0,25
GUJARAT,2001,Seperated,18,10,0,28
GUJARAT,2001,Total,2649,2142,0,4791
GUJARAT,2002,Never Married,612,439,0,1051
GUJARAT,2002,Married,1952,1381,0,3333
GUJARAT,2002,Widowed/Widower,93,95,0,188
GUJARAT,2002,Divorcee,18,8,0,26
GUJARAT,2002,Seperated,31,15,0,46
GUJARAT,2002,Total,2706,1938,0,4644
GUJARAT,2003,Never Married,505,369,0,874
GUJARAT,2003,Married,1963,1395,0,3358
GUJARAT,2003,Widowed/Widower,113,110,0,223
GUJARAT,2003,Divorcee,35,27,0,62
GUJARAT,2003,Seperated,34,15,0,49
GUJARAT,2003,Total,2650,1916,0,4566
GUJARAT,2004,Never Married,589,376,0,965
GUJARAT,2004,Married,2049,1397,0,3446
GUJARAT,2004,Widowed/Widower,104,101,0,205
GUJARAT,2004,Divorcee,37,31,0,68
GUJARAT,2004,Seperated,71,21,0,92
GUJARAT,2004,Total,2850,1926,0,4776
GUJARAT,2005,Never Married,548,396,0,944
GUJARAT,2005,Married,2092,1294,0,3386
GUJARAT,2005,Widowed/Widower,160,124,0,284
GUJARAT,2005,Divorcee,28,20,0,48
GUJARAT,2005,Seperated,74,29,0,103
GUJARAT,2005,Total,2902,1863,0,4765
GUJARAT,2006,Never Married,657,474,0,1131
GUJARAT,2006,Married,2120,1333,0,3453
GUJARAT,2006,Widowed/Widower,156,120,0,276
GUJARAT,2006,Divorcee,41,36,0,77
GUJARAT,2006,Seperated,74,24,0,98
GUJARAT,2006,Total,3048,1987,0,5035
GUJARAT,2007,Never Married,652,444,0,1096
GUJARAT,2007,Married,2451,1549,0,4000
GUJARAT,2007,Widowed/Widower,131,126,0,257
GUJARAT,2007,Divorcee,47,49,0,96
GUJARAT,2007,Seperated,94,37,0,131
GUJARAT,2007,Total,3375,2205,0,5580
GUJARAT,2008,Never Married,776,483,0,1259
GUJARAT,2008,Married,2723,1754,0,4477
GUJARAT,2008,Widowed/Widower,125,118,0,243
GUJARAT,2008,Divorcee,36,49,0,85
GUJARAT,2008,Seperated,75,26,0,101
GUJARAT,2008,Total,3735,2430,0,6165
GUJARAT,2009,Never Married,707,489,0,1196
GUJARAT,2009,Married,2693,1800,0,4493
GUJARAT,2009,Widowed/Widower,152,121,0,273
GUJARAT,2009,Divorcee,53,54,0,107
GUJARAT,2009,Seperated,66,21,0,87
GUJARAT,2009,Total,3671,2485,0,6156
GUJARAT,2010,Never Married,818,557,0,1375
GUJARAT,2010,Married,2683,1613,0,4296
GUJARAT,2010,Widowed/Widower,171,142,0,313
GUJARAT,2010,Divorcee,50,57,0,107
GUJARAT,2010,Seperated,91,25,0,116
GUJARAT,2010,Total,3813,2394,0,6207
GUJARAT,2011,Never Married,838,591,0,1429
GUJARAT,2011,Married,2732,1709,0,4441
GUJARAT,2011,Widowed/Widower,225,115,0,340
GUJARAT,2011,Divorcee,50,34,0,84
GUJARAT,2011,Seperated,67,21,0,88
GUJARAT,2011,Total,3912,2470,0,6382
GUJARAT,2012,Never Married,984,641,0,1625
GUJARAT,2012,Married,3047,1903,0,4950
GUJARAT,2012,Widowed/Widower,184,130,0,314
GUJARAT,2012,Divorcee,63,47,0,110
GUJARAT,2012,Seperated,84,27,0,111
GUJARAT,2012,Total,4362,2748,0,7110
HARYANA,2001,Never Married,228,76,0,304
HARYANA,2001,Married,1008,487,0,1495
HARYANA,2001,Widowed/Widower,74,40,0,114
HARYANA,2001,Divorcee,10,24,0,34
HARYANA,2001,Seperated,44,16,0,60
HARYANA,2001,Total,1364,643,0,2007
HARYANA,2002,Never Married,214,76,0,290
HARYANA,2002,Married,1252,511,0,1763
HARYANA,2002,Widowed/Widower,53,19,0,72
HARYANA,2002,Divorcee,11,14,0,25
HARYANA,2002,Seperated,40,10,0,50
HARYANA,2002,Total,1570,630,0,2200
HARYANA,2003,Never Married,257,99,0,356
HARYANA,2003,Married,1246,449,0,1695
HARYANA,2003,Widowed/Widower,55,30,0,85
HARYANA,2003,Divorcee,12,24,0,36
HARYANA,2003,Seperated,43,12,0,55
HARYANA,2003,Total,1613,614,0,2227
HARYANA,2004,Never Married,218,81,0,299
HARYANA,2004,Married,1163,474,0,1637
HARYANA,2004,Widowed/Widower,47,25,0,72
HARYANA,2004,Divorcee,8,16,0,24
HARYANA,2004,Seperated,18,32,0,50
HARYANA,2004,Total,1454,628,0,2082
HARYANA,2005,Never Married,227,70,0,297
HARYANA,2005,Married,1180,460,0,1640
HARYANA,2005,Widowed/Widower,56,18,0,74
HARYANA,2005,Divorcee,8,1,0,9
HARYANA,2005,Seperated,22,4,0,26
HARYANA,2005,Total,1493,553,0,2046
HARYANA,2006,Never Married,314,106,0,420
HARYANA,2006,Married,1342,407,0,1749
HARYANA,2006,Widowed/Widower,81,28,0,109
HARYANA,2006,Divorcee,4,5,0,9
HARYANA,2006,Seperated,25,4,0,29
HARYANA,2006,Total,1766,550,0,2316
HARYANA,2007,Never Married,384,106,0,490
HARYANA,2007,Married,1370,428,0,1798
HARYANA,2007,Widowed/Widower,69,37,0,106
HARYANA,2007,Divorcee,8,5,0,13
HARYANA,2007,Seperated,21,5,0,26
HARYANA,2007,Total,1852,581,0,2433
HARYANA,2008,Never Married,342,139,0,481
HARYANA,2008,Married,1492,479,0,1971
HARYANA,2008,Widowed/Widower,96,52,0,148
HARYANA,2008,Divorcee,19,8,0,27
HARYANA,2008,Seperated,25,4,0,29
HARYANA,2008,Total,1974,682,0,2656
HARYANA,2009,Never Married,317,121,0,438
HARYANA,2009,Married,1381,518,0,1899
HARYANA,2009,Widowed/Widower,87,38,0,125
HARYANA,2009,Divorcee,10,3,0,13
HARYANA,2009,Seperated,20,8,0,28
HARYANA,2009,Total,1815,688,0,2503
HARYANA,2010,Never Married,337,133,0,470
HARYANA,2010,Married,1434,488,0,1922
HARYANA,2010,Widowed/Widower,76,43,0,119
HARYANA,2010,Divorcee,8,3,0,11
HARYANA,2010,Seperated,323,50,0,373
HARYANA,2010,Total,2178,717,0,2895
HARYANA,2011,Never Married,651,202,0,853
HARYANA,2011,Married,1676,509,0,2185
HARYANA,2011,Widowed/Widower,124,61,0,185
HARYANA,2011,Divorcee,7,6,0,13
HARYANA,2011,Seperated,6,3,0,9
HARYANA,2011,Total,2464,781,0,3245
HARYANA,2012,Never Married,550,155,0,705
HARYANA,2012,Married,1371,528,0,1899
HARYANA,2012,Widowed/Widower,105,42,0,147
HARYANA,2012,Divorcee,6,5,0,11
HARYANA,2012,Seperated,39,26,0,65
HARYANA,2012,Total,2071,756,0,2827
HIMACHAL PRADESH,2001,Never Married,42,28,0,70
HIMACHAL PRADESH,2001,Married,126,94,0,220
HIMACHAL PRADESH,2001,Widowed/Widower,2,2,0,4
HIMACHAL PRADESH,2001,Divorcee,3,3,0,6
HIMACHAL PRADESH,2001,Seperated,4,3,0,7
HIMACHAL PRADESH,2001,Total,177,130,0,307
HIMACHAL PRADESH,2002,Never Married,59,25,0,84
HIMACHAL PRADESH,2002,Married,140,93,0,233
HIMACHAL PRADESH,2002,Widowed/Widower,4,7,0,11
HIMACHAL PRADESH,2002,Divorcee,1,1,0,2
HIMACHAL PRADESH,2002,Seperated,4,0,0,4
HIMACHAL PRADESH,2002,Total,208,126,0,334
HIMACHAL PRADESH,2003,Never Married,64,38,0,102
HIMACHAL PRADESH,2003,Married,162,102,0,264
HIMACHAL PRADESH,2003,Widowed/Widower,6,2,0,8
HIMACHAL PRADESH,2003,Divorcee,0,2,0,2
HIMACHAL PRADESH,2003,Seperated,8,2,0,10
HIMACHAL PRADESH,2003,Total,240,146,0,386
HIMACHAL PRADESH,2004,Never Married,70,30,0,100
HIMACHAL PRADESH,2004,Married,148,94,0,242
HIMACHAL PRADESH,2004,Widowed/Widower,12,7,0,19
HIMACHAL PRADESH,2004,Divorcee,4,1,0,5
HIMACHAL PRADESH,2004,Seperated,2,3,0,5
HIMACHAL PRADESH,2004,Total,236,135,0,371
HIMACHAL PRADESH,2005,Never Married,69,39,0,108
HIMACHAL PRADESH,2005,Married,119,86,0,205
HIMACHAL PRADESH,2005,Widowed/Widower,2,5,0,7
HIMACHAL PRADESH,2005,Divorcee,5,2,0,7
HIMACHAL PRADESH,2005,Seperated,19,13,0,32
HIMACHAL PRADESH,2005,Total,214,145,0,359
HIMACHAL PRADESH,2006,Never Married,82,50,0,132
HIMACHAL PRADESH,2006,Married,212,99,0,311
HIMACHAL PRADESH,2006,Widowed/Widower,3,4,0,7
HIMACHAL PRADESH,2006,Divorcee,0,0,0,0
HIMACHAL PRADESH,2006,Seperated,4,3,0,7
HIMACHAL PRADESH,2006,Total,301,156,0,457
HIMACHAL PRADESH,2007,Never Married,65,38,0,103
HIMACHAL PRADESH,2007,Married,188,100,0,288
HIMACHAL PRADESH,2007,Widowed/Widower,1,5,0,6
HIMACHAL PRADESH,2007,Divorcee,1,0,0,1
HIMACHAL PRADESH,2007,Seperated,3,1,0,4
HIMACHAL PRADESH,2007,Total,258,144,0,402
HIMACHAL PRADESH,2008,Never Married,85,48,0,133
HIMACHAL PRADESH,2008,Married,310,147,0,457
HIMACHAL PRADESH,2008,Widowed/Widower,10,14,0,24
HIMACHAL PRADESH,2008,Divorcee,3,0,0,3
HIMACHAL PRADESH,2008,Seperated,9,4,0,13
HIMACHAL PRADESH,2008,Total,417,213,0,630
HIMACHAL PRADESH,2009,Never Married,79,44,0,123
HIMACHAL PRADESH,2009,Married,266,136,0,402
HIMACHAL PRADESH,2009,Widowed/Widower,17,11,0,28
HIMACHAL PRADESH,2009,Divorcee,0,0,0,0
HIMACHAL PRADESH,2009,Seperated,4,3,0,7
HIMACHAL PRADESH,2009,Total,366,194,0,560
HIMACHAL PRADESH,2010,Never Married,91,55,0,146
HIMACHAL PRADESH,2010,Married,238,124,0,362
HIMACHAL PRADESH,2010,Widowed/Widower,13,8,0,21
HIMACHAL PRADESH,2010,Divorcee,1,0,0,1
HIMACHAL PRADESH,2010,Seperated,5,7,0,12
HIMACHAL PRADESH,2010,Total,348,194,0,542
HIMACHAL PRADESH,2011,Never Married,73,49,0,122
HIMACHAL PRADESH,2011,Married,188,114,0,302
HIMACHAL PRADESH,2011,Widowed/Widower,3,3,0,6
HIMACHAL PRADESH,2011,Divorcee,0,0,0,0
HIMACHAL PRADESH,2011,Seperated,5,8,0,13
HIMACHAL PRADESH,2011,Total,269,174,0,443
HIMACHAL PRADESH,2012,Never Married,91,37,0,128
HIMACHAL PRADESH,2012,Married,237,113,0,350
HIMACHAL PRADESH,2012,Widowed/Widower,10,9,0,19
HIMACHAL PRADESH,2012,Divorcee,4,2,0,6
HIMACHAL PRADESH,2012,Seperated,12,13,0,25
HIMACHAL PRADESH,2012,Total,354,174,0,528
JAMMU & KASHMIR,2001,Never Married,11,15,0,26
JAMMU & KASHMIR,2001,Married,74,45,0,119
JAMMU & KASHMIR,2001,Widowed/Widower,6,2,0,8
JAMMU & KASHMIR,2001,Divorcee,0,0,0,0
JAMMU & KASHMIR,2001,Seperated,0,0,0,0
JAMMU & KASHMIR,2001,Total,91,62,0,153
JAMMU & KASHMIR,2002,Never Married,22,18,0,40
JAMMU & KASHMIR,2002,Married,63,60,0,123
JAMMU & KASHMIR,2002,Widowed/Widower,5,2,0,7
JAMMU & KASHMIR,2002,Divorcee,1,5,0,6
JAMMU & KASHMIR,2002,Seperated,5,3,0,8
JAMMU & KASHMIR,2002,Total,96,88,0,184
JAMMU & KASHMIR,2003,Never Married,21,19,0,40
JAMMU & KASHMIR,2003,Married,34,43,0,77
JAMMU & KASHMIR,2003,Widowed/Widower,2,5,0,7
JAMMU & KASHMIR,2003,Divorcee,3,2,0,5
JAMMU & KASHMIR,2003,Seperated,3,6,0,9
JAMMU & KASHMIR,2003,Total,63,75,0,138
JAMMU & KASHMIR,2004,Never Married,15,15,0,30
JAMMU & KASHMIR,2004,Married,31,44,0,75
JAMMU & KASHMIR,2004,Widowed/Widower,3,0,0,3
JAMMU & KASHMIR,2004,Divorcee,0,0,0,0
JAMMU & KASHMIR,2004,Seperated,2,2,0,4
JAMMU & KASHMIR,2004,Total,51,61,0,112
JAMMU & KASHMIR,2005,Never Married,56,23,0,79
JAMMU & KASHMIR,2005,Married,112,58,0,170
JAMMU & KASHMIR,2005,Widowed/Widower,0,3,0,3
JAMMU & KASHMIR,2005,Divorcee,0,2,0,2
JAMMU & KASHMIR,2005,Seperated,28,12,0,40
JAMMU & KASHMIR,2005,Total,196,98,0,294
JAMMU & KASHMIR,2006,Never Married,53,42,0,95
JAMMU & KASHMIR,2006,Married,95,58,0,153
JAMMU & KASHMIR,2006,Widowed/Widower,0,3,0,3
JAMMU & KASHMIR,2006,Divorcee,0,5,0,5
JAMMU & KASHMIR,2006,Seperated,4,2,0,6
JAMMU & KASHMIR,2006,Total,152,110,0,262
JAMMU & KASHMIR,2007,Never Married,50,23,0,73
JAMMU & KASHMIR,2007,Married,101,54,0,155
JAMMU & KASHMIR,2007,Widowed/Widower,0,2,0,2
JAMMU & KASHMIR,2007,Divorcee,0,2,0,2
JAMMU & KASHMIR,2007,Seperated,2,0,0,2
JAMMU & KASHMIR,2007,Total,153,81,0,234
JAMMU & KASHMIR,2008,Never Married,50,36,0,86
JAMMU & KASHMIR,2008,Married,127,94,0,221
JAMMU & KASHMIR,2008,Widowed/Widower,0,0,0,0
JAMMU & KASHMIR,2008,Divorcee,0,3,0,3
JAMMU & KASHMIR,2008,Seperated,0,0,0,0
JAMMU & KASHMIR,2008,Total,177,133,0,310
JAMMU & KASHMIR,2009,Never Married,62,63,0,125
JAMMU & KASHMIR,2009,Married,97,83,0,180
JAMMU & KASHMIR,2009,Widowed/Widower,6,5,0,11
JAMMU & KASHMIR,2009,Divorcee,0,0,0,0
JAMMU & KASHMIR,2009,Seperated,3,2,0,5
JAMMU & KASHMIR,2009,Total,168,153,0,321
JAMMU & KASHMIR,2010,Never Married,42,61,0,103
JAMMU & KASHMIR,2010,Married,72,71,0,143
JAMMU & KASHMIR,2010,Widowed/Widower,0,1,0,1
JAMMU & KASHMIR,2010,Divorcee,0,0,0,0
JAMMU & KASHMIR,2010,Seperated,8,4,0,12
JAMMU & KASHMIR,2010,Total,122,137,0,259
JAMMU & KASHMIR,2011,Never Married,38,59,0,97
JAMMU & KASHMIR,2011,Married,83,69,0,152
JAMMU & KASHMIR,2011,Widowed/Widower,7,5,0,12
JAMMU & KASHMIR,2011,Divorcee,6,2,0,8
JAMMU & KASHMIR,2011,Seperated,10,8,0,18
JAMMU & KASHMIR,2011,Total,144,143,0,287
JAMMU & KASHMIR,2012,Never Married,59,67,0,126
JAMMU & KASHMIR,2012,Married,110,128,0,238
JAMMU & KASHMIR,2012,Widowed/Widower,5,6,0,11
JAMMU & KASHMIR,2012,Divorcee,5,12,0,17
JAMMU & KASHMIR,2012,Seperated,13,9,0,22
JAMMU & KASHMIR,2012,Total,192,222,0,414
JHARKHAND,2001,Never Married,20,15,0,35
JHARKHAND,2001,Married,107,85,0,192
JHARKHAND,2001,Widowed/Widower,1,2,0,3
JHARKHAND,2001,Divorcee,1,1,0,2
JHARKHAND,2001,Seperated,12,6,0,18
JHARKHAND,2001,Total,141,109,0,250
JHARKHAND,2002,Never Married,14,14,0,28
JHARKHAND,2002,Married,84,85,0,169
JHARKHAND,2002,Widowed/Widower,24,10,0,34
JHARKHAND,2002,Divorcee,12,3,0,15
JHARKHAND,2002,Seperated,19,7,0,26
JHARKHAND,2002,Total,153,119,0,272
JHARKHAND,2003,Never Married,21,14,0,35
JHARKHAND,2003,Married,90,75,0,165
JHARKHAND,2003,Widowed/Widower,15,20,0,35
JHARKHAND,2003,Divorcee,12,3,0,15
JHARKHAND,2003,Seperated,15,7,0,22
JHARKHAND,2003,Total,153,119,0,272
JHARKHAND,2004,Never Married,44,29,0,73
JHARKHAND,2004,Married,139,115,0,254
JHARKHAND,2004,Widowed/Widower,24,13,0,37
JHARKHAND,2004,Divorcee,3,12,0,15
JHARKHAND,2004,Seperated,23,15,0,38
JHARKHAND,2004,Total,233,184,0,417
JHARKHAND,2005,Never Married,135,91,0,226
JHARKHAND,2005,Married,347,165,0,512
JHARKHAND,2005,Widowed/Widower,12,19,0,31
JHARKHAND,2005,Divorcee,4,4,0,8
JHARKHAND,2005,Seperated,25,6,0,31
JHARKHAND,2005,Total,523,285,0,808
JHARKHAND,2006,Never Married,199,104,0,303
JHARKHAND,2006,Married,290,211,0,501
JHARKHAND,2006,Widowed/Widower,17,11,0,28
JHARKHAND,2006,Divorcee,4,5,0,9
JHARKHAND,2006,Seperated,11,4,0,15
JHARKHAND,2006,Total,521,335,0,856
JHARKHAND,2007,Never Married,232,116,0,348
JHARKHAND,2007,Married,573,259,0,832
JHARKHAND,2007,Widowed/Widower,57,21,0,78
JHARKHAND,2007,Divorcee,14,7,0,21
JHARKHAND,2007,Seperated,4,6,0,10
JHARKHAND,2007,Total,880,409,0,1289
JHARKHAND,2008,Never Married,134,82,0,216
JHARKHAND,2008,Married,413,156,0,569
JHARKHAND,2008,Widowed/Widower,21,18,0,39
JHARKHAND,2008,Divorcee,5,28,0,33
JHARKHAND,2008,Seperated,29,25,0,54
JHARKHAND,2008,Total,602,309,0,911
JHARKHAND,2009,Never Married,192,110,0,302
JHARKHAND,2009,Married,491,215,0,706
JHARKHAND,2009,Widowed/Widower,45,28,0,73
JHARKHAND,2009,Divorcee,6,7,0,13
JHARKHAND,2009,Seperated,10,8,0,18
JHARKHAND,2009,Total,744,368,0,1112
JHARKHAND,2010,Never Married,222,142,0,364
JHARKHAND,2010,Married,522,254,0,776
JHARKHAND,2010,Widowed/Widower,37,25,0,62
JHARKHAND,2010,Divorcee,3,10,0,13
JHARKHAND,2010,Seperated,11,6,0,17
JHARKHAND,2010,Total,795,437,0,1232
JHARKHAND,2011,Never Married,205,103,0,308
JHARKHAND,2011,Married,591,250,0,841
JHARKHAND,2011,Widowed/Widower,18,24,0,42
JHARKHAND,2011,Divorcee,2,5,0,7
JHARKHAND,2011,Seperated,9,5,0,14
JHARKHAND,2011,Total,825,387,0,1212
JHARKHAND,2012,Never Married,302,165,0,467
JHARKHAND,2012,Married,453,273,0,726
JHARKHAND,2012,Widowed/Widower,37,22,0,59
JHARKHAND,2012,Divorcee,19,8,0,27
JHARKHAND,2012,Seperated,27,13,0,40
JHARKHAND,2012,Total,838,481,0,1319
KARNATAKA,2001,Never Married,1686,894,0,2580
KARNATAKA,2001,Married,5581,2607,0,8188
KARNATAKA,2001,Widowed/Widower,261,364,0,625
KARNATAKA,2001,Divorcee,32,35,0,67
KARNATAKA,2001,Seperated,311,110,0,421
KARNATAKA,2001,Total,7871,4010,0,11881
KARNATAKA,2002,Never Married,1794,969,0,2763
KARNATAKA,2002,Married,5865,2829,0,8694
KARNATAKA,2002,Widowed/Widower,138,193,0,331
KARNATAKA,2002,Divorcee,15,68,0,83
KARNATAKA,2002,Seperated,268,131,0,399
KARNATAKA,2002,Total,8080,4190,0,12270
KARNATAKA,2003,Never Married,1953,1007,0,2960
KARNATAKA,2003,Married,5912,2678,0,8590
KARNATAKA,2003,Widowed/Widower,251,206,0,457
KARNATAKA,2003,Divorcee,26,17,0,43
KARNATAKA,2003,Seperated,233,78,0,311
KARNATAKA,2003,Total,8375,3986,0,12361
KARNATAKA,2004,Never Married,1762,1000,0,2762
KARNATAKA,2004,Married,5841,2671,0,8512
KARNATAKA,2004,Widowed/Widower,159,165,0,324
KARNATAKA,2004,Divorcee,13,3,0,16
KARNATAKA,2004,Seperated,243,80,0,323
KARNATAKA,2004,Total,8018,3919,0,11937
KARNATAKA,2005,Never Married,1562,869,0,2431
KARNATAKA,2005,Married,5715,2706,0,8421
KARNATAKA,2005,Widowed/Widower,170,147,0,317
KARNATAKA,2005,Divorcee,28,24,0,52
KARNATAKA,2005,Seperated,232,104,0,336
KARNATAKA,2005,Total,7707,3850,0,11557
KARNATAKA,2006,Never Married,1761,956,0,2717
KARNATAKA,2006,Married,5806,2863,0,8669
KARNATAKA,2006,Widowed/Widower,204,214,0,418
KARNATAKA,2006,Divorcee,33,28,0,61
KARNATAKA,2006,Seperated,244,103,0,347
KARNATAKA,2006,Total,8048,4164,0,12212
KARNATAKA,2007,Never Married,1776,1052,0,2828
KARNATAKA,2007,Married,6137,2574,0,8711
KARNATAKA,2007,Widowed/Widower,320,187,0,507
KARNATAKA,2007,Divorcee,28,51,0,79
KARNATAKA,2007,Seperated,131,48,0,179
KARNATAKA,2007,Total,8392,3912,0,12304
KARNATAKA,2008,Never Married,1771,1026,0,2797
KARNATAKA,2008,Married,6068,2715,0,8783
KARNATAKA,2008,Widowed/Widower,184,180,0,364
KARNATAKA,2008,Divorcee,38,34,0,72
KARNATAKA,2008,Seperated,155,51,0,206
KARNATAKA,2008,Total,8216,4006,0,12222
KARNATAKA,2009,Never Married,1775,982,0,2757
KARNATAKA,2009,Married,5581,2397,0,7978
KARNATAKA,2009,Widowed/Widower,495,423,0,918
KARNATAKA,2009,Divorcee,75,49,0,124
KARNATAKA,2009,Seperated,283,135,0,418
KARNATAKA,2009,Total,8209,3986,0,12195
KARNATAKA,2010,Never Married,1921,1055,0,2976
KARNATAKA,2010,Married,5631,2730,0,8361
KARNATAKA,2010,Widowed/Widower,471,250,0,721
KARNATAKA,2010,Divorcee,125,84,0,209
KARNATAKA,2010,Seperated,259,125,0,384
KARNATAKA,2010,Total,8407,4244,0,12651
KARNATAKA,2011,Never Married,1873,996,0,2869
KARNATAKA,2011,Married,6002,2822,0,8824
KARNATAKA,2011,Widowed/Widower,283,184,0,467
KARNATAKA,2011,Divorcee,55,58,0,113
KARNATAKA,2011,Seperated,259,90,0,349
KARNATAKA,2011,Total,8472,4150,0,12622
KARNATAKA,2012,Never Married,1968,1032,0,3000
KARNATAKA,2012,Married,6216,2920,0,9136
KARNATAKA,2012,Widowed/Widower,180,133,0,313
KARNATAKA,2012,Divorcee,17,13,0,30
KARNATAKA,2012,Seperated,215,59,0,274
KARNATAKA,2012,Total,8596,4157,0,12753
KERALA,2001,Never Married,1187,601,0,1788
KERALA,2001,Married,5306,1915,0,7221
KERALA,2001,Widowed/Widower,119,148,0,267
KERALA,2001,Divorcee,45,66,0,111
KERALA,2001,Seperated,130,55,0,185
KERALA,2001,Total,6787,2785,0,9572
KERALA,2002,Never Married,1193,570,0,1763
KERALA,2002,Married,5600,1782,0,7382
KERALA,2002,Widowed/Widower,189,171,0,360
KERALA,2002,Divorcee,26,54,0,80
KERALA,2002,Seperated,157,68,0,225
KERALA,2002,Total,7165,2645,0,9810
KERALA,2003,Never Married,1236,587,0,1823
KERALA,2003,Married,5344,1678,0,7022
KERALA,2003,Widowed/Widower,187,173,0,360
KERALA,2003,Divorcee,36,20,0,56
KERALA,2003,Seperated,132,45,0,177
KERALA,2003,Total,6935,2503,0,9438
KERALA,2004,Never Married,1113,583,0,1696
KERALA,2004,Married,5120,1576,0,6696
KERALA,2004,Widowed/Widower,181,203,0,384
KERALA,2004,Divorcee,49,42,0,91
KERALA,2004,Seperated,135,51,0,186
KERALA,2004,Total,6598,2455,0,9053
KERALA,2005,Never Married,1238,528,0,1766
KERALA,2005,Married,5388,1675,0,7063
KERALA,2005,Widowed/Widower,128,150,0,278
KERALA,2005,Divorcee,16,20,0,36
KERALA,2005,Seperated,60,41,0,101
KERALA,2005,Total,6830,2414,0,9244
KERALA,2006,Never Married,999,479,0,1478
KERALA,2006,Married,5298,1697,0,6995
KERALA,2006,Widowed/Widower,143,181,0,324
KERALA,2006,Divorcee,36,41,0,77
KERALA,2006,Seperated,107,45,0,152
KERALA,2006,Total,6583,2443,0,9026
KERALA,2007,Never Married,996,433,0,1429
KERALA,2007,Married,5333,1666,0,6999
KERALA,2007,Widowed/Widower,142,183,0,325
KERALA,2007,Divorcee,40,47,0,87
KERALA,2007,Seperated,77,45,0,122
KERALA,2007,Total,6588,2374,0,8962
KERALA,2008,Never Married,891,446,0,1337
KERALA,2008,Married,4952,1723,0,6675
KERALA,2008,Widowed/Widower,154,182,0,336
KERALA,2008,Divorcee,36,37,0,73
KERALA,2008,Seperated,97,51,0,148
KERALA,2008,Total,6130,2439,0,8569
KERALA,2009,Never Married,932,417,0,1349
KERALA,2009,Married,5099,1754,0,6853
KERALA,2009,Widowed/Widower,163,164,0,327
KERALA,2009,Divorcee,38,35,0,73
KERALA,2009,Seperated,90,63,0,153
KERALA,2009,Total,6322,2433,0,8755
KERALA,2010,Never Married,909,424,0,1333
KERALA,2010,Married,5141,1575,0,6716
KERALA,2010,Widowed/Widower,172,164,0,336
KERALA,2010,Divorcee,33,40,0,73
KERALA,2010,Seperated,91,37,0,128
KERALA,2010,Total,6346,2240,0,8586
KERALA,2011,Never Married,985,408,0,1393
KERALA,2011,Married,4845,1548,0,6393
KERALA,2011,Widowed/Widower,197,160,0,357
KERALA,2011,Divorcee,91,45,0,136
KERALA,2011,Seperated,94,58,0,152
KERALA,2011,Total,6212,2219,0,8431
KERALA,2012,Never Married,1000,401,0,1401
KERALA,2012,Married,4998,1443,0,6441
KERALA,2012,Widowed/Widower,262,163,0,425
KERALA,2012,Divorcee,63,43,0,106
KERALA,2012,Seperated,86,31,0,117
KERALA,2012,Total,6409,2081,0,8490
MADHYA PRADESH,2001,Never Married,1125,862,0,1987
MADHYA PRADESH,2001,Married,2260,2255,0,4515
MADHYA PRADESH,2001,Widowed/Widower,137,180,0,317
MADHYA PRADESH,2001,Divorcee,6,13,0,19
MADHYA PRADESH,2001,Seperated,8,14,0,22
MADHYA PRADESH,2001,Total,3536,3324,0,6860
MADHYA PRADESH,2002,Never Married,971,670,0,1641
MADHYA PRADESH,2002,Married,2353,2370,0,4723
MADHYA PRADESH,2002,Widowed/Widower,152,194,0,346
MADHYA PRADESH,2002,Divorcee,50,32,0,82
MADHYA PRADESH,2002,Seperated,53,54,0,107
MADHYA PRADESH,2002,Total,3579,3320,0,6899
MADHYA PRADESH,2003,Never Married,976,686,0,1662
MADHYA PRADESH,2003,Married,2335,2251,0,4586
MADHYA PRADESH,2003,Widowed/Widower,166,223,0,389
MADHYA PRADESH,2003,Divorcee,22,29,0,51
MADHYA PRADESH,2003,Seperated,39,35,0,74
MADHYA PRADESH,2003,Total,3538,3224,0,6762
MADHYA PRADESH,2004,Never Married,935,560,0,1495
MADHYA PRADESH,2004,Married,2462,2337,0,4799
MADHYA PRADESH,2004,Widowed/Widower,155,187,0,342
MADHYA PRADESH,2004,Divorcee,32,35,0,67
MADHYA PRADESH,2004,Seperated,50,42,0,92
MADHYA PRADESH,2004,Total,3634,3161,0,6795
MADHYA PRADESH,2005,Never Married,600,587,0,1187
MADHYA PRADESH,2005,Married,2031,1780,0,3811
MADHYA PRADESH,2005,Widowed/Widower,126,132,0,258
MADHYA PRADESH,2005,Divorcee,21,42,0,63
MADHYA PRADESH,2005,Seperated,73,56,0,129
MADHYA PRADESH,2005,Total,2851,2597,0,5448
MADHYA PRADESH,2006,Never Married,786,671,0,1457
MADHYA PRADESH,2006,Married,2515,2050,0,4565
MADHYA PRADESH,2006,Widowed/Widower,149,122,0,271
MADHYA PRADESH,2006,Divorcee,14,34,0,48
MADHYA PRADESH,2006,Seperated,39,55,0,94
MADHYA PRADESH,2006,Total,3503,2932,0,6435
MADHYA PRADESH,2007,Never Married,911,728,0,1639
MADHYA PRADESH,2007,Married,2425,1917,0,4342
MADHYA PRADESH,2007,Widowed/Widower,100,149,0,249
MADHYA PRADESH,2007,Divorcee,11,25,0,36
MADHYA PRADESH,2007,Seperated,23,40,0,63
MADHYA PRADESH,2007,Total,3470,2859,0,6329
MADHYA PRADESH,2008,Never Married,1302,854,0,2156
MADHYA PRADESH,2008,Married,2693,2020,0,4713
MADHYA PRADESH,2008,Widowed/Widower,182,199,0,381
MADHYA PRADESH,2008,Divorcee,73,69,0,142
MADHYA PRADESH,2008,Seperated,115,122,0,237
MADHYA PRADESH,2008,Total,4365,3264,0,7629
MADHYA PRADESH,2009,Never Married,1417,1002,0,2419
MADHYA PRADESH,2009,Married,3366,2735,0,6101
MADHYA PRADESH,2009,Widowed/Widower,269,200,0,469
MADHYA PRADESH,2009,Divorcee,29,20,0,49
MADHYA PRADESH,2009,Seperated,19,56,0,75
MADHYA PRADESH,2009,Total,5100,4013,0,9113
MADHYA PRADESH,2010,Never Married,1356,998,0,2354
MADHYA PRADESH,2010,Married,3426,2644,0,6070
MADHYA PRADESH,2010,Widowed/Widower,189,161,0,350
MADHYA PRADESH,2010,Divorcee,72,61,0,133
MADHYA PRADESH,2010,Seperated,44,52,0,96
MADHYA PRADESH,2010,Total,5087,3916,0,9003
MADHYA PRADESH,2011,Never Married,1474,1040,0,2514
MADHYA PRADESH,2011,Married,3589,2757,0,6346
MADHYA PRADESH,2011,Widowed/Widower,123,127,0,250
MADHYA PRADESH,2011,Divorcee,20,31,0,51
MADHYA PRADESH,2011,Seperated,34,64,0,98
MADHYA PRADESH,2011,Total,5240,4019,0,9259
MADHYA PRADESH,2012,Never Married,1592,1108,0,2700
MADHYA PRADESH,2012,Married,3860,2672,0,6532
MADHYA PRADESH,2012,Widowed/Widower,242,161,0,403
MADHYA PRADESH,2012,Divorcee,19,30,0,49
MADHYA PRADESH,2012,Seperated,61,30,0,91
MADHYA PRADESH,2012,Total,5774,4001,0,9775
MAHARASHTRA,2001,Never Married,1892,1102,0,2994
MAHARASHTRA,2001,Married,7015,3734,0,10749
MAHARASHTRA,2001,Widowed/Widower,247,280,0,527
MAHARASHTRA,2001,Divorcee,64,95,0,159
MAHARASHTRA,2001,Seperated,120,69,0,189
MAHARASHTRA,2001,Total,9338,5280,0,14618
MAHARASHTRA,2002,Never Married,2046,1106,0,3152
MAHARASHTRA,2002,Married,6988,3621,0,10609
MAHARASHTRA,2002,Widowed/Widower,283,241,0,524
MAHARASHTRA,2002,Divorcee,45,51,0,96
MAHARASHTRA,2002,Seperated,85,63,0,148
MAHARASHTRA,2002,Total,9447,5082,0,14529
MAHARASHTRA,2003,Never Married,1925,1012,0,2937
MAHARASHTRA,2003,Married,7477,3563,0,11040
MAHARASHTRA,2003,Widowed/Widower,320,302,0,622
MAHARASHTRA,2003,Divorcee,20,33,0,53
MAHARASHTRA,2003,Seperated,68,40,0,108
MAHARASHTRA,2003,Total,9810,4950,0,14760
MAHARASHTRA,2004,Never Married,2000,1054,0,3054
MAHARASHTRA,2004,Married,7525,3454,0,10979
MAHARASHTRA,2004,Widowed/Widower,246,260,0,506
MAHARASHTRA,2004,Divorcee,51,36,0,87
MAHARASHTRA,2004,Seperated,81,22,0,103
MAHARASHTRA,2004,Total,9903,4826,0,14729
MAHARASHTRA,2005,Never Married,1937,1108,0,3045
MAHARASHTRA,2005,Married,7232,3410,0,10642
MAHARASHTRA,2005,Widowed/Widower,346,250,0,596
MAHARASHTRA,2005,Divorcee,36,38,0,74
MAHARASHTRA,2005,Seperated,52,17,0,69
MAHARASHTRA,2005,Total,9603,4823,0,14426
MAHARASHTRA,2006,Never Married,1994,955,0,2949
MAHARASHTRA,2006,Married,8133,3707,0,11840
MAHARASHTRA,2006,Widowed/Widower,293,257,0,550
MAHARASHTRA,2006,Divorcee,35,37,0,72
MAHARASHTRA,2006,Seperated,55,28,0,83
MAHARASHTRA,2006,Total,10510,4984,0,15494
MAHARASHTRA,2007,Never Married,2019,949,0,2968
MAHARASHTRA,2007,Married,8024,3519,0,11543
MAHARASHTRA,2007,Widowed/Widower,295,230,0,525
MAHARASHTRA,2007,Divorcee,33,48,0,81
MAHARASHTRA,2007,Seperated,49,18,0,67
MAHARASHTRA,2007,Total,10420,4764,0,15184
MAHARASHTRA,2008,Never Married,1979,991,0,2970
MAHARASHTRA,2008,Married,7634,3176,0,10810
MAHARASHTRA,2008,Widowed/Widower,211,258,0,469
MAHARASHTRA,2008,Divorcee,28,42,0,70
MAHARASHTRA,2008,Seperated,37,18,0,55
MAHARASHTRA,2008,Total,9889,4485,0,14374
MAHARASHTRA,2009,Never Married,1995,1037,0,3032
MAHARASHTRA,2009,Married,7511,3235,0,10746
MAHARASHTRA,2009,Widowed/Widower,228,212,0,440
MAHARASHTRA,2009,Divorcee,20,20,0,40
MAHARASHTRA,2009,Seperated,31,11,0,42
MAHARASHTRA,2009,Total,9785,4515,0,14300
MAHARASHTRA,2010,Never Married,2372,1271,0,3643
MAHARASHTRA,2010,Married,8138,3538,0,11676
MAHARASHTRA,2010,Widowed/Widower,300,225,0,525
MAHARASHTRA,2010,Divorcee,31,18,0,49
MAHARASHTRA,2010,Seperated,17,6,0,23
MAHARASHTRA,2010,Total,10858,5058,0,15916
MAHARASHTRA,2011,Never Married,2211,1144,0,3355
MAHARASHTRA,2011,Married,8387,3696,0,12083
MAHARASHTRA,2011,Widowed/Widower,229,196,0,425
MAHARASHTRA,2011,Divorcee,35,21,0,56
MAHARASHTRA,2011,Seperated,25,3,0,28
MAHARASHTRA,2011,Total,10887,5060,0,15947
MAHARASHTRA,2012,Never Married,2261,1179,0,3440
MAHARASHTRA,2012,Married,8756,3370,0,12126
MAHARASHTRA,2012,Widowed/Widower,228,220,0,448
MAHARASHTRA,2012,Divorcee,29,26,0,55
MAHARASHTRA,2012,Seperated,30,13,0,43
MAHARASHTRA,2012,Total,11304,4808,0,16112
MANIPUR,2001,Never Married,12,9,0,21
MANIPUR,2001,Married,12,8,0,20
MANIPUR,2001,Widowed/Widower,0,0,0,0
MANIPUR,2001,Divorcee,0,0,0,0
MANIPUR,2001,Seperated,0,0,0,0
MANIPUR,2001,Total,24,17,0,41
MANIPUR,2002,Never Married,9,4,0,13
MANIPUR,2002,Married,21,5,0,26
MANIPUR,2002,Widowed/Widower,0,0,0,0
MANIPUR,2002,Divorcee,0,0,0,0
MANIPUR,2002,Seperated,0,0,0,0
MANIPUR,2002,Total,30,9,0,39
MANIPUR,2003,Never Married,9,3,0,12
MANIPUR,2003,Married,12,2,0,14
MANIPUR,2003,Widowed/Widower,0,0,0,0
MANIPUR,2003,Divorcee,0,0,0,0
MANIPUR,2003,Seperated,0,0,0,0
MANIPUR,2003,Total,21,5,0,26
MANIPUR,2004,Never Married,13,8,0,21
MANIPUR,2004,Married,19,1,0,20
MANIPUR,2004,Widowed/Widower,0,0,0,0
MANIPUR,2004,Divorcee,0,0,0,0
MANIPUR,2004,Seperated,0,0,0,0
MANIPUR,2004,Total,32,9,0,41
MANIPUR,2005,Never Married,8,2,0,10
MANIPUR,2005,Married,15,2,0,17
MANIPUR,2005,Widowed/Widower,0,0,0,0
MANIPUR,2005,Divorcee,0,0,0,0
MANIPUR,2005,Seperated,0,0,0,0
MANIPUR,2005,Total,23,4,0,27
MANIPUR,2006,Never Married,9,9,0,18
MANIPUR,2006,Married,14,3,0,17
MANIPUR,2006,Widowed/Widower,1,0,0,1
MANIPUR,2006,Divorcee,0,0,0,0
MANIPUR,2006,Seperated,0,0,0,0
MANIPUR,2006,Total,24,12,0,36
MANIPUR,2007,Never Married,10,1,0,11
MANIPUR,2007,Married,18,10,0,28
MANIPUR,2007,Widowed/Widower,0,0,0,0
MANIPUR,2007,Divorcee,0,0,0,0
MANIPUR,2007,Seperated,0,0,0,0
MANIPUR,2007,Total,28,11,0,39
MANIPUR,2008,Never Married,5,4,0,9
MANIPUR,2008,Married,18,7,0,25
MANIPUR,2008,Widowed/Widower,0,0,0,0
MANIPUR,2008,Divorcee,0,0,0,0
MANIPUR,2008,Seperated,0,0,0,0
MANIPUR,2008,Total,23,11,0,34
MANIPUR,2009,Never Married,7,4,0,11
MANIPUR,2009,Married,11,5,0,16
MANIPUR,2009,Widowed/Widower,0,0,0,0
MANIPUR,2009,Divorcee,0,0,0,0
MANIPUR,2009,Seperated,0,0,0,0
MANIPUR,2009,Total,18,9,0,27
MANIPUR,2010,Never Married,11,4,0,15
MANIPUR,2010,Married,13,8,0,21
MANIPUR,2010,Widowed/Widower,0,1,0,1
MANIPUR,2010,Divorcee,0,0,0,0
MANIPUR,2010,Seperated,0,0,0,0
MANIPUR,2010,Total,24,13,0,37
MANIPUR,2011,Never Married,6,6,0,12
MANIPUR,2011,Married,12,9,0,21
MANIPUR,2011,Widowed/Widower,0,0,0,0
MANIPUR,2011,Divorcee,0,0,0,0
MANIPUR,2011,Seperated,0,0,0,0
MANIPUR,2011,Total,18,15,0,33
MANIPUR,2012,Never Married,12,9,0,21
MANIPUR,2012,Married,11,8,0,19
MANIPUR,2012,Widowed/Widower,0,1,0,1
MANIPUR,2012,Divorcee,0,0,0,0
MANIPUR,2012,Seperated,0,0,0,0
MANIPUR,2012,Total,23,18,0,41
MEGHALAYA,2001,Never Married,29,8,0,37
MEGHALAYA,2001,Married,35,7,0,42
MEGHALAYA,2001,Widowed/Widower,5,2,0,7
MEGHALAYA,2001,Divorcee,0,0,0,0
MEGHALAYA,2001,Seperated,0,1,0,1
MEGHALAYA,2001,Total,69,18,0,87
MEGHALAYA,2002,Never Married,23,6,0,29
MEGHALAYA,2002,Married,26,11,0,37
MEGHALAYA,2002,Widowed/Widower,0,1,0,1
MEGHALAYA,2002,Divorcee,0,0,0,0
MEGHALAYA,2002,Seperated,0,0,0,0
MEGHALAYA,2002,Total,49,18,0,67
MEGHALAYA,2003,Never Married,9,6,0,15
MEGHALAYA,2003,Married,17,1,0,18
MEGHALAYA,2003,Widowed/Widower,5,2,0,7
MEGHALAYA,2003,Divorcee,0,0,0,0
MEGHALAYA,2003,Seperated,1,0,0,1
MEGHALAYA,2003,Total,32,9,0,41
MEGHALAYA,2004,Never Married,16,8,0,24
MEGHALAYA,2004,Married,20,8,0,28
MEGHALAYA,2004,Widowed/Widower,2,0,0,2
MEGHALAYA,2004,Divorcee,0,0,0,0
MEGHALAYA,2004,Seperated,1,0,0,1
MEGHALAYA,2004,Total,39,16,0,55
MEGHALAYA,2005,Never Married,17,7,0,24
MEGHALAYA,2005,Married,32,14,0,46
MEGHALAYA,2005,Widowed/Widower,0,0,0,0
MEGHALAYA,2005,Divorcee,0,0,0,0
MEGHALAYA,2005,Seperated,1,0,0,1
MEGHALAYA,2005,Total,50,21,0,71
MEGHALAYA,2006,Never Married,20,10,0,30
MEGHALAYA,2006,Married,46,13,0,59
MEGHALAYA,2006,Widowed/Widower,2,0,0,2
MEGHALAYA,2006,Divorcee,0,0,0,0
MEGHALAYA,2006,Seperated,1,0,0,1
MEGHALAYA,2006,Total,69,23,0,92
MEGHALAYA,2007,Never Married,30,14,0,44
MEGHALAYA,2007,Married,24,12,0,36
MEGHALAYA,2007,Widowed/Widower,2,0,0,2
MEGHALAYA,2007,Divorcee,1,0,0,1
MEGHALAYA,2007,Seperated,3,1,0,4
MEGHALAYA,2007,Total,60,27,0,87
MEGHALAYA,2008,Never Married,16,12,0,28
MEGHALAYA,2008,Married,36,14,0,50
MEGHALAYA,2008,Widowed/Widower,4,2,0,6
MEGHALAYA,2008,Divorcee,0,0,0,0
MEGHALAYA,2008,Seperated,1,0,0,1
MEGHALAYA,2008,Total,57,28,0,85
MEGHALAYA,2009,Never Married,15,16,0,31
MEGHALAYA,2009,Married,37,23,0,60
MEGHALAYA,2009,Widowed/Widower,6,3,0,9
MEGHALAYA,2009,Divorcee,8,3,0,11
MEGHALAYA,2009,Seperated,1,0,0,1
MEGHALAYA,2009,Total,67,45,0,112
MEGHALAYA,2010,Never Married,27,12,0,39
MEGHALAYA,2010,Married,50,15,0,65
MEGHALAYA,2010,Widowed/Widower,2,1,0,3
MEGHALAYA,2010,Divorcee,0,0,0,0
MEGHALAYA,2010,Seperated,1,0,0,1
MEGHALAYA,2010,Total,80,28,0,108
MEGHALAYA,2011,Never Married,55,18,0,73
MEGHALAYA,2011,Married,50,22,0,72
MEGHALAYA,2011,Widowed/Widower,4,2,0,6
MEGHALAYA,2011,Divorcee,2,0,0,2
MEGHALAYA,2011,Seperated,0,0,0,0
MEGHALAYA,2011,Total,111,42,0,153
MEGHALAYA,2012,Never Married,30,20,0,50
MEGHALAYA,2012,Married,58,16,0,74
MEGHALAYA,2012,Widowed/Widower,2,1,0,3
MEGHALAYA,2012,Divorcee,0,1,0,1
MEGHALAYA,2012,Seperated,0,0,0,0
MEGHALAYA,2012,Total,90,38,0,128
MIZORAM,2001,Never Married,21,4,0,25
MIZORAM,2001,Married,18,2,0,20
MIZORAM,2001,Widowed/Widower,0,0,0,0
MIZORAM,2001,Divorcee,6,2,0,8
MIZORAM,2001,Seperated,1,0,0,1
MIZORAM,2001,Total,46,8,0,54
MIZORAM,2002,Never Married,15,2,0,17
MIZORAM,2002,Married,32,7,0,39
MIZORAM,2002,Widowed/Widower,1,1,0,2
MIZORAM,2002,Divorcee,4,0,0,4
MIZORAM,2002,Seperated,4,0,0,4
MIZORAM,2002,Total,56,10,0,66
MIZORAM,2003,Never Married,20,2,0,22
MIZORAM,2003,Married,16,6,0,22
MIZORAM,2003,Widowed/Widower,0,0,0,0
MIZORAM,2003,Divorcee,0,0,0,0
MIZORAM,2003,Seperated,5,3,0,8
MIZORAM,2003,Total,41,11,0,52
MIZORAM,2004,Never Married,18,1,0,19
MIZORAM,2004,Married,26,5,0,31
MIZORAM,2004,Widowed/Widower,2,1,0,3
MIZORAM,2004,Divorcee,4,0,0,4
MIZORAM,2004,Seperated,3,0,0,3
MIZORAM,2004,Total,53,7,0,60
MIZORAM,2005,Never Married,17,4,0,21
MIZORAM,2005,Married,30,4,0,34
MIZORAM,2005,Widowed/Widower,0,0,0,0
MIZORAM,2005,Divorcee,0,0,0,0
MIZORAM,2005,Seperated,0,0,0,0
MIZORAM,2005,Total,47,8,0,55
MIZORAM,2006,Never Married,22,3,0,25
MIZORAM,2006,Married,35,7,0,42
MIZORAM,2006,Widowed/Widower,0,0,0,0
MIZORAM,2006,Divorcee,0,0,0,0
MIZORAM,2006,Seperated,3,0,0,3
MIZORAM,2006,Total,60,10,0,70
MIZORAM,2007,Never Married,4,1,0,5
MIZORAM,2007,Married,3,1,0,4
MIZORAM,2007,Widowed/Widower,0,1,0,1
MIZORAM,2007,Divorcee,13,2,0,15
MIZORAM,2007,Seperated,2,1,0,3
MIZORAM,2007,Total,22,6,0,28
MIZORAM,2008,Never Married,12,2,0,14
MIZORAM,2008,Married,21,2,0,23
MIZORAM,2008,Widowed/Widower,0,2,0,2
MIZORAM,2008,Divorcee,0,0,0,0
MIZORAM,2008,Seperated,2,0,0,2
MIZORAM,2008,Total,35,6,0,41
MIZORAM,2009,Never Married,31,4,0,35
MIZORAM,2009,Married,20,3,0,23
MIZORAM,2009,Widowed/Widower,2,0,0,2
MIZORAM,2009,Divorcee,2,0,0,2
MIZORAM,2009,Seperated,7,0,0,7
MIZORAM,2009,Total,62,7,0,69
MIZORAM,2010,Never Married,33,5,0,38
MIZORAM,2010,Married,16,4,0,20
MIZORAM,2010,Widowed/Widower,0,0,0,0
MIZORAM,2010,Divorcee,11,0,0,11
MIZORAM,2010,Seperated,7,0,0,7
MIZORAM,2010,Total,67,9,0,76
MIZORAM,2011,Never Married,27,5,0,32
MIZORAM,2011,Married,40,5,0,45
MIZORAM,2011,Widowed/Widower,0,2,0,2
MIZORAM,2011,Divorcee,9,1,0,10
MIZORAM,2011,Seperated,1,0,0,1
MIZORAM,2011,Total,77,13,0,90
MIZORAM,2012,Never Married,73,14,0,87
MIZORAM,2012,Married,44,0,0,44
MIZORAM,2012,Widowed/Widower,4,0,0,4
MIZORAM,2012,Divorcee,0,0,0,0
MIZORAM,2012,Seperated,36,2,0,38
MIZORAM,2012,Total,157,16,0,173
NAGALAND,2001,Never Married,10,5,0,15
NAGALAND,2001,Married,15,9,0,24
NAGALAND,2001,Widowed/Widower,0,1,0,1
NAGALAND,2001,Divorcee,0,0,0,0
NAGALAND,2001,Seperated,0,0,0,0
NAGALAND,2001,Total,25,15,0,40
NAGALAND,2002,Never Married,9,3,0,12
NAGALAND,2002,Married,10,4,0,14
NAGALAND,2002,Widowed/Widower,0,1,0,1
NAGALAND,2002,Divorcee,0,0,0,0
NAGALAND,2002,Seperated,0,0,0,0
NAGALAND,2002,Total,19,8,0,27
NAGALAND,2003,Never Married,3,1,0,4
NAGALAND,2003,Married,11,4,0,15
NAGALAND,2003,Widowed/Widower,0,0,0,0
NAGALAND,2003,Divorcee,0,0,0,0
NAGALAND,2003,Seperated,3,0,0,3
NAGALAND,2003,Total,17,5,0,22
NAGALAND,2004,Never Married,12,3,0,15
NAGALAND,2004,Married,13,3,0,16
NAGALAND,2004,Widowed/Widower,0,0,0,0
NAGALAND,2004,Divorcee,0,0,0,0
NAGALAND,2004,Seperated,0,0,0,0
NAGALAND,2004,Total,25,6,0,31
NAGALAND,2005,Never Married,10,3,0,13
NAGALAND,2005,Married,10,2,0,12
NAGALAND,2005,Widowed/Widower,0,0,0,0
NAGALAND,2005,Divorcee,0,0,0,0
NAGALAND,2005,Seperated,1,1,0,2
NAGALAND,2005,Total,21,6,0,27
NAGALAND,2006,Never Married,10,3,0,13
NAGALAND,2006,Married,9,6,0,15
NAGALAND,2006,Widowed/Widower,0,0,0,0
NAGALAND,2006,Divorcee,0,0,0,0
NAGALAND,2006,Seperated,0,0,0,0
NAGALAND,2006,Total,19,9,0,28
NAGALAND,2007,Never Married,8,3,0,11
NAGALAND,2007,Married,9,4,0,13
NAGALAND,2007,Widowed/Widower,0,0,0,0
NAGALAND,2007,Divorcee,0,0,0,0
NAGALAND,2007,Seperated,0,0,0,0
NAGALAND,2007,Total,17,7,0,24
NAGALAND,2008,Never Married,14,4,0,18
NAGALAND,2008,Married,18,6,0,24
NAGALAND,2008,Widowed/Widower,0,0,0,0
NAGALAND,2008,Divorcee,0,0,0,0
NAGALAND,2008,Seperated,0,0,0,0
NAGALAND,2008,Total,32,10,0,42
NAGALAND,2009,Never Married,13,2,0,15
NAGALAND,2009,Married,12,4,0,16
NAGALAND,2009,Widowed/Widower,0,0,0,0
NAGALAND,2009,Divorcee,0,0,0,0
NAGALAND,2009,Seperated,0,0,0,0
NAGALAND,2009,Total,25,6,0,31
NAGALAND,2010,Never Married,3,0,0,3
NAGALAND,2010,Married,8,1,0,9
NAGALAND,2010,Widowed/Widower,0,0,0,0
NAGALAND,2010,Divorcee,0,0,0,0
NAGALAND,2010,Seperated,0,0,0,0
NAGALAND,2010,Total,11,1,0,12
NAGALAND,2011,Never Married,10,3,0,13
NAGALAND,2011,Married,15,5,0,20
NAGALAND,2011,Widowed/Widower,0,0,0,0
NAGALAND,2011,Divorcee,0,0,0,0
NAGALAND,2011,Seperated,0,0,0,0
NAGALAND,2011,Total,25,8,0,33
NAGALAND,2012,Never Married,12,4,0,16
NAGALAND,2012,Married,11,2,0,13
NAGALAND,2012,Widowed/Widower,0,0,0,0
NAGALAND,2012,Divorcee,1,0,0,1
NAGALAND,2012,Seperated,0,0,0,0
NAGALAND,2012,Total,24,6,0,30
ODISHA,2001,Never Married,576,503,0,1079
ODISHA,2001,Married,1294,1181,0,2475
ODISHA,2001,Widowed/Widower,99,117,0,216
ODISHA,2001,Divorcee,13,33,0,46
ODISHA,2001,Seperated,107,129,0,236
ODISHA,2001,Total,2089,1963,0,4052
ODISHA,2002,Never Married,688,513,0,1201
ODISHA,2002,Married,1681,1008,0,2689
ODISHA,2002,Widowed/Widower,197,133,0,330
ODISHA,2002,Divorcee,25,33,0,58
ODISHA,2002,Seperated,40,70,0,110
ODISHA,2002,Total,2631,1757,0,4388
ODISHA,2003,Never Married,606,439,0,1045
ODISHA,2003,Married,1871,1047,0,2918
ODISHA,2003,Widowed/Widower,166,108,0,274
ODISHA,2003,Divorcee,40,47,0,87
ODISHA,2003,Seperated,57,39,0,96
ODISHA,2003,Total,2740,1680,0,4420
ODISHA,2004,Never Married,652,396,0,1048
ODISHA,2004,Married,1806,1097,0,2903
ODISHA,2004,Widowed/Widower,38,95,0,133
ODISHA,2004,Divorcee,15,46,0,61
ODISHA,2004,Seperated,33,37,0,70
ODISHA,2004,Total,2544,1671,0,4215
ODISHA,2005,Never Married,839,419,0,1258
ODISHA,2005,Married,1621,1016,0,2637
ODISHA,2005,Widowed/Widower,55,99,0,154
ODISHA,2005,Divorcee,4,39,0,43
ODISHA,2005,Seperated,35,81,0,116
ODISHA,2005,Total,2554,1654,0,4208
ODISHA,2006,Never Married,588,383,0,971
ODISHA,2006,Married,1686,1178,0,2864
ODISHA,2006,Widowed/Widower,67,74,0,141
ODISHA,2006,Divorcee,13,31,0,44
ODISHA,2006,Seperated,19,26,0,45
ODISHA,2006,Total,2373,1692,0,4065
ODISHA,2007,Never Married,792,453,0,1245
ODISHA,2007,Married,1589,1233,0,2822
ODISHA,2007,Widowed/Widower,71,92,0,163
ODISHA,2007,Divorcee,19,23,0,42
ODISHA,2007,Seperated,17,19,0,36
ODISHA,2007,Total,2488,1820,0,4308
ODISHA,2008,Never Married,802,392,0,1194
ODISHA,2008,Married,2205,1153,0,3358
ODISHA,2008,Widowed/Widower,74,112,0,186
ODISHA,2008,Divorcee,20,36,0,56
ODISHA,2008,Seperated,54,56,0,110
ODISHA,2008,Total,3155,1749,0,4904
ODISHA,2009,Never Married,741,468,0,1209
ODISHA,2009,Married,1645,1118,0,2763
ODISHA,2009,Widowed/Widower,113,128,0,241
ODISHA,2009,Divorcee,29,36,0,65
ODISHA,2009,Seperated,39,48,0,87
ODISHA,2009,Total,2567,1798,0,4365
ODISHA,2010,Never Married,633,446,0,1079
ODISHA,2010,Married,1624,1157,0,2781
ODISHA,2010,Widowed/Widower,90,111,0,201
ODISHA,2010,Divorcee,12,47,0,59
ODISHA,2010,Seperated,71,64,0,135
ODISHA,2010,Total,2430,1825,0,4255
ODISHA,2011,Never Married,778,530,0,1308
ODISHA,2011,Married,1935,1330,0,3265
ODISHA,2011,Widowed/Widower,216,168,0,384
ODISHA,2011,Divorcee,17,58,0,75
ODISHA,2011,Seperated,114,95,0,209
ODISHA,2011,Total,3060,2181,0,5241
ODISHA,2012,Never Married,835,563,0,1398
ODISHA,2012,Married,1911,1361,0,3272
ODISHA,2012,Widowed/Widower,67,123,0,190
ODISHA,2012,Divorcee,19,28,0,47
ODISHA,2012,Seperated,64,56,0,120
ODISHA,2012,Total,2896,2131,0,5027
PUNJAB,2001,Never Married,110,34,0,144
PUNJAB,2001,Married,234,104,0,338
PUNJAB,2001,Widowed/Widower,25,19,0,44
PUNJAB,2001,Divorcee,12,42,0,54
PUNJAB,2001,Seperated,15,53,0,68
PUNJAB,2001,Total,396,252,0,648
PUNJAB,2002,Never Married,109,28,0,137
PUNJAB,2002,Married,266,79,0,345
PUNJAB,2002,Widowed/Widower,19,1,0,20
PUNJAB,2002,Divorcee,0,1,0,1
PUNJAB,2002,Seperated,3,1,0,4
PUNJAB,2002,Total,397,110,0,507
PUNJAB,2003,Never Married,127,30,0,157
PUNJAB,2003,Married,201,78,0,279
PUNJAB,2003,Widowed/Widower,29,13,0,42
PUNJAB,2003,Divorcee,68,3,0,71
PUNJAB,2003,Seperated,81,1,0,82
PUNJAB,2003,Total,506,125,0,631
PUNJAB,2004,Never Married,176,37,0,213
PUNJAB,2004,Married,252,83,0,335
PUNJAB,2004,Widowed/Widower,62,8,0,70
PUNJAB,2004,Divorcee,14,1,0,15
PUNJAB,2004,Seperated,12,0,0,12
PUNJAB,2004,Total,516,129,0,645
PUNJAB,2005,Never Married,143,27,0,170
PUNJAB,2005,Married,297,77,0,374
PUNJAB,2005,Widowed/Widower,21,2,0,23
PUNJAB,2005,Divorcee,9,0,0,9
PUNJAB,2005,Seperated,12,0,0,12
PUNJAB,2005,Total,482,106,0,588
PUNJAB,2006,Never Married,187,48,0,235
PUNJAB,2006,Married,406,104,0,510
PUNJAB,2006,Widowed/Widower,7,7,0,14
PUNJAB,2006,Divorcee,4,0,0,4
PUNJAB,2006,Seperated,6,3,0,9
PUNJAB,2006,Total,610,162,0,772
PUNJAB,2007,Never Married,198,68,0,266
PUNJAB,2007,Married,418,138,0,556
PUNJAB,2007,Widowed/Widower,7,9,0,16
PUNJAB,2007,Divorcee,0,0,0,0
PUNJAB,2007,Seperated,9,0,0,9
PUNJAB,2007,Total,632,215,0,847
PUNJAB,2008,Never Married,220,70,0,290
PUNJAB,2008,Married,404,149,0,553
PUNJAB,2008,Widowed/Widower,10,6,0,16
PUNJAB,2008,Divorcee,4,1,0,5
PUNJAB,2008,Seperated,5,0,0,5
PUNJAB,2008,Total,643,226,0,869
PUNJAB,2009,Never Married,218,55,0,273
PUNJAB,2009,Married,392,146,0,538
PUNJAB,2009,Widowed/Widower,16,8,0,24
PUNJAB,2009,Divorcee,1,2,0,3
PUNJAB,2009,Seperated,8,1,0,9
PUNJAB,2009,Total,635,212,0,847
PUNJAB,2010,Never Married,251,74,0,325
PUNJAB,2010,Married,445,122,0,567
PUNJAB,2010,Widowed/Widower,14,4,0,18
PUNJAB,2010,Divorcee,6,1,0,7
PUNJAB,2010,Seperated,3,0,0,3
PUNJAB,2010,Total,719,201,0,920
PUNJAB,2011,Never Married,258,66,0,324
PUNJAB,2011,Married,485,142,0,627
PUNJAB,2011,Widowed/Widower,1,3,0,4
PUNJAB,2011,Divorcee,0,0,0,0
PUNJAB,2011,Seperated,11,0,0,11
PUNJAB,2011,Total,755,211,0,966
PUNJAB,2012,Never Married,299,70,0,369
PUNJAB,2012,Married,470,169,0,639
PUNJAB,2012,Widowed/Widower,4,3,0,7
PUNJAB,2012,Divorcee,1,4,0,5
PUNJAB,2012,Seperated,10,0,0,10
PUNJAB,2012,Total,784,246,0,1030
RAJASTHAN,2001,Never Married,507,323,0,830
RAJASTHAN,2001,Married,1356,816,0,2172
RAJASTHAN,2001,Widowed/Widower,57,66,0,123
RAJASTHAN,2001,Divorcee,10,10,0,20
RAJASTHAN,2001,Seperated,29,21,0,50
RAJASTHAN,2001,Total,1959,1236,0,3195
RAJASTHAN,2002,Never Married,588,280,0,868
RAJASTHAN,2002,Married,1422,799,0,2221
RAJASTHAN,2002,Widowed/Widower,45,52,0,97
RAJASTHAN,2002,Divorcee,12,8,0,20
RAJASTHAN,2002,Seperated,25,17,0,42
RAJASTHAN,2002,Total,2092,1156,0,3248
RAJASTHAN,2003,Never Married,639,306,0,945
RAJASTHAN,2003,Married,1665,890,0,2555
RAJASTHAN,2003,Widowed/Widower,62,45,0,107
RAJASTHAN,2003,Divorcee,9,17,0,26
RAJASTHAN,2003,Seperated,14,14,0,28
RAJASTHAN,2003,Total,2389,1272,0,3661
RAJASTHAN,2004,Never Married,605,243,0,848
RAJASTHAN,2004,Married,1828,922,0,2750
RAJASTHAN,2004,Widowed/Widower,35,36,0,71
RAJASTHAN,2004,Divorcee,7,13,0,20
RAJASTHAN,2004,Seperated,11,25,0,36
RAJASTHAN,2004,Total,2486,1239,0,3725
RAJASTHAN,2005,Never Married,924,256,0,1180
RAJASTHAN,2005,Married,1869,1015,0,2884
RAJASTHAN,2005,Widowed/Widower,48,25,0,73
RAJASTHAN,2005,Divorcee,6,6,0,12
RAJASTHAN,2005,Seperated,11,18,0,29
RAJASTHAN,2005,Total,2858,1320,0,4178
RAJASTHAN,2006,Never Married,871,332,0,1203
RAJASTHAN,2006,Married,1958,976,0,2934
RAJASTHAN,2006,Widowed/Widower,34,21,0,55
RAJASTHAN,2006,Divorcee,9,7,0,16
RAJASTHAN,2006,Seperated,38,17,0,55
RAJASTHAN,2006,Total,2910,1353,0,4263
RAJASTHAN,2007,Never Married,960,264,0,1224
RAJASTHAN,2007,Married,2112,946,0,3058
RAJASTHAN,2007,Widowed/Widower,53,37,0,90
RAJASTHAN,2007,Divorcee,11,13,0,24
RAJASTHAN,2007,Seperated,18,23,0,41
RAJASTHAN,2007,Total,3154,1283,0,4437
RAJASTHAN,2008,Never Married,1043,357,0,1400
RAJASTHAN,2008,Married,2421,1094,0,3515
RAJASTHAN,2008,Widowed/Widower,108,74,0,182
RAJASTHAN,2008,Divorcee,14,14,0,28
RAJASTHAN,2008,Seperated,16,25,0,41
RAJASTHAN,2008,Total,3602,1564,0,5166
RAJASTHAN,2009,Never Married,874,393,0,1267
RAJASTHAN,2009,Married,2527,1090,0,3617
RAJASTHAN,2009,Widowed/Widower,77,49,0,126
RAJASTHAN,2009,Divorcee,7,8,0,15
RAJASTHAN,2009,Seperated,26,14,0,40
RAJASTHAN,2009,Total,3511,1554,0,5065
RAJASTHAN,2010,Never Married,949,390,0,1339
RAJASTHAN,2010,Married,2300,1101,0,3401
RAJASTHAN,2010,Widowed/Widower,74,42,0,116
RAJASTHAN,2010,Divorcee,8,6,0,14
RAJASTHAN,2010,Seperated,34,16,0,50
RAJASTHAN,2010,Total,3365,1555,0,4920
RAJASTHAN,2011,Never Married,776,315,0,1091
RAJASTHAN,2011,Married,2163,958,0,3121
RAJASTHAN,2011,Widowed/Widower,47,38,0,85
RAJASTHAN,2011,Divorcee,8,5,0,13
RAJASTHAN,2011,Seperated,22,16,0,38
RAJASTHAN,2011,Total,3016,1332,0,4348
RAJASTHAN,2012,Never Married,846,429,0,1275
RAJASTHAN,2012,Married,2273,1082,0,3355
RAJASTHAN,2012,Widowed/Widower,72,51,0,123
RAJASTHAN,2012,Divorcee,19,14,0,33
RAJASTHAN,2012,Seperated,17,18,0,35
RAJASTHAN,2012,Total,3227,1594,0,4821
SIKKIM,2001,Never Married,16,14,0,30
SIKKIM,2001,Married,41,17,0,58
SIKKIM,2001,Widowed/Widower,2,0,0,2
SIKKIM,2001,Divorcee,0,0,0,0
SIKKIM,2001,Seperated,3,1,0,4
SIKKIM,2001,Total,62,32,0,94
SIKKIM,2002,Never Married,12,6,0,18
SIKKIM,2002,Married,29,8,0,37
SIKKIM,2002,Widowed/Widower,6,3,0,9
SIKKIM,2002,Divorcee,3,2,0,5
SIKKIM,2002,Seperated,4,5,0,9
SIKKIM,2002,Total,54,24,0,78
SIKKIM,2003,Never Married,26,9,0,35
SIKKIM,2003,Married,38,26,0,64
SIKKIM,2003,Widowed/Widower,3,2,0,5
SIKKIM,2003,Divorcee,0,0,0,0
SIKKIM,2003,Seperated,1,0,0,1
SIKKIM,2003,Total,68,37,0,105
SIKKIM,2004,Never Married,0,1,0,1
SIKKIM,2004,Married,56,41,0,97
SIKKIM,2004,Widowed/Widower,0,0,0,0
SIKKIM,2004,Divorcee,0,0,0,0
SIKKIM,2004,Seperated,0,0,0,0
SIKKIM,2004,Total,56,42,0,98
SIKKIM,2005,Never Married,23,15,0,38
SIKKIM,2005,Married,38,23,0,61
SIKKIM,2005,Widowed/Widower,0,5,0,5
SIKKIM,2005,Divorcee,0,2,0,2
SIKKIM,2005,Seperated,1,2,0,3
SIKKIM,2005,Total,62,47,0,109
SIKKIM,2006,Never Married,37,14,0,51
SIKKIM,2006,Married,34,30,0,64
SIKKIM,2006,Widowed/Widower,18,2,0,20
SIKKIM,2006,Divorcee,0,1,0,1
SIKKIM,2006,Seperated,9,0,0,9
SIKKIM,2006,Total,98,47,0,145
SIKKIM,2007,Never Married,17,7,0,24
SIKKIM,2007,Married,40,20,0,60
SIKKIM,2007,Widowed/Widower,7,5,0,12
SIKKIM,2007,Divorcee,11,2,0,13
SIKKIM,2007,Seperated,9,4,0,13
SIKKIM,2007,Total,84,38,0,122
SIKKIM,2008,Never Married,72,18,0,90
SIKKIM,2008,Married,138,47,0,185
SIKKIM,2008,Widowed/Widower,4,4,0,8
SIKKIM,2008,Divorcee,2,2,0,4
SIKKIM,2008,Seperated,0,0,0,0
SIKKIM,2008,Total,216,71,0,287
SIKKIM,2009,Never Married,49,59,0,108
SIKKIM,2009,Married,28,29,0,57
SIKKIM,2009,Widowed/Widower,18,13,0,31
SIKKIM,2009,Divorcee,9,9,0,18
SIKKIM,2009,Seperated,18,9,0,27
SIKKIM,2009,Total,122,119,0,241
SIKKIM,2010,Never Married,96,15,0,111
SIKKIM,2010,Married,117,17,0,134
SIKKIM,2010,Widowed/Widower,10,7,0,17
SIKKIM,2010,Divorcee,5,2,0,7
SIKKIM,2010,Seperated,7,4,0,11
SIKKIM,2010,Total,235,45,0,280
SIKKIM,2011,Never Married,17,29,0,46
SIKKIM,2011,Married,82,36,0,118
SIKKIM,2011,Widowed/Widower,2,7,0,9
SIKKIM,2011,Divorcee,3,3,0,6
SIKKIM,2011,Seperated,3,2,0,5
SIKKIM,2011,Total,107,77,0,184
SIKKIM,2012,Never Married,23,20,0,43
SIKKIM,2012,Married,45,45,0,90
SIKKIM,2012,Widowed/Widower,7,10,0,17
SIKKIM,2012,Divorcee,13,5,0,18
SIKKIM,2012,Seperated,8,5,0,13
SIKKIM,2012,Total,96,85,0,181
TAMIL NADU,2001,Never Married,1379,795,0,2174
TAMIL NADU,2001,Married,4944,2833,0,7777
TAMIL NADU,2001,Widowed/Widower,377,304,0,681
TAMIL NADU,2001,Divorcee,49,35,0,84
TAMIL NADU,2001,Seperated,379,195,0,574
TAMIL NADU,2001,Total,7128,4162,0,11290
TAMIL NADU,2002,Never Married,1255,817,0,2072
TAMIL NADU,2002,Married,4863,2817,0,7680
TAMIL NADU,2002,Widowed/Widower,405,307,0,712
TAMIL NADU,2002,Divorcee,67,93,0,160
TAMIL NADU,2002,Seperated,393,227,0,620
TAMIL NADU,2002,Total,6983,4261,0,11244
TAMIL NADU,2003,Never Married,1311,914,0,2225
TAMIL NADU,2003,Married,4900,2963,0,7863
TAMIL NADU,2003,Widowed/Widower,435,369,0,804
TAMIL NADU,2003,Divorcee,36,80,0,116
TAMIL NADU,2003,Seperated,472,392,0,864
TAMIL NADU,2003,Total,7154,4718,0,11872
TAMIL NADU,2004,Never Married,1453,1026,0,2479
TAMIL NADU,2004,Married,5583,3151,0,8734
TAMIL NADU,2004,Widowed/Widower,481,453,0,934
TAMIL NADU,2004,Divorcee,92,91,0,183
TAMIL NADU,2004,Seperated,337,172,0,509
TAMIL NADU,2004,Total,7946,4893,0,12839
TAMIL NADU,2005,Never Married,1344,965,0,2309
TAMIL NADU,2005,Married,5400,2986,0,8386
TAMIL NADU,2005,Widowed/Widower,417,360,0,777
TAMIL NADU,2005,Divorcee,92,86,0,178
TAMIL NADU,2005,Seperated,254,172,0,426
TAMIL NADU,2005,Total,7507,4569,0,12076
TAMIL NADU,2006,Never Married,1197,827,0,2024
TAMIL NADU,2006,Married,5426,3452,0,8878
TAMIL NADU,2006,Widowed/Widower,399,288,0,687
TAMIL NADU,2006,Divorcee,70,65,0,135
TAMIL NADU,2006,Seperated,417,240,0,657
TAMIL NADU,2006,Total,7509,4872,0,12381
TAMIL NADU,2007,Never Married,1385,870,0,2255
TAMIL NADU,2007,Married,6277,3631,0,9908
TAMIL NADU,2007,Widowed/Widower,462,303,0,765
TAMIL NADU,2007,Divorcee,81,68,0,149
TAMIL NADU,2007,Seperated,482,252,0,734
TAMIL NADU,2007,Total,8687,5124,0,13811
TAMIL NADU,2008,Never Married,1442,914,0,2356
TAMIL NADU,2008,Married,6534,3814,0,10348
TAMIL NADU,2008,Widowed/Widower,481,318,0,799
TAMIL NADU,2008,Divorcee,84,71,0,155
TAMIL NADU,2008,Seperated,502,265,0,767
TAMIL NADU,2008,Total,9043,5382,0,14425
TAMIL NADU,2009,Never Married,1514,976,0,2490
TAMIL NADU,2009,Married,6373,3902,0,10275
TAMIL NADU,2009,Widowed/Widower,332,249,0,581
TAMIL NADU,2009,Divorcee,64,68,0,132
TAMIL NADU,2009,Seperated,667,279,0,946
TAMIL NADU,2009,Total,8950,5474,0,14424
TAMIL NADU,2010,Never Married,1861,1131,0,2992
TAMIL NADU,2010,Married,7423,4027,0,11450
TAMIL NADU,2010,Widowed/Widower,432,280,0,712
TAMIL NADU,2010,Divorcee,120,133,0,253
TAMIL NADU,2010,Seperated,716,438,0,1154
TAMIL NADU,2010,Total,10552,6009,0,16561
TAMIL NADU,2011,Never Married,1990,1040,0,3030
TAMIL NADU,2011,Married,7350,3919,0,11269
TAMIL NADU,2011,Widowed/Widower,177,279,0,456
TAMIL NADU,2011,Divorcee,38,70,0,108
TAMIL NADU,2011,Seperated,727,373,0,1100
TAMIL NADU,2011,Total,10282,5681,0,15963
TAMIL NADU,2012,Never Married,1614,985,0,2599
TAMIL NADU,2012,Married,8122,4315,0,12437
TAMIL NADU,2012,Widowed/Widower,311,295,0,606
TAMIL NADU,2012,Divorcee,39,85,0,124
TAMIL NADU,2012,Seperated,662,499,0,1161
TAMIL NADU,2012,Total,10748,6179,0,16927
TELANGANA,2001,Never Married,0,0,0,0
TELANGANA,2001,Married,0,0,0,0
TELANGANA,2001,Widowed/Widower,0,0,0,0
TELANGANA,2001,Divorcee,0,0,0,0
TELANGANA,2001,Seperated,0,0,0,0
TELANGANA,2001,Total,0,0,0,0
TELANGANA,2002,Never Married,0,0,0,0
TELANGANA,2002,Married,0,0,0,0
TELANGANA,2002,Widowed/Widower,0,0,0,0
TELANGANA,2002,Divorcee,0,0,0,0
TELANGANA,2002,Seperated,0,0,0,0
TELANGANA,2002,Total,0,0,0,0
TELANGANA,2003,Never Married,0,0,0,0
TELANGANA,2003,Married,0,0,0,0
TELANGANA,2003,Widowed/Widower,0,0,0,0
TELANGANA,2003,Divorcee,0,0,0,0
TELANGANA,2003,Seperated,0,0,0,0
TELANGANA,2003,Total,0,0,0,0
TELANGANA,2004,Never Married,0,0,0,0
TELANGANA,2004,Married,0,0,0,0
TELANGANA,2004,Widowed/Widower,0,0,0,0
TELANGANA,2004,Divorcee,0,0,0,0
TELANGANA,2004,Seperated,0,0,0,0
TELANGANA,2004,Total,0,0,0,0
TELANGANA,2005,Never Married,0,0,0,0
TELANGANA,2005,Married,0,0,0,0
TELANGANA,2005,Widowed/Widower,0,0,0,0
TELANGANA,2005,Divorcee,0,0,0,0
TELANGANA,2005,Seperated,0,0,0,0
TELANGANA,2005,Total,0,0,0,0
TELANGANA,2006,Never Married,0,0,0,0
TELANGANA,2006,Married,0,0,0,0
TELANGANA,2006,Widowed/Widower,0,0,0,0
TELANGANA,2006,Divorcee,0,0,0,0
TELANGANA,2006,Seperated,0,0,0,0
TELANGANA,2006,Total,0,0,0,0
TELANGANA,2007,Never Married,0,0,0,0
TELANGANA,2007,Married,0,0,0,0
TELANGANA,2007,Widowed/Widower,0,0,0,0
TELANGANA,2007,Divorcee,0,0,0,0
TELANGANA,2007,Seperated,0,0,0,0
TELANGANA,2007,Total,0,0,0,0
TELANGANA,2008,Never Married,0,0,0,0
TELANGANA,2008,Married,0,0,0,0
TELANGANA,2008,Widowed/Widower,0,0,0,0
TELANGANA,2008,Divorcee,0,0,0,0
TELANGANA,2008,Seperated,0,0,0,0
TELANGANA,2008,Total,0,0,0,0
TELANGANA,2009,Never Married,0,0,0,0
TELANGANA,2009,Married,0,0,0,0
TELANGANA,2009,Widowed/Widower,0,0,0,0
TELANGANA,2009,Divorcee,0,0,0,0
TELANGANA,2009,Seperated,0,0,0,0
TELANGANA,2009,Total,0,0,0,0
TELANGANA,2010,Never Married,0,0,0,0
TELANGANA,2010,Married,0,0,0,0
TELANGANA,2010,Widowed/Widower,0,0,0,0
TELANGANA,2010,Divorcee,0,0,0,0
TELANGANA,2010,Seperated,0,0,0,0
TELANGANA,2010,Total,0,0,0,0
TELANGANA,2011,Never Married,0,0,0,0
TELANGANA,2011,Married,0,0,0,0
TELANGANA,2011,Widowed/Widower,0,0,0,0
TELANGANA,2011,Divorcee,0,0,0,0
TELANGANA,2011,Seperated,0,0,0,0
TELANGANA,2011,Total,0,0,0,0
TELANGANA,2012,Never Married,0,0,0,0
TELANGANA,2012,Married,0,0,0,0
TELANGANA,2012,Widowed/Widower,0,0,0,0
TELANGANA,2012,Divorcee,0,0,0,0
TELANGANA,2012,Seperated,0,0,0,0
TELANGANA,2012,Total,0,0,0,0
TRIPURA,2001,Never Married,157,96,0,253
TRIPURA,2001,Married,270,250,0,520
TRIPURA,2001,Widowed/Widower,12,19,0,31
TRIPURA,2001,Divorcee,6,10,0,16
TRIPURA,2001,Seperated,18,16,0,34
TRIPURA,2001,Total,463,391,0,854
TRIPURA,2002,Never Married,186,93,0,279
TRIPURA,2002,Married,227,129,0,356
TRIPURA,2002,Widowed/Widower,32,31,0,63
TRIPURA,2002,Divorcee,8,7,0,15
TRIPURA,2002,Seperated,40,26,0,66
TRIPURA,2002,Total,493,286,0,779
TRIPURA,2003,Never Married,257,54,0,311
TRIPURA,2003,Married,219,295,0,514
TRIPURA,2003,Widowed/Widower,7,0,0,7
TRIPURA,2003,Divorcee,2,2,0,4
TRIPURA,2003,Seperated,3,5,0,8
TRIPURA,2003,Total,488,356,0,844
TRIPURA,2004,Never Married,189,136,0,325
TRIPURA,2004,Married,207,177,0,384
TRIPURA,2004,Widowed/Widower,25,20,0,45
TRIPURA,2004,Divorcee,4,4,0,8
TRIPURA,2004,Seperated,8,0,0,8
TRIPURA,2004,Total,433,337,0,770
TRIPURA,2005,Never Married,132,94,0,226
TRIPURA,2005,Married,202,162,0,364
TRIPURA,2005,Widowed/Widower,39,32,0,71
TRIPURA,2005,Divorcee,18,18,0,36
TRIPURA,2005,Seperated,10,8,0,18
TRIPURA,2005,Total,401,314,0,715
TRIPURA,2006,Never Married,193,147,0,340
TRIPURA,2006,Married,229,154,0,383
TRIPURA,2006,Widowed/Widower,6,36,0,42
TRIPURA,2006,Divorcee,0,0,0,0
TRIPURA,2006,Seperated,0,0,0,0
TRIPURA,2006,Total,428,337,0,765
TRIPURA,2007,Never Married,87,80,0,167
TRIPURA,2007,Married,323,194,0,517
TRIPURA,2007,Widowed/Widower,9,12,0,21
TRIPURA,2007,Divorcee,0,0,0,0
TRIPURA,2007,Seperated,0,0,0,0
TRIPURA,2007,Total,419,286,0,705
TRIPURA,2008,Never Married,99,60,0,159
TRIPURA,2008,Married,343,241,0,584
TRIPURA,2008,Widowed/Widower,0,9,0,9
TRIPURA,2008,Divorcee,0,0,0,0
TRIPURA,2008,Seperated,0,0,0,0
TRIPURA,2008,Total,442,310,0,752
TRIPURA,2009,Never Married,132,78,0,210
TRIPURA,2009,Married,324,185,0,509
TRIPURA,2009,Widowed/Widower,8,8,0,16
TRIPURA,2009,Divorcee,0,0,0,0
TRIPURA,2009,Seperated,3,0,0,3
TRIPURA,2009,Total,467,271,0,738
TRIPURA,2010,Never Married,95,97,0,192
TRIPURA,2010,Married,346,178,0,524
TRIPURA,2010,Widowed/Widower,0,9,0,9
TRIPURA,2010,Divorcee,0,0,0,0
TRIPURA,2010,Seperated,0,0,0,0
TRIPURA,2010,Total,441,284,0,725
TRIPURA,2011,Never Married,93,76,0,169
TRIPURA,2011,Married,332,162,0,494
TRIPURA,2011,Widowed/Widower,0,4,0,4
TRIPURA,2011,Divorcee,0,0,0,0
TRIPURA,2011,Seperated,22,14,0,36
TRIPURA,2011,Total,447,256,0,703
TRIPURA,2012,Never Married,144,73,0,217
TRIPURA,2012,Married,387,186,0,573
TRIPURA,2012,Widowed/Widower,9,11,0,20
TRIPURA,2012,Divorcee,0,0,0,0
TRIPURA,2012,Seperated,20,14,0,34
TRIPURA,2012,Total,560,284,0,844
UTTAR PRADESH,2001,Never Married,376,381,0,757
UTTAR PRADESH,2001,Married,1294,1184,0,2478
UTTAR PRADESH,2001,Widowed/Widower,75,75,0,150
UTTAR PRADESH,2001,Divorcee,17,16,0,33
UTTAR PRADESH,2001,Seperated,39,59,0,98
UTTAR PRADESH,2001,Total,1801,1715,0,3516
UTTAR PRADESH,2002,Never Married,578,410,0,988
UTTAR PRADESH,2002,Married,1490,1302,0,2792
UTTAR PRADESH,2002,Widowed/Widower,158,145,0,303
UTTAR PRADESH,2002,Divorcee,45,24,0,69
UTTAR PRADESH,2002,Seperated,55,43,0,98
UTTAR PRADESH,2002,Total,2326,1924,0,4250
UTTAR PRADESH,2003,Never Married,523,375,0,898
UTTAR PRADESH,2003,Married,1328,1163,0,2491
UTTAR PRADESH,2003,Widowed/Widower,78,83,0,161
UTTAR PRADESH,2003,Divorcee,21,26,0,47
UTTAR PRADESH,2003,Seperated,37,29,0,66
UTTAR PRADESH,2003,Total,1987,1676,0,3663
UTTAR PRADESH,2004,Never Married,537,337,0,874
UTTAR PRADESH,2004,Married,1301,1179,0,2480
UTTAR PRADESH,2004,Widowed/Widower,57,98,0,155
UTTAR PRADESH,2004,Divorcee,23,15,0,38
UTTAR PRADESH,2004,Seperated,36,54,0,90
UTTAR PRADESH,2004,Total,1954,1683,0,3637
UTTAR PRADESH,2005,Never Married,457,326,0,783
UTTAR PRADESH,2005,Married,1195,1214,0,2409
UTTAR PRADESH,2005,Widowed/Widower,70,68,0,138
UTTAR PRADESH,2005,Divorcee,12,24,0,36
UTTAR PRADESH,2005,Seperated,38,45,0,83
UTTAR PRADESH,2005,Total,1772,1677,0,3449
UTTAR PRADESH,2006,Never Married,534,279,0,813
UTTAR PRADESH,2006,Married,1079,974,0,2053
UTTAR PRADESH,2006,Widowed/Widower,60,44,0,104
UTTAR PRADESH,2006,Divorcee,9,16,0,25
UTTAR PRADESH,2006,Seperated,79,25,0,104
UTTAR PRADESH,2006,Total,1761,1338,0,3099
UTTAR PRADESH,2007,Never Married,599,373,0,972
UTTAR PRADESH,2007,Married,1253,1305,0,2558
UTTAR PRADESH,2007,Widowed/Widower,79,103,0,182
UTTAR PRADESH,2007,Divorcee,13,42,0,55
UTTAR PRADESH,2007,Seperated,110,50,0,160
UTTAR PRADESH,2007,Total,2054,1873,0,3927
UTTAR PRADESH,2008,Never Married,541,437,0,978
UTTAR PRADESH,2008,Married,1471,1344,0,2815
UTTAR PRADESH,2008,Widowed/Widower,101,78,0,179
UTTAR PRADESH,2008,Divorcee,18,27,0,45
UTTAR PRADESH,2008,Seperated,48,23,0,71
UTTAR PRADESH,2008,Total,2179,1909,0,4088
UTTAR PRADESH,2009,Never Married,529,404,0,933
UTTAR PRADESH,2009,Married,1532,1322,0,2854
UTTAR PRADESH,2009,Widowed/Widower,108,114,0,222
UTTAR PRADESH,2009,Divorcee,20,37,0,57
UTTAR PRADESH,2009,Seperated,50,42,0,92
UTTAR PRADESH,2009,Total,2239,1919,0,4158
UTTAR PRADESH,2010,Never Married,554,425,0,979
UTTAR PRADESH,2010,Married,1083,1254,0,2337
UTTAR PRADESH,2010,Widowed/Widower,74,75,0,149
UTTAR PRADESH,2010,Divorcee,25,34,0,59
UTTAR PRADESH,2010,Seperated,51,53,0,104
UTTAR PRADESH,2010,Total,1787,1841,0,3628
UTTAR PRADESH,2011,Never Married,664,440,0,1104
UTTAR PRADESH,2011,Married,1847,1515,0,3362
UTTAR PRADESH,2011,Widowed/Widower,118,76,0,194
UTTAR PRADESH,2011,Divorcee,15,36,0,51
UTTAR PRADESH,2011,Seperated,69,63,0,132
UTTAR PRADESH,2011,Total,2713,2130,0,4843
UTTAR PRADESH,2012,Never Married,625,518,0,1143
UTTAR PRADESH,2012,Married,1546,1216,0,2762
UTTAR PRADESH,2012,Widowed/Widower,204,103,0,307
UTTAR PRADESH,2012,Divorcee,19,52,0,71
UTTAR PRADESH,2012,Seperated,101,38,0,139
UTTAR PRADESH,2012,Total,2495,1927,0,4422
UTTARAKHAND,2001,Never Married,40,40,0,80
UTTARAKHAND,2001,Married,139,79,0,218
UTTARAKHAND,2001,Widowed/Widower,1,5,0,6
UTTARAKHAND,2001,Divorcee,0,4,0,4
UTTARAKHAND,2001,Seperated,2,1,0,3
UTTARAKHAND,2001,Total,182,129,0,311
UTTARAKHAND,2002,Never Married,60,29,0,89
UTTARAKHAND,2002,Married,136,120,0,256
UTTARAKHAND,2002,Widowed/Widower,6,4,0,10
UTTARAKHAND,2002,Divorcee,2,2,0,4
UTTARAKHAND,2002,Seperated,1,1,0,2
UTTARAKHAND,2002,Total,205,156,0,361
UTTARAKHAND,2003,Never Married,85,36,0,121
UTTARAKHAND,2003,Married,165,81,0,246
UTTARAKHAND,2003,Widowed/Widower,7,7,0,14
UTTARAKHAND,2003,Divorcee,1,5,0,6
UTTARAKHAND,2003,Seperated,4,0,0,4
UTTARAKHAND,2003,Total,262,129,0,391
UTTARAKHAND,2004,Never Married,44,16,0,60
UTTARAKHAND,2004,Married,91,63,0,154
UTTARAKHAND,2004,Widowed/Widower,10,4,0,14
UTTARAKHAND,2004,Divorcee,1,4,0,5
UTTARAKHAND,2004,Seperated,2,2,0,4
UTTARAKHAND,2004,Total,148,89,0,237
UTTARAKHAND,2005,Never Married,65,26,0,91
UTTARAKHAND,2005,Married,105,55,0,160
UTTARAKHAND,2005,Widowed/Widower,6,10,0,16
UTTARAKHAND,2005,Divorcee,1,2,0,3
UTTARAKHAND,2005,Seperated,3,0,0,3
UTTARAKHAND,2005,Total,180,93,0,273
UTTARAKHAND,2006,Never Married,40,47,0,87
UTTARAKHAND,2006,Married,101,79,0,180
UTTARAKHAND,2006,Widowed/Widower,15,14,0,29
UTTARAKHAND,2006,Divorcee,10,6,0,16
UTTARAKHAND,2006,Seperated,7,7,0,14
UTTARAKHAND,2006,Total,173,153,0,326
UTTARAKHAND,2007,Never Married,33,23,0,56
UTTARAKHAND,2007,Married,75,75,0,150
UTTARAKHAND,2007,Widowed/Widower,11,12,0,23
UTTARAKHAND,2007,Divorcee,6,5,0,11
UTTARAKHAND,2007,Seperated,5,3,0,8
UTTARAKHAND,2007,Total,130,118,0,248
UTTARAKHAND,2008,Never Married,28,28,0,56
UTTARAKHAND,2008,Married,69,54,0,123
UTTARAKHAND,2008,Widowed/Widower,3,3,0,6
UTTARAKHAND,2008,Divorcee,2,1,0,3
UTTARAKHAND,2008,Seperated,2,1,0,3
UTTARAKHAND,2008,Total,104,87,0,191
UTTARAKHAND,2009,Never Married,56,36,0,92
UTTARAKHAND,2009,Married,137,96,0,233
UTTARAKHAND,2009,Widowed/Widower,3,3,0,6
UTTARAKHAND,2009,Divorcee,1,1,0,2
UTTARAKHAND,2009,Seperated,5,4,0,9
UTTARAKHAND,2009,Total,202,140,0,342
UTTARAKHAND,2010,Never Married,39,34,0,73
UTTARAKHAND,2010,Married,118,82,0,200
UTTARAKHAND,2010,Widowed/Widower,4,0,0,4
UTTARAKHAND,2010,Divorcee,0,0,0,0
UTTARAKHAND,2010,Seperated,3,1,0,4
UTTARAKHAND,2010,Total,164,117,0,281
UTTARAKHAND,2011,Never Married,72,43,0,115
UTTARAKHAND,2011,Married,104,78,0,182
UTTARAKHAND,2011,Widowed/Widower,7,3,0,10
UTTARAKHAND,2011,Divorcee,3,0,0,3
UTTARAKHAND,2011,Seperated,6,1,0,7
UTTARAKHAND,2011,Total,192,125,0,317
UTTARAKHAND,2012,Never Married,96,44,0,140
UTTARAKHAND,2012,Married,134,122,0,256
UTTARAKHAND,2012,Widowed/Widower,17,3,0,20
UTTARAKHAND,2012,Divorcee,0,6,0,6
UTTARAKHAND,2012,Seperated,2,0,0,2
UTTARAKHAND,2012,Total,249,175,0,424
WEST BENGAL,2001,Never Married,2028,1853,0,3881
WEST BENGAL,2001,Married,4385,3557,0,7942
WEST BENGAL,2001,Widowed/Widower,432,435,0,867
WEST BENGAL,2001,Divorcee,337,175,0,512
WEST BENGAL,2001,Seperated,313,175,0,488
WEST BENGAL,2001,Total,7495,6195,0,13690
WEST BENGAL,2002,Never Married,2057,1633,0,3690
WEST BENGAL,2002,Married,4266,3276,0,7542
WEST BENGAL,2002,Widowed/Widower,446,563,0,1009
WEST BENGAL,2002,Divorcee,190,155,0,345
WEST BENGAL,2002,Seperated,165,256,0,421
WEST BENGAL,2002,Total,7124,5883,0,13007
WEST BENGAL,2003,Never Married,1952,1106,0,3058
WEST BENGAL,2003,Married,4980,4212,0,9192
WEST BENGAL,2003,Widowed/Widower,282,307,0,589
WEST BENGAL,2003,Divorcee,109,117,0,226
WEST BENGAL,2003,Seperated,101,114,0,215
WEST BENGAL,2003,Total,7424,5856,0,13280
WEST BENGAL,2004,Never Married,2084,1270,0,3354
WEST BENGAL,2004,Married,4854,3833,0,8687
WEST BENGAL,2004,Widowed/Widower,264,316,0,580
WEST BENGAL,2004,Divorcee,139,94,0,233
WEST BENGAL,2004,Seperated,320,250,0,570
WEST BENGAL,2004,Total,7661,5763,0,13424
WEST BENGAL,2005,Never Married,1934,1137,0,3071
WEST BENGAL,2005,Married,6010,4520,0,10530
WEST BENGAL,2005,Widowed/Widower,254,426,0,680
WEST BENGAL,2005,Divorcee,142,158,0,300
WEST BENGAL,2005,Seperated,274,160,0,434
WEST BENGAL,2005,Total,8614,6401,0,15015
WEST BENGAL,2006,Never Married,1650,944,0,2594
WEST BENGAL,2006,Married,6933,4967,0,11900
WEST BENGAL,2006,Widowed/Widower,303,385,0,688
WEST BENGAL,2006,Divorcee,126,198,0,324
WEST BENGAL,2006,Seperated,108,111,0,219
WEST BENGAL,2006,Total,9120,6605,0,15725
WEST BENGAL,2007,Never Married,2154,1208,0,3362
WEST BENGAL,2007,Married,5637,4377,0,10014
WEST BENGAL,2007,Widowed/Widower,291,412,0,703
WEST BENGAL,2007,Divorcee,75,155,0,230
WEST BENGAL,2007,Seperated,348,203,0,551
WEST BENGAL,2007,Total,8505,6355,0,14860
WEST BENGAL,2008,Never Married,2844,1580,0,4424
WEST BENGAL,2008,Married,5182,4265,0,9447
WEST BENGAL,2008,Widowed/Widower,172,440,0,612
WEST BENGAL,2008,Divorcee,78,98,0,176
WEST BENGAL,2008,Seperated,93,100,0,193
WEST BENGAL,2008,Total,8369,6483,0,14852
WEST BENGAL,2009,Never Married,2580,1354,0,3934
WEST BENGAL,2009,Married,5521,4133,0,9654
WEST BENGAL,2009,Widowed/Widower,190,399,0,589
WEST BENGAL,2009,Divorcee,76,147,0,223
WEST BENGAL,2009,Seperated,127,121,0,248
WEST BENGAL,2009,Total,8494,6154,0,14648
WEST BENGAL,2010,Never Married,2941,1766,0,4707
WEST BENGAL,2010,Married,5938,4331,0,10269
WEST BENGAL,2010,Widowed/Widower,184,331,0,515
WEST BENGAL,2010,Divorcee,65,146,0,211
WEST BENGAL,2010,Seperated,173,162,0,335
WEST BENGAL,2010,Total,9301,6736,0,16037
WEST BENGAL,2011,Never Married,2973,1718,0,4691
WEST BENGAL,2011,Married,6072,4415,0,10487
WEST BENGAL,2011,Widowed/Widower,251,409,0,660
WEST BENGAL,2011,Divorcee,61,213,0,274
WEST BENGAL,2011,Seperated,267,113,0,380
WEST BENGAL,2011,Total,9624,6868,0,16492
WEST BENGAL,2012,Never Married,2658,1513,0,4171
WEST BENGAL,2012,Married,5451,3927,0,9378
WEST BENGAL,2012,Widowed/Widower,233,455,0,688
WEST BENGAL,2012,Divorcee,189,182,0,371
WEST BENGAL,2012,Seperated,149,200,0,349
WEST BENGAL,2012,Total,8680,6277,0,14957
TOTAL (STATES),2001,Never Married,14204,9375,0,23579
TOTAL (STATES),2001,Married,45932,27702,0,73634
TOTAL (STATES),2001,Widowed/Widower,2365,2531,0,4896
TOTAL (STATES),2001,Divorcee,708,642,0,1350
TOTAL (STATES),2001,Seperated,1889,1127,0,3016
TOTAL (STATES),2001,Total,65098,41377,0,106475
TOTAL (STATES),2002,Never Married,14701,9039,0,23740
TOTAL (STATES),2002,Married,47527,26483,0,74010
TOTAL (STATES),2002,Widowed/Widower,3311,3007,0,6318
TOTAL (STATES),2002,Divorcee,684,672,0,1356
TOTAL (STATES),2002,Seperated,1865,1210,0,3075
TOTAL (STATES),2002,Total,68088,40411,0,108499
TOTAL (STATES),2003,Never Married,14956,8573,0,23529
TOTAL (STATES),2003,Married,48656,27143,0,75799
TOTAL (STATES),2003,Widowed/Widower,2910,2553,0,5463
TOTAL (STATES),2003,Divorcee,588,534,0,1122
TOTAL (STATES),2003,Seperated,1795,1114,0,2909
TOTAL (STATES),2003,Total,68905,39917,0,108822
TOTAL (STATES),2004,Never Married,15397,8557,0,23954
TOTAL (STATES),2004,Married,50731,27589,0,78320
TOTAL (STATES),2004,Widowed/Widower,2351,2360,0,4711
TOTAL (STATES),2004,Divorcee,663,531,0,1194
TOTAL (STATES),2004,Seperated,2214,1260,0,3474
TOTAL (STATES),2004,Total,71356,40297,0,111653
TOTAL (STATES),2005,Never Married,14930,8372,0,23302
TOTAL (STATES),2005,Married,51573,27686,0,79259
TOTAL (STATES),2005,Widowed/Widower,2653,2388,0,5041
TOTAL (STATES),2005,Divorcee,559,562,0,1121
TOTAL (STATES),2005,Seperated,1869,1210,0,3079
TOTAL (STATES),2005,Total,71584,40218,0,111802
TOTAL (STATES),2006,Never Married,15195,8556,0,23751
TOTAL (STATES),2006,Married,54437,29347,0,83784
TOTAL (STATES),2006,Widowed/Widower,2382,2220,0,4602
TOTAL (STATES),2006,Divorcee,514,587,0,1101
TOTAL (STATES),2006,Seperated,1675,902,0,2577
TOTAL (STATES),2006,Total,74203,41612,0,115815
TOTAL (STATES),2007,Never Married,16055,8738,0,24793
TOTAL (STATES),2007,Married,56540,29531,0,86071
TOTAL (STATES),2007,Widowed/Widower,2642,2341,0,4983
TOTAL (STATES),2007,Divorcee,525,643,0,1168
TOTAL (STATES),2007,Seperated,2037,1255,0,3292
TOTAL (STATES),2007,Total,77799,42508,0,120307
TOTAL (STATES),2008,Never Married,17447,9594,0,27041
TOTAL (STATES),2008,Married,56734,29736,0,86470
TOTAL (STATES),2008,Widowed/Widower,2599,2701,0,5300
TOTAL (STATES),2008,Divorcee,726,673,0,1399
TOTAL (STATES),2008,Seperated,1707,985,0,2692
TOTAL (STATES),2008,Total,79213,43689,0,122902
TOTAL (STATES),2009,Never Married,17381,9803,0,27184
TOTAL (STATES),2009,Married,57195,30754,0,87949
TOTAL (STATES),2009,Widowed/Widower,2819,2651,0,5470
TOTAL (STATES),2009,Divorcee,630,612,0,1242
TOTAL (STATES),2009,Seperated,2012,1013,0,3025
TOTAL (STATES),2009,Total,80037,44833,0,124870
TOTAL (STATES),2010,Never Married,19293,10849,0,30142
TOTAL (STATES),2010,Married,60449,31177,0,91626
TOTAL (STATES),2010,Widowed/Widower,2756,2348,0,5104
TOTAL (STATES),2010,Divorcee,724,777,0,1501
TOTAL (STATES),2010,Seperated,2465,1388,0,3853
TOTAL (STATES),2010,Total,85687,46539,0,132226
TOTAL (STATES),2011,Never Married,19404,10479,0,29883
TOTAL (STATES),2011,Married,61242,32070,0,93312
TOTAL (STATES),2011,Widowed/Widower,2542,2333,0,4875
TOTAL (STATES),2011,Divorcee,551,725,0,1276
TOTAL (STATES),2011,Seperated,2326,1303,0,3629
TOTAL (STATES),2011,Total,86065,46910,0,132975
TOTAL (STATES),2012,Never Married,19158,10528,0,29686
TOTAL (STATES),2012,Married,62123,31335,0,93458
TOTAL (STATES),2012,Widowed/Widower,2651,2269,0,4920
TOTAL (STATES),2012,Divorcee,680,705,0,1385
TOTAL (STATES),2012,Seperated,2001,1217,0,3218
TOTAL (STATES),2012,Total,86613,46054,0,132667
A & N ISLANDS,2001,Never Married,24,12,0,36
A & N ISLANDS,2001,Married,55,38,0,93
A & N ISLANDS,2001,Widowed/Widower,0,0,0,0
A & N ISLANDS,2001,Divorcee,0,0,0,0
A & N ISLANDS,2001,Seperated,0,0,0,0
A & N ISLANDS,2001,Total,79,50,0,129
A & N ISLANDS,2002,Never Married,37,17,0,54
A & N ISLANDS,2002,Married,54,36,0,90
A & N ISLANDS,2002,Widowed/Widower,0,0,0,0
A & N ISLANDS,2002,Divorcee,0,0,0,0
A & N ISLANDS,2002,Seperated,0,0,0,0
A & N ISLANDS,2002,Total,91,53,0,144
A & N ISLANDS,2003,Never Married,19,15,0,34
A & N ISLANDS,2003,Married,51,28,0,79
A & N ISLANDS,2003,Widowed/Widower,0,0,0,0
A & N ISLANDS,2003,Divorcee,0,0,0,0
A & N ISLANDS,2003,Seperated,0,0,0,0
A & N ISLANDS,2003,Total,70,43,0,113
A & N ISLANDS,2004,Never Married,23,15,0,38
A & N ISLANDS,2004,Married,57,26,0,83
A & N ISLANDS,2004,Widowed/Widower,0,0,0,0
A & N ISLANDS,2004,Divorcee,1,0,0,1
A & N ISLANDS,2004,Seperated,0,0,0,0
A & N ISLANDS,2004,Total,81,41,0,122
A & N ISLANDS,2005,Never Married,25,18,0,43
A & N ISLANDS,2005,Married,60,35,0,95
A & N ISLANDS,2005,Widowed/Widower,1,0,0,1
A & N ISLANDS,2005,Divorcee,0,0,0,0
A & N ISLANDS,2005,Seperated,0,0,0,0
A & N ISLANDS,2005,Total,86,53,0,139
A & N ISLANDS,2006,Never Married,47,10,0,57
A & N ISLANDS,2006,Married,49,27,0,76
A & N ISLANDS,2006,Widowed/Widower,0,0,0,0
A & N ISLANDS,2006,Divorcee,0,0,0,0
A & N ISLANDS,2006,Seperated,0,0,0,0
A & N ISLANDS,2006,Total,96,37,0,133
A & N ISLANDS,2007,Never Married,45,23,0,68
A & N ISLANDS,2007,Married,55,33,0,88
A & N ISLANDS,2007,Widowed/Widower,0,0,0,0
A & N ISLANDS,2007,Divorcee,0,0,0,0
A & N ISLANDS,2007,Seperated,0,0,0,0
A & N ISLANDS,2007,Total,100,56,0,156
A & N ISLANDS,2008,Never Married,27,12,0,39
A & N ISLANDS,2008,Married,71,33,0,104
A & N ISLANDS,2008,Widowed/Widower,0,0,0,0
A & N ISLANDS,2008,Divorcee,0,0,0,0
A & N ISLANDS,2008,Seperated,0,0,0,0
A & N ISLANDS,2008,Total,98,45,0,143
A & N ISLANDS,2009,Never Married,20,17,0,37
A & N ISLANDS,2009,Married,66,28,0,94
A & N ISLANDS,2009,Widowed/Widower,0,0,0,0
A & N ISLANDS,2009,Divorcee,0,0,0,0
A & N ISLANDS,2009,Seperated,0,0,0,0
A & N ISLANDS,2009,Total,86,45,0,131
A & N ISLANDS,2010,Never Married,42,11,0,53
A & N ISLANDS,2010,Married,64,31,0,95
A & N ISLANDS,2010,Widowed/Widower,3,2,0,5
A & N ISLANDS,2010,Divorcee,1,0,0,1
A & N ISLANDS,2010,Seperated,2,0,0,2
A & N ISLANDS,2010,Total,112,44,0,156
A & N ISLANDS,2011,Never Married,20,15,0,35
A & N ISLANDS,2011,Married,73,26,0,99
A & N ISLANDS,2011,Widowed/Widower,0,0,0,0
A & N ISLANDS,2011,Divorcee,0,1,0,1
A & N ISLANDS,2011,Seperated,1,0,0,1
A & N ISLANDS,2011,Total,94,42,0,136
A & N ISLANDS,2012,Never Married,28,11,0,39
A & N ISLANDS,2012,Married,52,30,0,82
A & N ISLANDS,2012,Widowed/Widower,0,0,0,0
A & N ISLANDS,2012,Divorcee,0,0,0,0
A & N ISLANDS,2012,Seperated,0,0,0,0
A & N ISLANDS,2012,Total,80,41,0,121
CHANDIGARH,2001,Never Married,5,6,0,11
CHANDIGARH,2001,Married,34,25,0,59
CHANDIGARH,2001,Widowed/Widower,0,0,0,0
CHANDIGARH,2001,Divorcee,0,0,0,0
CHANDIGARH,2001,Seperated,0,0,0,0
CHANDIGARH,2001,Total,39,31,0,70
CHANDIGARH,2002,Never Married,19,12,0,31
CHANDIGARH,2002,Married,34,22,0,56
CHANDIGARH,2002,Widowed/Widower,0,0,0,0
CHANDIGARH,2002,Divorcee,0,0,0,0
CHANDIGARH,2002,Seperated,0,0,0,0
CHANDIGARH,2002,Total,53,34,0,87
CHANDIGARH,2003,Never Married,18,13,0,31
CHANDIGARH,2003,Married,50,22,0,72
CHANDIGARH,2003,Widowed/Widower,0,0,0,0
CHANDIGARH,2003,Divorcee,0,0,0,0
CHANDIGARH,2003,Seperated,0,0,0,0
CHANDIGARH,2003,Total,68,35,0,103
CHANDIGARH,2004,Never Married,18,10,0,28
CHANDIGARH,2004,Married,34,13,0,47
CHANDIGARH,2004,Widowed/Widower,0,0,0,0
CHANDIGARH,2004,Divorcee,0,0,0,0
CHANDIGARH,2004,Seperated,0,0,0,0
CHANDIGARH,2004,Total,52,23,0,75
CHANDIGARH,2005,Never Married,26,11,0,37
CHANDIGARH,2005,Married,37,15,0,52
CHANDIGARH,2005,Widowed/Widower,0,0,0,0
CHANDIGARH,2005,Divorcee,0,0,0,0
CHANDIGARH,2005,Seperated,0,0,0,0
CHANDIGARH,2005,Total,63,26,0,89
CHANDIGARH,2006,Never Married,27,14,0,41
CHANDIGARH,2006,Married,29,10,0,39
CHANDIGARH,2006,Widowed/Widower,0,0,0,0
CHANDIGARH,2006,Divorcee,0,0,0,0
CHANDIGARH,2006,Seperated,0,0,0,0
CHANDIGARH,2006,Total,56,24,0,80
CHANDIGARH,2007,Never Married,19,2,0,21
CHANDIGARH,2007,Married,41,20,0,61
CHANDIGARH,2007,Widowed/Widower,0,0,0,0
CHANDIGARH,2007,Divorcee,0,0,0,0
CHANDIGARH,2007,Seperated,0,0,0,0
CHANDIGARH,2007,Total,60,22,0,82
CHANDIGARH,2008,Never Married,17,8,0,25
CHANDIGARH,2008,Married,41,16,0,57
CHANDIGARH,2008,Widowed/Widower,0,0,0,0
CHANDIGARH,2008,Divorcee,0,1,0,1
CHANDIGARH,2008,Seperated,0,0,0,0
CHANDIGARH,2008,Total,58,25,0,83
CHANDIGARH,2009,Never Married,11,14,0,25
CHANDIGARH,2009,Married,33,17,0,50
CHANDIGARH,2009,Widowed/Widower,0,0,0,0
CHANDIGARH,2009,Divorcee,0,0,0,0
CHANDIGARH,2009,Seperated,0,0,0,0
CHANDIGARH,2009,Total,44,31,0,75
CHANDIGARH,2010,Never Married,10,17,0,27
CHANDIGARH,2010,Married,21,23,0,44
CHANDIGARH,2010,Widowed/Widower,0,0,0,0
CHANDIGARH,2010,Divorcee,0,0,0,0
CHANDIGARH,2010,Seperated,0,0,0,0
CHANDIGARH,2010,Total,31,40,0,71
CHANDIGARH,2011,Never Married,22,18,0,40
CHANDIGARH,2011,Married,35,30,0,65
CHANDIGARH,2011,Widowed/Widower,0,0,0,0
CHANDIGARH,2011,Divorcee,0,0,0,0
CHANDIGARH,2011,Seperated,0,0,0,0
CHANDIGARH,2011,Total,57,48,0,105
CHANDIGARH,2012,Never Married,26,20,0,46
CHANDIGARH,2012,Married,49,18,0,67
CHANDIGARH,2012,Widowed/Widower,0,0,0,0
CHANDIGARH,2012,Divorcee,0,1,0,1
CHANDIGARH,2012,Seperated,0,0,0,0
CHANDIGARH,2012,Total,75,39,0,114
D & N HAVELI,2001,Never Married,8,2,0,10
D & N HAVELI,2001,Married,27,13,0,40
D & N HAVELI,2001,Widowed/Widower,0,0,0,0
D & N HAVELI,2001,Divorcee,0,0,0,0
D & N HAVELI,2001,Seperated,0,0,0,0
D & N HAVELI,2001,Total,35,15,0,50
D & N HAVELI,2002,Never Married,5,6,0,11
D & N HAVELI,2002,Married,27,11,0,38
D & N HAVELI,2002,Widowed/Widower,0,1,0,1
D & N HAVELI,2002,Divorcee,0,0,0,0
D & N HAVELI,2002,Seperated,0,0,0,0
D & N HAVELI,2002,Total,32,18,0,50
D & N HAVELI,2003,Never Married,9,1,0,10
D & N HAVELI,2003,Married,18,20,0,38
D & N HAVELI,2003,Widowed/Widower,2,0,0,2
D & N HAVELI,2003,Divorcee,0,1,0,1
D & N HAVELI,2003,Seperated,1,0,0,1
D & N HAVELI,2003,Total,30,22,0,52
D & N HAVELI,2004,Never Married,4,2,0,6
D & N HAVELI,2004,Married,16,17,0,33
D & N HAVELI,2004,Widowed/Widower,0,0,0,0
D & N HAVELI,2004,Divorcee,0,0,0,0
D & N HAVELI,2004,Seperated,0,0,0,0
D & N HAVELI,2004,Total,20,19,0,39
D & N HAVELI,2005,Never Married,5,3,0,8
D & N HAVELI,2005,Married,36,24,0,60
D & N HAVELI,2005,Widowed/Widower,0,1,0,1
D & N HAVELI,2005,Divorcee,0,0,0,0
D & N HAVELI,2005,Seperated,0,0,0,0
D & N HAVELI,2005,Total,41,28,0,69
D & N HAVELI,2006,Never Married,8,7,0,15
D & N HAVELI,2006,Married,14,12,0,26
D & N HAVELI,2006,Widowed/Widower,0,0,0,0
D & N HAVELI,2006,Divorcee,0,0,0,0
D & N HAVELI,2006,Seperated,1,0,0,1
D & N HAVELI,2006,Total,23,19,0,42
D & N HAVELI,2007,Never Married,6,4,0,10
D & N HAVELI,2007,Married,37,28,0,65
D & N HAVELI,2007,Widowed/Widower,0,0,0,0
D & N HAVELI,2007,Divorcee,0,0,0,0
D & N HAVELI,2007,Seperated,1,0,0,1
D & N HAVELI,2007,Total,44,32,0,76
D & N HAVELI,2008,Never Married,8,6,0,14
D & N HAVELI,2008,Married,24,22,0,46
D & N HAVELI,2008,Widowed/Widower,0,0,0,0
D & N HAVELI,2008,Divorcee,0,0,0,0
D & N HAVELI,2008,Seperated,0,0,0,0
D & N HAVELI,2008,Total,32,28,0,60
D & N HAVELI,2009,Never Married,7,4,0,11
D & N HAVELI,2009,Married,22,18,0,40
D & N HAVELI,2009,Widowed/Widower,1,3,0,4
D & N HAVELI,2009,Divorcee,0,1,0,1
D & N HAVELI,2009,Seperated,0,0,0,0
D & N HAVELI,2009,Total,30,26,0,56
D & N HAVELI,2010,Never Married,11,9,0,20
D & N HAVELI,2010,Married,25,16,0,41
D & N HAVELI,2010,Widowed/Widower,1,0,0,1
D & N HAVELI,2010,Divorcee,0,1,0,1
D & N HAVELI,2010,Seperated,0,0,0,0
D & N HAVELI,2010,Total,37,26,0,63
D & N HAVELI,2011,Never Married,15,7,0,22
D & N HAVELI,2011,Married,26,11,0,37
D & N HAVELI,2011,Widowed/Widower,0,2,0,2
D & N HAVELI,2011,Divorcee,0,0,0,0
D & N HAVELI,2011,Seperated,0,2,0,2
D & N HAVELI,2011,Total,41,22,0,63
D & N HAVELI,2012,Never Married,12,8,0,20
D & N HAVELI,2012,Married,27,17,0,44
D & N HAVELI,2012,Widowed/Widower,0,0,0,0
D & N HAVELI,2012,Divorcee,1,0,0,1
D & N HAVELI,2012,Seperated,1,0,0,1
D & N HAVELI,2012,Total,41,25,0,66
DAMAN & DIU,2001,Never Married,5,1,0,6
DAMAN & DIU,2001,Married,5,3,0,8
DAMAN & DIU,2001,Widowed/Widower,0,0,0,0
DAMAN & DIU,2001,Divorcee,0,0,0,0
DAMAN & DIU,2001,Seperated,0,0,0,0
DAMAN & DIU,2001,Total,10,4,0,14
DAMAN & DIU,2002,Never Married,6,0,0,6
DAMAN & DIU,2002,Married,9,2,0,11
DAMAN & DIU,2002,Widowed/Widower,0,0,0,0
DAMAN & DIU,2002,Divorcee,0,0,0,0
DAMAN & DIU,2002,Seperated,0,0,0,0
DAMAN & DIU,2002,Total,15,2,0,17
DAMAN & DIU,2003,Never Married,7,2,0,9
DAMAN & DIU,2003,Married,10,4,0,14
DAMAN & DIU,2003,Widowed/Widower,1,0,0,1
DAMAN & DIU,2003,Divorcee,0,0,0,0
DAMAN & DIU,2003,Seperated,0,0,0,0
DAMAN & DIU,2003,Total,18,6,0,24
DAMAN & DIU,2004,Never Married,3,2,0,5
DAMAN & DIU,2004,Married,2,6,0,8
DAMAN & DIU,2004,Widowed/Widower,0,0,0,0
DAMAN & DIU,2004,Divorcee,0,0,0,0
DAMAN & DIU,2004,Seperated,0,0,0,0
DAMAN & DIU,2004,Total,5,8,0,13
DAMAN & DIU,2005,Never Married,10,4,0,14
DAMAN & DIU,2005,Married,14,3,0,17
DAMAN & DIU,2005,Widowed/Widower,0,0,0,0
DAMAN & DIU,2005,Divorcee,0,0,0,0
DAMAN & DIU,2005,Seperated,1,0,0,1
DAMAN & DIU,2005,Total,25,7,0,32
DAMAN & DIU,2006,Never Married,7,4,0,11
DAMAN & DIU,2006,Married,6,4,0,10
DAMAN & DIU,2006,Widowed/Widower,1,0,0,1
DAMAN & DIU,2006,Divorcee,0,0,0,0
DAMAN & DIU,2006,Seperated,0,0,0,0
DAMAN & DIU,2006,Total,14,8,0,22
DAMAN & DIU,2007,Never Married,2,6,0,8
DAMAN & DIU,2007,Married,4,3,0,7
DAMAN & DIU,2007,Widowed/Widower,0,0,0,0
DAMAN & DIU,2007,Divorcee,0,0,0,0
DAMAN & DIU,2007,Seperated,0,0,0,0
DAMAN & DIU,2007,Total,6,9,0,15
DAMAN & DIU,2008,Never Married,7,1,0,8
DAMAN & DIU,2008,Married,6,1,0,7
DAMAN & DIU,2008,Widowed/Widower,0,3,0,3
DAMAN & DIU,2008,Divorcee,1,0,0,1
DAMAN & DIU,2008,Seperated,0,0,0,0
DAMAN & DIU,2008,Total,14,5,0,19
DAMAN & DIU,2009,Never Married,8,4,0,12
DAMAN & DIU,2009,Married,6,4,0,10
DAMAN & DIU,2009,Widowed/Widower,1,0,0,1
DAMAN & DIU,2009,Divorcee,0,0,0,0
DAMAN & DIU,2009,Seperated,0,0,0,0
DAMAN & DIU,2009,Total,15,8,0,23
DAMAN & DIU,2010,Never Married,10,5,0,15
DAMAN & DIU,2010,Married,9,7,0,16
DAMAN & DIU,2010,Widowed/Widower,0,0,0,0
DAMAN & DIU,2010,Divorcee,0,0,0,0
DAMAN & DIU,2010,Seperated,0,0,0,0
DAMAN & DIU,2010,Total,19,12,0,31
DAMAN & DIU,2011,Never Married,6,9,0,15
DAMAN & DIU,2011,Married,11,6,0,17
DAMAN & DIU,2011,Widowed/Widower,0,0,0,0
DAMAN & DIU,2011,Divorcee,0,0,0,0
DAMAN & DIU,2011,Seperated,1,0,0,1
DAMAN & DIU,2011,Total,18,15,0,33
DAMAN & DIU,2012,Never Married,18,1,0,19
DAMAN & DIU,2012,Married,6,10,0,16
DAMAN & DIU,2012,Widowed/Widower,0,0,0,0
DAMAN & DIU,2012,Divorcee,0,0,0,0
DAMAN & DIU,2012,Seperated,1,0,0,1
DAMAN & DIU,2012,Total,25,11,0,36
DELHI (UT),2001,Never Married,192,124,0,316
DELHI (UT),2001,Married,508,365,0,873
DELHI (UT),2001,Widowed/Widower,12,9,0,21
DELHI (UT),2001,Divorcee,0,1,0,1
DELHI (UT),2001,Seperated,18,10,0,28
DELHI (UT),2001,Total,730,509,0,1239
DELHI (UT),2002,Never Married,172,110,0,282
DELHI (UT),2002,Married,434,274,0,708
DELHI (UT),2002,Widowed/Widower,15,9,0,24
DELHI (UT),2002,Divorcee,0,3,0,3
DELHI (UT),2002,Seperated,22,14,0,36
DELHI (UT),2002,Total,643,410,0,1053
DELHI (UT),2003,Never Married,232,122,0,354
DELHI (UT),2003,Married,471,272,0,743
DELHI (UT),2003,Widowed/Widower,4,6,0,10
DELHI (UT),2003,Divorcee,0,4,0,4
DELHI (UT),2003,Seperated,34,8,0,42
DELHI (UT),2003,Total,741,412,0,1153
DELHI (UT),2004,Never Married,263,175,0,438
DELHI (UT),2004,Married,508,270,0,778
DELHI (UT),2004,Widowed/Widower,10,2,0,12
DELHI (UT),2004,Divorcee,1,1,0,2
DELHI (UT),2004,Seperated,17,9,0,26
DELHI (UT),2004,Total,799,457,0,1256
DELHI (UT),2005,Never Married,218,150,0,368
DELHI (UT),2005,Married,501,301,0,802
DELHI (UT),2005,Widowed/Widower,10,4,0,14
DELHI (UT),2005,Divorcee,0,0,0,0
DELHI (UT),2005,Seperated,48,13,0,61
DELHI (UT),2005,Total,777,468,0,1245
DELHI (UT),2006,Never Married,241,158,0,399
DELHI (UT),2006,Married,656,358,0,1014
DELHI (UT),2006,Widowed/Widower,7,3,0,10
DELHI (UT),2006,Divorcee,0,1,0,1
DELHI (UT),2006,Seperated,56,12,0,68
DELHI (UT),2006,Total,960,532,0,1492
DELHI (UT),2007,Never Married,253,162,0,415
DELHI (UT),2007,Married,661,334,0,995
DELHI (UT),2007,Widowed/Widower,12,2,0,14
DELHI (UT),2007,Divorcee,1,1,0,2
DELHI (UT),2007,Seperated,39,16,0,55
DELHI (UT),2007,Total,966,515,0,1481
DELHI (UT),2008,Never Married,216,157,0,373
DELHI (UT),2008,Married,516,309,0,825
DELHI (UT),2008,Widowed/Widower,36,18,0,54
DELHI (UT),2008,Divorcee,3,3,0,6
DELHI (UT),2008,Seperated,24,21,0,45
DELHI (UT),2008,Total,795,508,0,1303
DELHI (UT),2009,Never Married,240,160,0,400
DELHI (UT),2009,Married,615,357,0,972
DELHI (UT),2009,Widowed/Widower,27,10,0,37
DELHI (UT),2009,Divorcee,5,0,0,5
DELHI (UT),2009,Seperated,46,17,0,63
DELHI (UT),2009,Total,933,544,0,1477
DELHI (UT),2010,Never Married,264,164,0,428
DELHI (UT),2010,Married,624,392,0,1016
DELHI (UT),2010,Widowed/Widower,17,6,0,23
DELHI (UT),2010,Divorcee,10,4,0,14
DELHI (UT),2010,Seperated,46,16,0,62
DELHI (UT),2010,Total,961,582,0,1543
DELHI (UT),2011,Never Married,348,182,0,530
DELHI (UT),2011,Married,742,337,0,1079
DELHI (UT),2011,Widowed/Widower,24,6,0,30
DELHI (UT),2011,Divorcee,3,3,0,6
DELHI (UT),2011,Seperated,51,20,0,71
DELHI (UT),2011,Total,1168,548,0,1716
DELHI (UT),2012,Never Married,405,216,0,621
DELHI (UT),2012,Married,793,405,0,1198
DELHI (UT),2012,Widowed/Widower,7,7,0,14
DELHI (UT),2012,Divorcee,1,2,0,3
DELHI (UT),2012,Seperated,40,23,0,63
DELHI (UT),2012,Total,1246,653,0,1899
LAKSHADWEEP,2001,Never Married,0,0,0,0
LAKSHADWEEP,2001,Married,0,0,0,0
LAKSHADWEEP,2001,Widowed/Widower,0,0,0,0
LAKSHADWEEP,2001,Divorcee,0,0,0,0
LAKSHADWEEP,2001,Seperated,0,0,0,0
LAKSHADWEEP,2001,Total,0,0,0,0
LAKSHADWEEP,2002,Never Married,0,0,0,0
LAKSHADWEEP,2002,Married,0,0,0,0
LAKSHADWEEP,2002,Widowed/Widower,0,0,0,0
LAKSHADWEEP,2002,Divorcee,0,0,0,0
LAKSHADWEEP,2002,Seperated,0,0,0,0
LAKSHADWEEP,2002,Total,0,0,0,0
LAKSHADWEEP,2003,Never Married,0,0,0,0
LAKSHADWEEP,2003,Married,1,1,0,2
LAKSHADWEEP,2003,Widowed/Widower,0,0,0,0
LAKSHADWEEP,2003,Divorcee,0,0,0,0
LAKSHADWEEP,2003,Seperated,0,0,0,0
LAKSHADWEEP,2003,Total,1,1,0,2
LAKSHADWEEP,2004,Never Married,0,0,0,0
LAKSHADWEEP,2004,Married,0,0,0,0
LAKSHADWEEP,2004,Widowed/Widower,0,0,0,0
LAKSHADWEEP,2004,Divorcee,0,0,0,0
LAKSHADWEEP,2004,Seperated,0,0,0,0
LAKSHADWEEP,2004,Total,0,0,0,0
LAKSHADWEEP,2005,Never Married,0,0,0,0
LAKSHADWEEP,2005,Married,0,0,0,0
LAKSHADWEEP,2005,Widowed/Widower,0,0,0,0
LAKSHADWEEP,2005,Divorcee,0,0,0,0
LAKSHADWEEP,2005,Seperated,0,0,0,0
LAKSHADWEEP,2005,Total,0,0,0,0
LAKSHADWEEP,2006,Never Married,0,0,0,0
LAKSHADWEEP,2006,Married,1,1,0,2
LAKSHADWEEP,2006,Widowed/Widower,0,0,0,0
LAKSHADWEEP,2006,Divorcee,0,0,0,0
LAKSHADWEEP,2006,Seperated,0,0,0,0
LAKSHADWEEP,2006,Total,1,1,0,2
LAKSHADWEEP,2007,Never Married,0,0,0,0
LAKSHADWEEP,2007,Married,1,2,0,3
LAKSHADWEEP,2007,Widowed/Widower,0,0,0,0
LAKSHADWEEP,2007,Divorcee,0,0,0,0
LAKSHADWEEP,2007,Seperated,0,0,0,0
LAKSHADWEEP,2007,Total,1,2,0,3
LAKSHADWEEP,2008,Never Married,0,0,0,0
LAKSHADWEEP,2008,Married,0,0,0,0
LAKSHADWEEP,2008,Widowed/Widower,0,0,0,0
LAKSHADWEEP,2008,Divorcee,0,0,0,0
LAKSHADWEEP,2008,Seperated,0,0,0,0
LAKSHADWEEP,2008,Total,0,0,0,0
LAKSHADWEEP,2009,Never Married,0,0,0,0
LAKSHADWEEP,2009,Married,0,1,0,1
LAKSHADWEEP,2009,Widowed/Widower,0,0,0,0
LAKSHADWEEP,2009,Divorcee,0,0,0,0
LAKSHADWEEP,2009,Seperated,0,0,0,0
LAKSHADWEEP,2009,Total,0,1,0,1
LAKSHADWEEP,2010,Never Married,0,0,0,0
LAKSHADWEEP,2010,Married,0,1,0,1
LAKSHADWEEP,2010,Widowed/Widower,0,0,0,0
LAKSHADWEEP,2010,Divorcee,0,0,0,0
LAKSHADWEEP,2010,Seperated,0,0,0,0
LAKSHADWEEP,2010,Total,0,1,0,1
LAKSHADWEEP,2011,Never Married,0,0,0,0
LAKSHADWEEP,2011,Married,0,0,0,0
LAKSHADWEEP,2011,Widowed/Widower,0,0,0,0
LAKSHADWEEP,2011,Divorcee,0,0,0,0
LAKSHADWEEP,2011,Seperated,0,0,0,0
LAKSHADWEEP,2011,Total,0,0,0,0
LAKSHADWEEP,2012,Never Married,0,0,0,0
LAKSHADWEEP,2012,Married,1,0,0,1
LAKSHADWEEP,2012,Widowed/Widower,0,0,0,0
LAKSHADWEEP,2012,Divorcee,0,0,0,0
LAKSHADWEEP,2012,Seperated,0,0,0,0
LAKSHADWEEP,2012,Total,1,0,0,1
PUDUCHERRY,2001,Never Married,42,63,0,105
PUDUCHERRY,2001,Married,281,135,0,416
PUDUCHERRY,2001,Widowed/Widower,0,8,0,8
PUDUCHERRY,2001,Divorcee,0,0,0,0
PUDUCHERRY,2001,Seperated,0,0,0,0
PUDUCHERRY,2001,Total,323,206,0,529
PUDUCHERRY,2002,Never Married,86,41,0,127
PUDUCHERRY,2002,Married,324,108,0,432
PUDUCHERRY,2002,Widowed/Widower,0,8,0,8
PUDUCHERRY,2002,Divorcee,0,0,0,0
PUDUCHERRY,2002,Seperated,0,0,0,0
PUDUCHERRY,2002,Total,410,157,0,567
PUDUCHERRY,2003,Never Married,98,72,0,170
PUDUCHERRY,2003,Married,288,113,0,401
PUDUCHERRY,2003,Widowed/Widower,2,9,0,11
PUDUCHERRY,2003,Divorcee,0,0,0,0
PUDUCHERRY,2003,Seperated,0,0,0,0
PUDUCHERRY,2003,Total,388,194,0,582
PUDUCHERRY,2004,Never Married,61,62,0,123
PUDUCHERRY,2004,Married,275,124,0,399
PUDUCHERRY,2004,Widowed/Widower,2,15,0,17
PUDUCHERRY,2004,Divorcee,0,0,0,0
PUDUCHERRY,2004,Seperated,0,0,0,0
PUDUCHERRY,2004,Total,338,201,0,539
PUDUCHERRY,2005,Never Married,78,60,0,138
PUDUCHERRY,2005,Married,262,124,0,386
PUDUCHERRY,2005,Widowed/Widower,0,14,0,14
PUDUCHERRY,2005,Divorcee,0,0,0,0
PUDUCHERRY,2005,Seperated,0,0,0,0
PUDUCHERRY,2005,Total,340,198,0,538
PUDUCHERRY,2006,Never Married,82,63,0,145
PUDUCHERRY,2006,Married,260,110,0,370
PUDUCHERRY,2006,Widowed/Widower,7,4,0,11
PUDUCHERRY,2006,Divorcee,0,0,0,0
PUDUCHERRY,2006,Seperated,0,0,0,0
PUDUCHERRY,2006,Total,349,177,0,526
PUDUCHERRY,2007,Never Married,65,74,0,139
PUDUCHERRY,2007,Married,254,113,0,367
PUDUCHERRY,2007,Widowed/Widower,0,11,0,11
PUDUCHERRY,2007,Divorcee,0,0,0,0
PUDUCHERRY,2007,Seperated,0,0,0,0
PUDUCHERRY,2007,Total,319,198,0,517
PUDUCHERRY,2008,Never Married,87,57,0,144
PUDUCHERRY,2008,Married,247,107,0,354
PUDUCHERRY,2008,Widowed/Widower,0,9,0,9
PUDUCHERRY,2008,Divorcee,0,0,0,0
PUDUCHERRY,2008,Seperated,0,0,0,0
PUDUCHERRY,2008,Total,334,173,0,507
PUDUCHERRY,2009,Never Married,71,61,0,132
PUDUCHERRY,2009,Married,255,121,0,376
PUDUCHERRY,2009,Widowed/Widower,0,10,0,10
PUDUCHERRY,2009,Divorcee,0,0,0,0
PUDUCHERRY,2009,Seperated,0,0,0,0
PUDUCHERRY,2009,Total,326,192,0,518
PUDUCHERRY,2010,Never Married,72,53,0,125
PUDUCHERRY,2010,Married,261,107,0,368
PUDUCHERRY,2010,Widowed/Widower,0,15,0,15
PUDUCHERRY,2010,Divorcee,0,0,0,0
PUDUCHERRY,2010,Seperated,0,0,0,0
PUDUCHERRY,2010,Total,333,175,0,508
PUDUCHERRY,2011,Never Married,92,46,0,138
PUDUCHERRY,2011,Married,304,102,0,406
PUDUCHERRY,2011,Widowed/Widower,0,13,0,13
PUDUCHERRY,2011,Divorcee,0,0,0,0
PUDUCHERRY,2011,Seperated,0,0,0,0
PUDUCHERRY,2011,Total,396,161,0,557
PUDUCHERRY,2012,Never Married,80,46,0,126
PUDUCHERRY,2012,Married,292,106,0,398
PUDUCHERRY,2012,Widowed/Widower,0,17,0,17
PUDUCHERRY,2012,Divorcee,0,0,0,0
PUDUCHERRY,2012,Seperated,0,0,0,0
PUDUCHERRY,2012,Total,372,169,0,541
TOTAL (UTs),2001,Never Married,276,208,0,484
TOTAL (UTs),2001,Married,910,579,0,1489
TOTAL (UTs),2001,Widowed/Widower,12,17,0,29
TOTAL (UTs),2001,Divorcee,0,1,0,1
TOTAL (UTs),2001,Seperated,18,10,0,28
TOTAL (UTs),2001,Total,1216,815,0,2031
TOTAL (UTs),2002,Never Married,325,186,0,511
TOTAL (UTs),2002,Married,882,453,0,1335
TOTAL (UTs),2002,Widowed/Widower,15,18,0,33
TOTAL (UTs),2002,Divorcee,0,3,0,3
TOTAL (UTs),2002,Seperated,22,14,0,36
TOTAL (UTs),2002,Total,1244,674,0,1918
TOTAL (UTs),2003,Never Married,383,225,0,608
TOTAL (UTs),2003,Married,889,460,0,1349
TOTAL (UTs),2003,Widowed/Widower,9,15,0,24
TOTAL (UTs),2003,Divorcee,0,5,0,5
TOTAL (UTs),2003,Seperated,35,8,0,43
TOTAL (UTs),2003,Total,1316,713,0,2029
TOTAL (UTs),2004,Never Married,372,266,0,638
TOTAL (UTs),2004,Married,892,456,0,1348
TOTAL (UTs),2004,Widowed/Widower,12,17,0,29
TOTAL (UTs),2004,Divorcee,2,1,0,3
TOTAL (UTs),2004,Seperated,17,9,0,26
TOTAL (UTs),2004,Total,1295,749,0,2044
TOTAL (UTs),2005,Never Married,362,246,0,608
TOTAL (UTs),2005,Married,910,502,0,1412
TOTAL (UTs),2005,Widowed/Widower,11,19,0,30
TOTAL (UTs),2005,Divorcee,0,0,0,0
TOTAL (UTs),2005,Seperated,49,13,0,62
TOTAL (UTs),2005,Total,1332,780,0,2112
TOTAL (UTs),2006,Never Married,412,256,0,668
TOTAL (UTs),2006,Married,1015,522,0,1537
TOTAL (UTs),2006,Widowed/Widower,15,7,0,22
TOTAL (UTs),2006,Divorcee,0,1,0,1
TOTAL (UTs),2006,Seperated,57,12,0,69
TOTAL (UTs),2006,Total,1499,798,0,2297
TOTAL (UTs),2007,Never Married,390,271,0,661
TOTAL (UTs),2007,Married,1053,533,0,1586
TOTAL (UTs),2007,Widowed/Widower,12,13,0,25
TOTAL (UTs),2007,Divorcee,1,1,0,2
TOTAL (UTs),2007,Seperated,40,16,0,56
TOTAL (UTs),2007,Total,1496,834,0,2330
TOTAL (UTs),2008,Never Married,362,241,0,603
TOTAL (UTs),2008,Married,905,488,0,1393
TOTAL (UTs),2008,Widowed/Widower,36,30,0,66
TOTAL (UTs),2008,Divorcee,4,4,0,8
TOTAL (UTs),2008,Seperated,24,21,0,45
TOTAL (UTs),2008,Total,1331,784,0,2115
TOTAL (UTs),2009,Never Married,357,260,0,617
TOTAL (UTs),2009,Married,997,546,0,1543
TOTAL (UTs),2009,Widowed/Widower,29,23,0,52
TOTAL (UTs),2009,Divorcee,5,1,0,6
TOTAL (UTs),2009,Seperated,46,17,0,63
TOTAL (UTs),2009,Total,1434,847,0,2281
TOTAL (UTs),2010,Never Married,409,259,0,668
TOTAL (UTs),2010,Married,1004,577,0,1581
TOTAL (UTs),2010,Widowed/Widower,21,23,0,44
TOTAL (UTs),2010,Divorcee,11,5,0,16
TOTAL (UTs),2010,Seperated,48,16,0,64
TOTAL (UTs),2010,Total,1493,880,0,2373
TOTAL (UTs),2011,Never Married,503,277,0,780
TOTAL (UTs),2011,Married,1191,512,0,1703
TOTAL (UTs),2011,Widowed/Widower,24,21,0,45
TOTAL (UTs),2011,Divorcee,3,4,0,7
TOTAL (UTs),2011,Seperated,53,22,0,75
TOTAL (UTs),2011,Total,1774,836,0,2610
TOTAL (UTs),2012,Never Married,569,302,0,871
TOTAL (UTs),2012,Married,1220,586,0,1806
TOTAL (UTs),2012,Widowed/Widower,7,24,0,31
TOTAL (UTs),2012,Divorcee,2,3,0,5
TOTAL (UTs),2012,Seperated,42,23,0,65
TOTAL (UTs),2012,Total,1840,938,0,2778
TOTAL (ALL INDIA),2001,Never Married,14480,9583,0,24063
TOTAL (ALL INDIA),2001,Married,46842,28281,0,75123
TOTAL (ALL INDIA),2001,Widowed/Widower,2377,2548,0,4925
TOTAL (ALL INDIA),2001,Divorcee,708,643,0,1351
TOTAL (ALL INDIA),2001,Seperated,1907,1137,0,3044
TOTAL (ALL INDIA),2001,Total,66314,42192,0,108506
TOTAL (ALL INDIA),2002,Never Married,15026,9225,0,24251
TOTAL (ALL INDIA),2002,Married,48409,26936,0,75345
TOTAL (ALL INDIA),2002,Widowed/Widower,3326,3025,0,6351
TOTAL (ALL INDIA),2002,Divorcee,684,675,0,1359
TOTAL (ALL INDIA),2002,Seperated,1887,1224,0,3111
TOTAL (ALL INDIA),2002,Total,69332,41085,0,110417
TOTAL (ALL INDIA),2003,Never Married,15339,8798,0,24137
TOTAL (ALL INDIA),2003,Married,49545,27603,0,77148
TOTAL (ALL INDIA),2003,Widowed/Widower,2919,2568,0,5487
TOTAL (ALL INDIA),2003,Divorcee,588,539,0,1127
TOTAL (ALL INDIA),2003,Seperated,1830,1122,0,2952
TOTAL (ALL INDIA),2003,Total,70221,40630,0,110851
TOTAL (ALL INDIA),2004,Never Married,15769,8823,0,24592
TOTAL (ALL INDIA),2004,Married,51623,28045,0,79668
TOTAL (ALL INDIA),2004,Widowed/Widower,2363,2377,0,4740
TOTAL (ALL INDIA),2004,Divorcee,665,532,0,1197
TOTAL (ALL INDIA),2004,Seperated,2231,1269,0,3500
TOTAL (ALL INDIA),2004,Total,72651,41046,0,113697
TOTAL (ALL INDIA),2005,Never Married,15292,8618,0,23910
TOTAL (ALL INDIA),2005,Married,52483,28188,0,80671
TOTAL (ALL INDIA),2005,Widowed/Widower,2664,2407,0,5071
TOTAL (ALL INDIA),2005,Divorcee,559,562,0,1121
TOTAL (ALL INDIA),2005,Seperated,1918,1223,0,3141
TOTAL (ALL INDIA),2005,Total,72916,40998,0,113914
TOTAL (ALL INDIA),2006,Never Married,15607,8812,0,24419
TOTAL (ALL INDIA),2006,Married,55452,29869,0,85321
TOTAL (ALL INDIA),2006,Widowed/Widower,2397,2227,0,4624
TOTAL (ALL INDIA),2006,Divorcee,514,588,0,1102
TOTAL (ALL INDIA),2006,Seperated,1732,914,0,2646
TOTAL (ALL INDIA),2006,Total,75702,42410,0,118112
TOTAL (ALL INDIA),2007,Never Married,16445,9009,0,25454
TOTAL (ALL INDIA),2007,Married,57593,30064,0,87657
TOTAL (ALL INDIA),2007,Widowed/Widower,2654,2354,0,5008
TOTAL (ALL INDIA),2007,Divorcee,526,644,0,1170
TOTAL (ALL INDIA),2007,Seperated,2077,1271,0,3348
TOTAL (ALL INDIA),2007,Total,79295,43342,0,122637
TOTAL (ALL INDIA),2008,Never Married,17809,9835,0,27644
TOTAL (ALL INDIA),2008,Married,57639,30224,0,87863
TOTAL (ALL INDIA),2008,Widowed/Widower,2635,2731,0,5366
TOTAL (ALL INDIA),2008,Divorcee,730,677,0,1407
TOTAL (ALL INDIA),2008,Seperated,1731,1006,0,2737
TOTAL (ALL INDIA),2008,Total,80544,44473,0,125017
TOTAL (ALL INDIA),2009,Never Married,17738,10063,0,27801
TOTAL (ALL INDIA),2009,Married,58192,31300,0,89492
TOTAL (ALL INDIA),2009,Widowed/Widower,2848,2674,0,5522
TOTAL (ALL INDIA),2009,Divorcee,635,613,0,1248
TOTAL (ALL INDIA),2009,Seperated,2058,1030,0,3088
TOTAL (ALL INDIA),2009,Total,81471,45680,0,127151
TOTAL (ALL INDIA),2010,Never Married,19702,11108,0,30810
TOTAL (ALL INDIA),2010,Married,61453,31754,0,93207
TOTAL (ALL INDIA),2010,Widowed/Widower,2777,2371,0,5148
TOTAL (ALL INDIA),2010,Divorcee,735,782,0,1517
TOTAL (ALL INDIA),2010,Seperated,2513,1404,0,3917
TOTAL (ALL INDIA),2010,Total,87180,47419,0,134599
TOTAL (ALL INDIA),2011,Never Married,19907,10756,0,30663
TOTAL (ALL INDIA),2011,Married,62433,32582,0,95015
TOTAL (ALL INDIA),2011,Widowed/Widower,2566,2354,0,4920
TOTAL (ALL INDIA),2011,Divorcee,554,729,0,1283
TOTAL (ALL INDIA),2011,Seperated,2379,1325,0,3704
TOTAL (ALL INDIA),2011,Total,87839,47746,0,135585
TOTAL (ALL INDIA),2012,Never Married,19727,10830,0,30557
TOTAL (ALL INDIA),2012,Married,63343,31921,0,95264
TOTAL (ALL INDIA),2012,Widowed/Widower,2658,2293,0,4951
TOTAL (ALL INDIA),2012,Divorcee,682,708,0,1390
TOTAL (ALL INDIA),2012,Seperated,2043,1240,0,3283
TOTAL (ALL INDIA),2012,Total,88453,46992,0,135445