,STATE.UT,Year,id,CAUSE,Male.upto.14.years,Male.15.29.years,Male.30.44.years,Male.45.59.years,Male.60.years.and.above,Total.Male,Female.upto.14.years,Female.15.29.years,Female.30.44.years,Female.45.59.years,Female.60.years.and.above,Total.Female,Transgender.upto.14.years,Transgender.15.29.years,Transgender.30.44.years,Transgender.45.59.years,Transgender.60.years.and.above,Total.Transgender,Grand.Total
1,A & N ISLANDS,2001,1,CAUSES NOT KNOWN,0,9,8,10,0,27,0,8,2,1,1,12,0,0,0,0,0,0,39
547,A & N ISLANDS,2001,1,DEATH OF DEAR PERSON,0,0,0,0,0,0,0,0,1,0,0,1,0,0,0,0,0,0,1
1093,A & N ISLANDS,2001,1,DOWRY DISPUTE,0,0,0,0,0,0,0,0,0,0,0,0,0,0,0,0,0,0,0
1639,A & N ISLANDS,2001,1,DRUG ABUSE,0,0,0,0,0,0,0,0,0,0,0,0,0,0,0,0,0,0,0
2185,A & N ISLANDS,2001,1,ECONOMIC ISSUES,0,0,0,0,0,0,0,0,0,0,0,0,0,0,0,0,0,0,0
2731,A & N ISLANDS,2001,1,EXAM FAILURE,1,1,0,0,0,2,0,2,0,0,0,2,0,0,0,0,0,0,4
3277,A & N ISLANDS,2001,1,FAMILY PROBLEMS,0,3,4,3,1,11,0,5,0,2,0,7,0,0,0,0,0,0,18
3823,A & N ISLANDS,2001,1,HEALTH ISSUES,1,3,6,4,4,18,0,8,3,2,1,14,0,0,0,0,0,0,32
4369,A & N ISLANDS,2001,1,HERO WORSHIP,0,0,0,0,0,0,0,0,0,0,0,0,0,0,0,0,0,0,0
4914,A & N ISLANDS,2001,1,ILLEGITIMATE PREGNANCY,0,0,0,0,0,0,0,0,0,0,0,0,0,0,0,0,0,0,0
5459,A & N ISLANDS,2001,1,LOVE AFFAIRS,0,3,0,0,0,3,1,0,0,0,0,1,0,0,0,0,0,0,4
6004,A & N ISLANDS,2001,1,MARITAL ISSUES,0,0,0,0,0,0,0,0,0,0,0,0,0,0,0,0,0,0,0
6550,A & N ISLANDS,2001,1,MENTAL HEALTH,0,2,3,3,1,9,0,2,2,0,1,5,0,0,0,0,0,0,14
7096,A & N ISLANDS,2001,1,OTHERS,0,4,2,1,2,9,1,6,1,0,0,8,0,0,0,0,0,0,17
7681,A & N ISLANDS,2001,1,"PHYSICAL ABUSE (RAPE,INCEST ETC.)",0,0,0,0,0,0,0,0,0,0,0,0,0,0,0,0,0,0,0
8187,A & N ISLANDS,2001,1,SOCIETAL ISSUES,0,0,0,0,0,0,0,0,0,0,0,0,0,0,0,0,0,0,0
40,A & N ISLANDS,2002,1,CAUSES NOT KNOWN,0,10,9,3,2,24,0,7,2,1,1,11,0,0,0,0,0,0,35
586,A & N ISLANDS,2002,1,DEATH OF DEAR PERSON,0,0,0,0,1,1,0,0,0,1,0,1,0,0,0,0,0,0,2
1132,A & N ISLANDS,2002,1,DOWRY DISPUTE,0,0,0,0,0,0,0,0,0,0,0,0,0,0,0,0,0,0,0
1678,A & N ISLANDS,2002,1,DRUG ABUSE,0,0,0,0,0,0,0,0,0,0,0,0,0,0,0,0,0,0,0
2224,A & N ISLANDS,2002,1,ECONOMIC ISSUES,0,1,0,0,0,1,0,0,0,0,0,0,0,0,0,0,0,0,1
2770,A & N ISLANDS,2002,1,EXAM FAILURE,1,0,0,0,0,1,1,1,0,0,0,2,0,0,0,0,0,0,3
3316,A & N ISLANDS,2002,1,FAMILY PROBLEMS,1,3,4,3,0,11,1,11,1,1,0,14,0,0,0,0,0,0,25
3862,A & N ISLANDS,2002,1,HEALTH ISSUES,0,3,5,6,6,20,0,2,5,1,1,9,0,0,0,0,0,0,29
4408,A & N ISLANDS,2002,1,HERO WORSHIP,0,0,0,0,0,0,0,0,0,0,0,0,0,0,0,0,0,0,0
4953,A & N ISLANDS,2002,1,ILLEGITIMATE PREGNANCY,0,0,0,0,0,0,0,0,0,0,0,0,0,0,0,0,0,0,0
5498,A & N ISLANDS,2002,1,LOVE AFFAIRS,0,4,1,0,0,5,0,1,2,0,0,3,0,0,0,0,0,0,8
6043,A & N ISLANDS,2002,1,MARITAL ISSUES,0,0,0,0,0,0,0,0,0,0,0,0,0,0,0,0,0,0,0
6589,A & N ISLANDS,2002,1,MENTAL HEALTH,0,2,7,2,2,13,0,4,1,1,1,7,0,0,0,0,0,0,20
7135,A & N ISLANDS,2002,1,OTHERS,0,4,2,7,2,15,0,2,3,1,0,6,0,0,0,0,0,0,21
7720,A & N ISLANDS,2002,1,"PHYSICAL ABUSE (RAPE,INCEST ETC.)",0,0,0,0,0,0,0,0,0,0,0,0,0,0,0,0,0,0,0
8226,A & N ISLANDS,2002,1,SOCIETAL ISSUES,0,0,0,0,0,0,0,0,0,0,0,0,0,0,0,0,0,0,0
79,A & N ISLANDS,2003,1,CAUSES NOT KNOWN,0,3,3,5,2,13,1,5,1,0,0,7,0,0,0,0,0,0,20
625,A & N ISLANDS,2003,1,DEATH OF DEAR PERSON,0,0,0,0,0,0,1,0,0,0,0,1,0,0,0,0,0,0,1
1171,A & N ISLANDS,2003,1,DOWRY DISPUTE,0,0,0,0,0,0,0,0,0,0,0,0,0,0,0,0,0,0,0
1717,A & N ISLANDS,2003,1,DRUG ABUSE,0,0,0,0,0,0,0,0,0,0,0,0,0,0,0,0,0,0,0
2263,A & N ISLANDS,2003,1,ECONOMIC ISSUES,0,1,2,0,0,3,0,0,0,0,0,0,0,0,0,0,0,0,3
2809,A & N ISLANDS,2003,1,EXAM FAILURE,0,1,0,0,0,1,0,0,0,0,0,0,0,0,0,0,0,0,1
3355,A & N ISLANDS,2003,1,FAMILY PROBLEMS,0,5,4,1,1,11,1,9,1,0,0,11,0,0,0,0,0,0,22
3901,A & N ISLANDS,2003,1,HEALTH ISSUES,0,1,3,8,2,14,0,4,3,2,0,9,0,0,0,0,0,0,23
4447,A & N ISLANDS,2003,1,HERO WORSHIP,0,0,0,0,0,0,0,0,0,0,0,0,0,0,0,0,0,0,0
4992,A & N ISLANDS,2003,1,ILLEGITIMATE PREGNANCY,0,0,0,0,0,0,0,0,0,0,0,0,0,0,0,0,0,0,0
5537,A & N ISLANDS,2003,1,LOVE AFFAIRS,0,6,0,0,0,6,0,2,0,0,0,2,0,0,0,0,0,0,8
6082,A & N ISLANDS,2003,1,MARITAL ISSUES,0,0,1,0,0,1,0,3,0,0,0,3,0,0,0,0,0,0,4
6628,A & N ISLANDS,2003,1,MENTAL HEALTH,0,0,4,1,0,5,0,3,0,0,1,4,0,0,0,0,0,0,9
7174,A & N ISLANDS,2003,1,OTHERS,0,5,5,2,1,13,1,2,2,0,0,5,0,0,0,0,0,0,18
7759,A & N ISLANDS,2003,1,"PHYSICAL ABUSE (RAPE,INCEST ETC.)",0,0,0,0,0,0,0,0,0,0,0,0,0,0,0,0,0,0,0
8265,A & N ISLANDS,2003,1,SOCIETAL ISSUES,1,1,1,0,0,3,0,0,1,0,0,1,0,0,0,0,0,0,4
118,A & N ISLANDS,2004,1,CAUSES NOT KNOWN,0,5,4,2,1,12,0,5,0,0,0,5,0,0,0,0,0,0,17
664,A & N ISLANDS,2004,1,DEATH OF DEAR PERSON,0,0,1,0,0,1,0,1,0,0,0,1,0,0,0,0,0,0,2
1210,A & N ISLANDS,2004,1,DOWRY DISPUTE,0,0,0,0,0,0,0,0,0,0,0,0,0,0,0,0,0,0,0
1756,A & N ISLANDS,2004,1,DRUG ABUSE,0,0,0,0,0,0,0,0,0,0,0,0,0,0,0,0,0,0,0
2302,A & N ISLANDS,2004,1,ECONOMIC ISSUES,0,10,1,2,1,14,0,5,0,0,0,5,0,0,0,0,0,0,19
2848,A & N ISLANDS,2004,1,EXAM FAILURE,0,3,0,0,0,3,0,2,0,0,0,2,0,0,0,0,0,0,5
3394,A & N ISLANDS,2004,1,FAMILY PROBLEMS,0,2,3,1,0,6,1,4,3,1,0,9,0,0,0,0,0,0,15
3940,A & N ISLANDS,2004,1,HEALTH ISSUES,0,2,4,6,5,17,0,4,6,2,1,13,0,0,0,0,0,0,30
4486,A & N ISLANDS,2004,1,HERO WORSHIP,0,0,0,0,0,0,0,0,0,0,0,0,0,0,0,0,0,0,0
5031,A & N ISLANDS,2004,1,ILLEGITIMATE PREGNANCY,0,0,0,0,0,0,0,0,0,0,0,0,0,0,0,0,0,0,0
5576,A & N ISLANDS,2004,1,LOVE AFFAIRS,0,4,1,0,0,5,0,1,0,0,0,1,0,0,0,0,0,0,6
6121,A & N ISLANDS,2004,1,MARITAL ISSUES,0,1,1,0,0,2,0,0,0,0,0,0,0,0,0,0,0,0,2
6667,A & N ISLANDS,2004,1,MENTAL HEALTH,0,6,5,3,1,15,0,1,2,0,0,3,0,0,0,0,0,0,18
7213,A & N ISLANDS,2004,1,OTHERS,0,1,4,0,1,6,0,0,2,0,0,2,0,0,0,0,0,0,8
7798,A & N ISLANDS,2004,1,"PHYSICAL ABUSE (RAPE,INCEST ETC.)",0,0,0,0,0,0,0,0,0,0,0,0,0,0,0,0,0,0,0
8304,A & N ISLANDS,2004,1,SOCIETAL ISSUES,0,0,0,0,0,0,0,0,0,0,0,0,0,0,0,0,0,0,0
157,A & N ISLANDS,2005,1,CAUSES NOT KNOWN,0,6,2,10,2,20,1,3,1,1,0,6,0,0,0,0,0,0,26
703,A & N ISLANDS,2005,1,DEATH OF DEAR PERSON,0,1,0,0,0,1,0,0,0,0,0,0,0,0,0,0,0,0,1
1249,A & N ISLANDS,2005,1,DOWRY DISPUTE,0,0,0,0,0,0,0,0,0,0,0,0,0,0,0,0,0,0,0
1795,A & N ISLANDS,2005,1,DRUG ABUSE,0,0,0,0,0,0,0,0,0,0,0,0,0,0,0,0,0,0,0
2341,A & N ISLANDS,2005,1,ECONOMIC ISSUES,0,0,2,1,0,3,0,0,0,1,0,1,0,0,0,0,0,0,4
2887,A & N ISLANDS,2005,1,EXAM FAILURE,0,0,0,0,0,0,0,3,0,0,0,3,0,0,0,0,0,0,3
3433,A & N ISLANDS,2005,1,FAMILY PROBLEMS,0,0,1,0,1,2,0,0,1,0,0,1,0,0,0,0,0,0,3
3979,A & N ISLANDS,2005,1,HEALTH ISSUES,0,1,3,7,10,21,0,6,2,4,4,16,0,0,0,0,0,0,37
4525,A & N ISLANDS,2005,1,HERO WORSHIP,0,0,0,0,0,0,0,0,0,0,0,0,0,0,0,0,0,0,0
5070,A & N ISLANDS,2005,1,ILLEGITIMATE PREGNANCY,0,0,0,0,0,0,0,0,0,0,0,0,0,0,0,0,0,0,0
5615,A & N ISLANDS,2005,1,LOVE AFFAIRS,1,0,2,0,0,3,0,0,0,0,0,0,0,0,0,0,0,0,3
6160,A & N ISLANDS,2005,1,MARITAL ISSUES,0,0,0,0,0,0,0,0,0,0,0,0,0,0,0,0,0,0,0
6706,A & N ISLANDS,2005,1,MENTAL HEALTH,0,2,4,2,1,9,0,2,2,2,1,7,0,0,0,0,0,0,16
7252,A & N ISLANDS,2005,1,OTHERS,4,5,10,5,3,27,2,13,2,2,0,19,0,0,0,0,0,0,46
7837,A & N ISLANDS,2005,1,"PHYSICAL ABUSE (RAPE,INCEST ETC.)",0,0,0,0,0,0,0,0,0,0,0,0,0,0,0,0,0,0,0
8343,A & N ISLANDS,2005,1,SOCIETAL ISSUES,0,0,0,0,0,0,0,0,0,0,0,0,0,0,0,0,0,0,0
196,A & N ISLANDS,2006,1,CAUSES NOT KNOWN,0,0,0,0,0,0,0,0,0,0,0,0,0,0,0,0,0,0,0
742,A & N ISLANDS,2006,1,DEATH OF DEAR PERSON,0,0,0,1,0,1,0,0,0,0,0,0,0,0,0,0,0,0,1
1288,A & N ISLANDS,2006,1,DOWRY DISPUTE,0,0,0,0,0,0,0,0,0,0,0,0,0,0,0,0,0,0,0
1834,A & N ISLANDS,2006,1,DRUG ABUSE,0,0,0,0,0,0,0,0,0,0,0,0,0,0,0,0,0,0,0
2380,A & N ISLANDS,2006,1,ECONOMIC ISSUES,0,2,0,0,0,2,0,0,0,0,0,0,0,0,0,0,0,0,2
2926,A & N ISLANDS,2006,1,EXAM FAILURE,0,0,0,0,0,0,0,0,0,0,0,0,0,0,0,0,0,0,0
3472,A & N ISLANDS,2006,1,FAMILY PROBLEMS,0,0,0,0,0,0,0,0,0,0,0,0,0,0,0,0,0,0,0
4018,A & N ISLANDS,2006,1,HEALTH ISSUES,0,2,9,7,9,27,0,9,2,1,1,13,0,0,0,0,0,0,40
4564,A & N ISLANDS,2006,1,HERO WORSHIP,0,0,0,0,0,0,0,0,0,0,0,0,0,0,0,0,0,0,0
5109,A & N ISLANDS,2006,1,ILLEGITIMATE PREGNANCY,0,0,0,0,0,0,0,0,0,0,0,0,0,0,0,0,0,0,0
5654,A & N ISLANDS,2006,1,LOVE AFFAIRS,0,1,1,0,0,2,1,1,0,0,0,2,0,0,0,0,0,0,4
6199,A & N ISLANDS,2006,1,MARITAL ISSUES,0,0,0,0,0,0,0,0,0,0,0,0,0,0,0,0,0,0,0
6745,A & N ISLANDS,2006,1,MENTAL HEALTH,0,1,4,9,2,16,0,0,3,2,1,6,0,0,0,0,0,0,22
7291,A & N ISLANDS,2006,1,OTHERS,4,15,20,8,1,48,0,11,5,0,0,16,0,0,0,0,0,0,64
7876,A & N ISLANDS,2006,1,"PHYSICAL ABUSE (RAPE,INCEST ETC.)",0,0,0,0,0,0,0,0,0,0,0,0,0,0,0,0,0,0,0
8382,A & N ISLANDS,2006,1,SOCIETAL ISSUES,0,0,0,0,0,0,0,0,0,0,0,0,0,0,0,0,0,0,0
235,A & N ISLANDS,2007,1,CAUSES NOT KNOWN,0,3,1,0,0,4,0,0,0,0,0,0,0,0,0,0,0,0,4
781,A & N ISLANDS,2007,1,DEATH OF DEAR PERSON,0,0,0,0,1,1,0,0,0,0,0,0,0,0,0,0,0,0,1
1327,A & N ISLANDS,2007,1,DOWRY DISPUTE,0,0,0,0,0,0,0,0,0,0,0,0,0,0,0,0,0,0,0
1873,A & N ISLANDS,2007,1,DRUG ABUSE,0,0,0,0,0,0,0,0,0,0,0,0,0,0,0,0,0,0,0
2419,A & N ISLANDS,2007,1,ECONOMIC ISSUES,0,3,1,1,0,5,0,1,0,0,0,1,0,0,0,0,0,0,6
2965,A & N ISLANDS,2007,1,EXAM FAILURE,0,2,0,0,0,2,2,5,0,0,0,7,0,0,0,0,0,0,9
3511,A & N ISLANDS,2007,1,FAMILY PROBLEMS,0,0,1,2,1,4,0,0,0,0,0,0,0,0,0,0,0,0,4
4057,A & N ISLANDS,2007,1,HEALTH ISSUES,0,3,1,5,4,13,0,4,2,2,2,10,0,0,0,0,0,0,23
4602,A & N ISLANDS,2007,1,HERO WORSHIP,0,0,0,0,0,0,0,0,0,0,0,0,0,0,0,0,0,0,0
5147,A & N ISLANDS,2007,1,ILLEGITIMATE PREGNANCY,0,0,0,0,0,0,0,0,0,0,0,0,0,0,0,0,0,0,0
5692,A & N ISLANDS,2007,1,LOVE AFFAIRS,0,3,0,0,0,3,1,4,1,0,0,6,0,0,0,0,0,0,9
6238,A & N ISLANDS,2007,1,MARITAL ISSUES,0,1,1,0,0,2,0,0,0,0,0,0,0,0,0,0,0,0,2
6784,A & N ISLANDS,2007,1,MENTAL HEALTH,0,3,9,7,1,20,0,3,1,2,0,6,0,0,0,0,0,0,26
7330,A & N ISLANDS,2007,1,OTHERS,0,16,12,12,4,44,3,13,6,4,0,26,0,0,0,0,0,0,70
7914,A & N ISLANDS,2007,1,"PHYSICAL ABUSE (RAPE,INCEST ETC.)",0,0,0,0,0,0,0,0,0,0,0,0,0,0,0,0,0,0,0
8421,A & N ISLANDS,2007,1,SOCIETAL ISSUES,0,2,0,0,0,2,0,0,0,0,0,0,0,0,0,0,0,0,2
274,A & N ISLANDS,2008,1,CAUSES NOT KNOWN,0,5,7,4,4,20,0,4,1,1,0,6,0,0,0,0,0,0,26
820,A & N ISLANDS,2008,1,DEATH OF DEAR PERSON,0,0,0,0,0,0,0,0,0,0,0,0,0,0,0,0,0,0,0
1366,A & N ISLANDS,2008,1,DOWRY DISPUTE,0,0,0,0,0,0,0,0,0,0,0,0,0,0,0,0,0,0,0
1912,A & N ISLANDS,2008,1,DRUG ABUSE,0,0,0,0,0,0,0,0,0,0,0,0,0,0,0,0,0,0,0
2458,A & N ISLANDS,2008,1,ECONOMIC ISSUES,0,2,0,2,1,5,0,0,0,0,0,0,0,0,0,0,0,0,5
3004,A & N ISLANDS,2008,1,EXAM FAILURE,0,1,0,0,0,1,0,0,0,0,0,0,0,0,0,0,0,0,1
3550,A & N ISLANDS,2008,1,FAMILY PROBLEMS,0,0,0,0,0,0,0,0,0,0,0,0,0,0,0,0,0,0,0
4096,A & N ISLANDS,2008,1,HEALTH ISSUES,0,3,6,7,6,22,0,5,4,2,2,13,0,0,0,0,0,0,35
4641,A & N ISLANDS,2008,1,HERO WORSHIP,0,0,0,0,0,0,0,0,0,0,0,0,0,0,0,0,0,0,0
5186,A & N ISLANDS,2008,1,ILLEGITIMATE PREGNANCY,0,0,0,0,0,0,0,0,0,0,0,0,0,0,0,0,0,0,0
5731,A & N ISLANDS,2008,1,LOVE AFFAIRS,0,5,2,0,0,7,0,2,0,0,0,2,0,0,0,0,0,0,9
6277,A & N ISLANDS,2008,1,MARITAL ISSUES,0,3,0,1,0,4,0,0,2,0,0,2,0,0,0,0,0,0,6
6823,A & N ISLANDS,2008,1,MENTAL HEALTH,0,3,7,4,2,16,0,2,0,2,1,5,0,0,0,0,0,0,21
7369,A & N ISLANDS,2008,1,OTHERS,0,9,10,3,1,23,0,10,6,0,1,17,0,0,0,0,0,0,40
7953,A & N ISLANDS,2008,1,"PHYSICAL ABUSE (RAPE,INCEST ETC.)",0,0,0,0,0,0,0,0,0,0,0,0,0,0,0,0,0,0,0
8460,A & N ISLANDS,2008,1,SOCIETAL ISSUES,0,0,0,0,0,0,0,0,0,0,0,0,0,0,0,0,0,0,0
313,A & N ISLANDS,2009,1,CAUSES NOT KNOWN,0,7,8,9,1,25,0,4,2,0,0,6,0,0,0,0,0,0,31
859,A & N ISLANDS,2009,1,DEATH OF DEAR PERSON,0,0,0,0,0,0,0,0,0,0,0,0,0,0,0,0,0,0,0
1405,A & N ISLANDS,2009,1,DOWRY DISPUTE,0,0,0,0,0,0,0,0,0,0,0,0,0,0,0,0,0,0,0
1951,A & N ISLANDS,2009,1,DRUG ABUSE,0,0,0,0,0,0,0,0,0,0,0,0,0,0,0,0,0,0,0
2497,A & N ISLANDS,2009,1,ECONOMIC ISSUES,0,0,0,0,0,0,0,0,0,0,0,0,0,0,0,0,0,0,0
3043,A & N ISLANDS,2009,1,EXAM FAILURE,0,0,0,0,0,0,0,1,0,0,0,1,0,0,0,0,0,0,1
3589,A & N ISLANDS,2009,1,FAMILY PROBLEMS,0,0,0,0,0,0,0,1,0,0,0,1,0,0,0,0,0,0,1
4135,A & N ISLANDS,2009,1,HEALTH ISSUES,0,4,3,6,3,16,0,3,2,3,1,9,0,0,0,0,0,0,25
4680,A & N ISLANDS,2009,1,HERO WORSHIP,0,0,0,0,0,0,0,0,0,0,0,0,0,0,0,0,0,0,0
5225,A & N ISLANDS,2009,1,ILLEGITIMATE PREGNANCY,0,0,0,0,0,0,0,0,0,0,0,0,0,0,0,0,0,0,0
5770,A & N ISLANDS,2009,1,LOVE AFFAIRS,0,2,0,0,1,3,0,1,0,0,0,1,0,0,0,0,0,0,4
6316,A & N ISLANDS,2009,1,MARITAL ISSUES,0,0,0,0,0,0,0,0,0,0,0,0,0,0,0,0,0,0,0
6862,A & N ISLANDS,2009,1,MENTAL HEALTH,0,4,5,4,1,14,0,1,5,0,0,6,0,0,0,0,0,0,20
7408,A & N ISLANDS,2009,1,OTHERS,1,14,7,6,0,28,7,8,5,1,0,21,0,0,0,0,0,0,49
7992,A & N ISLANDS,2009,1,"PHYSICAL ABUSE (RAPE,INCEST ETC.)",0,0,0,0,0,0,0,0,0,0,0,0,0,0,0,0,0,0,0
8499,A & N ISLANDS,2009,1,SOCIETAL ISSUES,0,0,0,0,0,0,0,0,0,0,0,0,0,0,0,0,0,0,0
352,A & N ISLANDS,2010,1,CAUSES NOT KNOWN,0,4,4,5,3,16,0,5,0,0,0,5,0,0,0,0,0,0,21
898,A & N ISLANDS,2010,1,DEATH OF DEAR PERSON,0,0,0,0,0,0,0,0,0,0,0,0,0,0,0,0,0,0,0
1444,A & N ISLANDS,2010,1,DOWRY DISPUTE,0,0,0,0,0,0,0,0,0,0,0,0,0,0,0,0,0,0,0
1990,A & N ISLANDS,2010,1,DRUG ABUSE,0,0,0,0,0,0,0,0,0,0,0,0,0,0,0,0,0,0,0
2536,A & N ISLANDS,2010,1,ECONOMIC ISSUES,0,4,2,1,0,7,0,1,0,0,0,1,0,0,0,0,0,0,8
3082,A & N ISLANDS,2010,1,EXAM FAILURE,0,0,0,0,0,0,0,0,0,0,0,0,0,0,0,0,0,0,0
3628,A & N ISLANDS,2010,1,FAMILY PROBLEMS,0,0,1,0,2,3,0,2,1,0,0,3,0,0,0,0,0,0,6
4174,A & N ISLANDS,2010,1,HEALTH ISSUES,0,5,4,4,5,18,0,3,1,0,3,7,0,0,0,0,0,0,25
4719,A & N ISLANDS,2010,1,HERO WORSHIP,0,0,0,0,0,0,0,0,0,0,0,0,0,0,0,0,0,0,0
5264,A & N ISLANDS,2010,1,ILLEGITIMATE PREGNANCY,0,0,0,0,0,0,0,0,0,0,0,0,0,0,0,0,0,0,0
5809,A & N ISLANDS,2010,1,LOVE AFFAIRS,0,3,1,0,0,4,0,1,0,0,0,1,0,0,0,0,0,0,5
6355,A & N ISLANDS,2010,1,MARITAL ISSUES,0,0,0,0,0,0,0,2,0,0,0,2,0,0,0,0,0,0,2
6901,A & N ISLANDS,2010,1,MENTAL HEALTH,0,10,7,2,2,21,0,2,4,0,0,6,0,0,0,0,0,0,27
7447,A & N ISLANDS,2010,1,OTHERS,4,13,14,6,6,43,0,12,5,2,0,19,0,0,0,0,0,0,62
8031,A & N ISLANDS,2010,1,"PHYSICAL ABUSE (RAPE,INCEST ETC.)",0,0,0,0,0,0,0,0,0,0,0,0,0,0,0,0,0,0,0
8538,A & N ISLANDS,2010,1,SOCIETAL ISSUES,0,0,0,0,0,0,0,0,0,0,0,0,0,0,0,0,0,0,0
391,A & N ISLANDS,2011,1,CAUSES NOT KNOWN,0,9,13,6,1,29,2,3,1,3,1,10,0,0,0,0,0,0,39
937,A & N ISLANDS,2011,1,DEATH OF DEAR PERSON,0,0,0,0,0,0,0,0,0,0,0,0,0,0,0,0,0,0,0
1483,A & N ISLANDS,2011,1,DOWRY DISPUTE,0,0,0,0,0,0,0,0,0,0,0,0,0,0,0,0,0,0,0
2029,A & N ISLANDS,2011,1,DRUG ABUSE,0,0,0,0,0,0,0,0,0,0,0,0,0,0,0,0,0,0,0
2575,A & N ISLANDS,2011,1,ECONOMIC ISSUES,0,2,1,0,0,3,0,0,0,0,0,0,0,0,0,0,0,0,3
3121,A & N ISLANDS,2011,1,EXAM FAILURE,0,2,0,0,0,2,0,1,0,0,0,1,0,0,0,0,0,0,3
3667,A & N ISLANDS,2011,1,FAMILY PROBLEMS,0,1,2,0,0,3,0,0,0,1,1,2,0,0,0,0,0,0,5
4213,A & N ISLANDS,2011,1,HEALTH ISSUES,0,2,3,5,5,15,0,3,4,1,0,8,0,0,0,0,0,0,23
4758,A & N ISLANDS,2011,1,HERO WORSHIP,0,0,0,0,0,0,0,0,0,0,0,0,0,0,0,0,0,0,0
5303,A & N ISLANDS,2011,1,ILLEGITIMATE PREGNANCY,0,0,0,0,0,0,0,0,0,0,0,0,0,0,0,0,0,0,0
5848,A & N ISLANDS,2011,1,LOVE AFFAIRS,0,7,0,0,0,7,0,2,1,0,0,3,0,0,0,0,0,0,10
6394,A & N ISLANDS,2011,1,MARITAL ISSUES,0,0,0,0,0,0,0,0,1,0,0,1,0,0,0,0,0,0,1
6940,A & N ISLANDS,2011,1,MENTAL HEALTH,0,1,7,6,1,15,0,4,1,1,0,6,0,0,0,0,0,0,21
7486,A & N ISLANDS,2011,1,OTHERS,1,4,9,3,3,20,2,6,3,0,0,11,0,0,0,0,0,0,31
8070,A & N ISLANDS,2011,1,"PHYSICAL ABUSE (RAPE,INCEST ETC.)",0,0,0,0,0,0,0,0,0,0,0,0,0,0,0,0,0,0,0
8577,A & N ISLANDS,2011,1,SOCIETAL ISSUES,0,0,0,0,0,0,0,0,0,0,0,0,0,0,0,0,0,0,0
430,A & N ISLANDS,2012,1,CAUSES NOT KNOWN,1,2,6,3,1,13,0,5,3,0,0,8,0,0,0,0,0,0,21
976,A & N ISLANDS,2012,1,DEATH OF DEAR PERSON,0,0,1,0,0,1,0,0,0,0,0,0,0,0,0,0,0,0,1
1522,A & N ISLANDS,2012,1,DOWRY DISPUTE,0,0,0,0,0,0,0,0,0,0,0,0,0,0,0,0,0,0,0
2068,A & N ISLANDS,2012,1,DRUG ABUSE,0,0,0,0,0,0,0,0,0,0,0,0,0,0,0,0,0,0,0
2614,A & N ISLANDS,2012,1,ECONOMIC ISSUES,0,4,0,0,0,4,0,1,0,0,0,1,0,0,0,0,0,0,5
3160,A & N ISLANDS,2012,1,EXAM FAILURE,0,0,0,0,0,0,0,0,0,0,0,0,0,0,0,0,0,0,0
3706,A & N ISLANDS,2012,1,FAMILY PROBLEMS,0,0,0,0,0,0,0,0,0,0,0,0,0,0,0,0,0,0,0
4252,A & N ISLANDS,2012,1,HEALTH ISSUES,0,1,6,6,6,19,0,3,1,0,3,7,0,0,0,0,0,0,26
4797,A & N ISLANDS,2012,1,HERO WORSHIP,0,0,0,0,0,0,0,0,0,0,0,0,0,0,0,0,0,0,0
5342,A & N ISLANDS,2012,1,ILLEGITIMATE PREGNANCY,0,0,0,0,0,0,0,0,0,0,0,0,0,0,0,0,0,0,0
5887,A & N ISLANDS,2012,1,LOVE AFFAIRS,0,4,0,0,0,4,0,1,0,0,0,1,0,0,0,0,0,0,5
6433,A & N ISLANDS,2012,1,MARITAL ISSUES,0,0,0,0,0,0,0,0,0,0,0,0,0,0,0,0,0,0,0
6979,A & N ISLANDS,2012,1,MENTAL HEALTH,0,6,7,5,1,19,0,2,3,0,0,5,0,0,0,0,0,0,24
7525,A & N ISLANDS,2012,1,OTHERS,1,5,6,6,2,20,1,9,5,3,1,19,0,0,0,0,0,0,39
8109,A & N ISLANDS,2012,1,"PHYSICAL ABUSE (RAPE,INCEST ETC.)",0,0,0,0,0,0,0,0,0,0,0,0,0,0,0,0,0,0,0
8616,A & N ISLANDS,2012,1,SOCIETAL ISSUES,0,0,0,0,0,0,0,0,0,0,0,0,0,0,0,0,0,0,0
469,A & N ISLANDS,2013,1,CAUSES NOT KNOWN,2,5,5,5,1,18,0,6,0,1,0,7,0,0,0,0,0,0,25
1015,A & N ISLANDS,2013,1,DEATH OF DEAR PERSON,0,0,0,0,0,0,0,0,1,0,0,1,0,0,0,0,0,0,1
1561,A & N ISLANDS,2013,1,DOWRY DISPUTE,0,0,0,0,0,0,0,0,0,0,0,0,0,0,0,0,0,0,0
2107,A & N ISLANDS,2013,1,DRUG ABUSE,0,0,0,0,0,0,0,0,0,0,0,0,0,0,0,0,0,0,0
2653,A & N ISLANDS,2013,1,ECONOMIC ISSUES,0,0,1,0,0,1,0,0,0,0,0,0,0,0,0,0,0,0,1
3199,A & N ISLANDS,2013,1,EXAM FAILURE,0,0,0,0,0,0,0,0,0,0,0,0,0,0,0,0,0,0,0
3745,A & N ISLANDS,2013,1,FAMILY PROBLEMS,0,1,0,1,0,2,0,0,0,0,0,0,0,0,0,0,0,0,2
4291,A & N ISLANDS,2013,1,HEALTH ISSUES,0,3,1,3,8,15,0,2,2,1,1,6,0,0,0,0,0,0,21
4836,A & N ISLANDS,2013,1,HERO WORSHIP,0,0,0,0,0,0,0,0,0,0,0,0,0,0,0,0,0,0,0
5381,A & N ISLANDS,2013,1,ILLEGITIMATE PREGNANCY,0,0,0,0,0,0,0,0,0,0,0,0,0,0,0,0,0,0,0
5926,A & N ISLANDS,2013,1,LOVE AFFAIRS,0,11,1,0,0,12,1,4,0,0,0,5,0,0,0,0,0,0,17
6472,A & N ISLANDS,2013,1,MARITAL ISSUES,0,0,1,0,0,1,0,0,0,0,0,0,0,0,0,0,0,0,1
7018,A & N ISLANDS,2013,1,MENTAL HEALTH,0,5,6,6,2,19,0,3,1,0,0,4,0,0,0,0,0,0,23
7564,A & N ISLANDS,2013,1,OTHERS,2,10,14,13,4,43,1,7,7,2,0,17,0,0,0,0,0,0,60
8148,A & N ISLANDS,2013,1,"PHYSICAL ABUSE (RAPE,INCEST ETC.)",0,0,0,0,0,0,0,0,0,0,0,0,0,0,0,0,0,0,0
8655,A & N ISLANDS,2013,1,SOCIETAL ISSUES,0,0,0,0,0,0,0,0,0,0,0,0,0,0,0,0,0,0,0
508,A & N ISLANDS,2014,1,CAUSES NOT KNOWN,0,4,3,2,1,10,0,3,0,0,0,3,0,0,0,0,0,0,13
1054,A & N ISLANDS,2014,1,DEATH OF DEAR PERSON,0,1,0,0,0,1,0,0,0,0,0,0,0,0,0,0,0,0,1
1600,A & N ISLANDS,2014,1,DOWRY DISPUTE,0,0,0,0,0,0,0,0,0,0,0,0,0,0,0,0,0,0,0
2146,A & N ISLANDS,2014,1,DRUG ABUSE,1,3,5,2,3,14,0,0,0,0,0,0,0,0,0,0,0,0,14
2692,A & N ISLANDS,2014,1,ECONOMIC ISSUES,0,1,0,0,0,1,0,0,1,0,0,1,0,0,0,0,0,0,2
3238,A & N ISLANDS,2014,1,EXAM FAILURE,0,0,0,0,0,0,0,3,0,0,0,3,0,0,0,0,0,0,3
3784,A & N ISLANDS,2014,1,FAMILY PROBLEMS,0,0,1,2,0,3,0,0,0,0,0,0,0,0,0,0,0,0,3
4330,A & N ISLANDS,2014,1,HEALTH ISSUES,0,11,12,18,17,58,2,10,3,3,4,22,0,0,0,0,0,0,80
4875,A & N ISLANDS,2014,1,HERO WORSHIP,0,0,0,0,0,0,0,0,0,0,0,0,0,0,0,0,0,0,0
5420,A & N ISLANDS,2014,1,ILLEGITIMATE PREGNANCY,0,0,0,0,0,0,0,0,0,0,0,0,0,0,0,0,0,0,0
5965,A & N ISLANDS,2014,1,LOVE AFFAIRS,0,6,4,0,0,10,0,3,0,0,0,3,0,0,0,0,0,0,13
6511,A & N ISLANDS,2014,1,MARITAL ISSUES,0,0,0,1,0,1,0,2,0,0,0,2,0,0,0,0,0,0,3
7057,A & N ISLANDS,2014,1,MENTAL HEALTH,0,5,10,4,5,24,0,2,1,1,0,4,0,0,0,0,0,0,28
7603,A & N ISLANDS,2014,1,OTHERS,0,12,12,7,4,35,1,10,1,0,4,16,0,0,0,0,0,0,51
7642,A & N ISLANDS,2014,1,PHYSICAL ABUSE,0,0,0,0,0,0,0,0,0,0,0,0,0,0,0,0,0,0,0
8694,A & N ISLANDS,2014,1,SOCIETAL ISSUES,0,0,0,0,0,0,0,0,0,0,0,0,0,0,0,0,0,0,0
2,ANDHRA PRADESH,2001,2,CAUSES NOT KNOWN,35,234,254,107,47,677,17,155,93,61,15,341,0,0,0,0,0,0,1018
548,ANDHRA PRADESH,2001,2,DEATH OF DEAR PERSON,0,5,4,4,1,14,0,36,27,2,2,67,0,0,0,0,0,0,81
1094,ANDHRA PRADESH,2001,2,DOWRY DISPUTE,0,1,0,0,0,1,0,159,41,1,0,201,0,0,0,0,0,0,202
1640,ANDHRA PRADESH,2001,2,DRUG ABUSE,0,4,8,10,1,23,1,0,1,0,0,2,0,0,0,0,0,0,25
2186,ANDHRA PRADESH,2001,2,ECONOMIC ISSUES,7,203,252,158,42,662,9,70,72,44,7,202,0,0,0,0,0,0,864
2732,ANDHRA PRADESH,2001,2,EXAM FAILURE,13,84,0,0,0,97,6,44,0,0,0,50,0,0,0,0,0,0,147
3278,ANDHRA PRADESH,2001,2,FAMILY PROBLEMS,12,492,553,285,42,1384,20,437,315,133,28,933,0,0,0,0,0,0,2317
3824,ANDHRA PRADESH,2001,2,HEALTH ISSUES,48,490,620,636,148,1942,52,422,370,300,96,1240,0,0,0,0,0,0,3182
4370,ANDHRA PRADESH,2001,2,HERO WORSHIP,0,2,1,3,0,6,0,3,1,2,0,6,0,0,0,0,0,0,12
4915,ANDHRA PRADESH,2001,2,ILLEGITIMATE PREGNANCY,0,0,0,0,0,0,0,18,0,0,0,18,0,0,0,0,0,0,18
5460,ANDHRA PRADESH,2001,2,LOVE AFFAIRS,3,84,12,0,0,99,3,65,8,0,0,76,0,0,0,0,0,0,175
6005,ANDHRA PRADESH,2001,2,MARITAL ISSUES,0,42,24,8,0,74,9,101,24,7,0,141,0,0,0,0,0,0,215
6551,ANDHRA PRADESH,2001,2,MENTAL HEALTH,1,110,171,53,33,368,2,112,82,52,25,273,0,0,0,0,0,0,641
7097,ANDHRA PRADESH,2001,2,OTHERS,54,280,293,285,48,960,61,196,142,84,17,500,0,0,0,0,0,0,1460
7682,ANDHRA PRADESH,2001,2,"PHYSICAL ABUSE (RAPE,INCEST ETC.)",0,9,3,0,0,12,5,30,8,0,1,44,0,0,0,0,0,0,56
8188,ANDHRA PRADESH,2001,2,SOCIETAL ISSUES,0,18,18,17,7,60,0,23,14,11,1,49,0,0,0,0,0,0,109
41,ANDHRA PRADESH,2002,2,CAUSES NOT KNOWN,13,215,249,134,46,657,14,117,61,41,17,250,0,0,0,0,0,0,907
587,ANDHRA PRADESH,2002,2,DEATH OF DEAR PERSON,1,2,12,3,0,18,1,9,2,1,0,13,0,0,0,0,0,0,31
1133,ANDHRA PRADESH,2002,2,DOWRY DISPUTE,0,10,2,0,0,12,0,229,17,4,0,250,0,0,0,0,0,0,262
1679,ANDHRA PRADESH,2002,2,DRUG ABUSE,0,3,8,7,0,18,0,1,0,0,0,1,0,0,0,0,0,0,19
2225,ANDHRA PRADESH,2002,2,ECONOMIC ISSUES,6,214,332,253,58,863,4,41,92,25,16,178,0,0,0,0,0,0,1041
2771,ANDHRA PRADESH,2002,2,EXAM FAILURE,17,147,5,0,0,169,7,78,8,0,0,93,0,0,0,0,0,0,262
3317,ANDHRA PRADESH,2002,2,FAMILY PROBLEMS,17,440,601,349,71,1478,33,325,295,134,29,816,0,0,0,0,0,0,2294
3863,ANDHRA PRADESH,2002,2,HEALTH ISSUES,21,477,824,854,257,2433,25,446,414,230,110,1225,0,0,0,0,0,0,3658
4409,ANDHRA PRADESH,2002,2,HERO WORSHIP,0,0,2,1,0,3,0,0,0,0,0,0,0,0,0,0,0,0,3
4954,ANDHRA PRADESH,2002,2,ILLEGITIMATE PREGNANCY,0,0,0,0,0,0,0,13,0,0,0,13,0,0,0,0,0,0,13
5499,ANDHRA PRADESH,2002,2,LOVE AFFAIRS,0,109,52,3,0,164,4,75,13,0,0,92,0,0,0,0,0,0,256
6044,ANDHRA PRADESH,2002,2,MARITAL ISSUES,0,41,16,4,0,61,0,51,36,1,0,88,0,0,0,0,0,0,149
6590,ANDHRA PRADESH,2002,2,MENTAL HEALTH,5,135,162,82,38,422,8,74,111,60,17,270,0,0,0,0,0,0,692
7136,ANDHRA PRADESH,2002,2,OTHERS,20,360,548,234,60,1222,41,332,319,76,44,812,0,0,0,0,0,0,2034
7721,ANDHRA PRADESH,2002,2,"PHYSICAL ABUSE (RAPE,INCEST ETC.)",0,10,8,4,0,22,1,5,2,0,0,8,0,0,0,0,0,0,30
8227,ANDHRA PRADESH,2002,2,SOCIETAL ISSUES,1,10,10,7,1,29,1,8,4,0,0,13,0,0,0,0,0,0,42
80,ANDHRA PRADESH,2003,2,CAUSES NOT KNOWN,27,200,208,117,40,592,27,92,52,32,19,222,0,0,0,0,0,0,814
626,ANDHRA PRADESH,2003,2,DEATH OF DEAR PERSON,0,8,6,18,4,36,0,1,3,5,3,12,0,0,0,0,0,0,48
1172,ANDHRA PRADESH,2003,2,DOWRY DISPUTE,0,2,28,19,0,49,6,239,33,6,0,284,0,0,0,0,0,0,333
1718,ANDHRA PRADESH,2003,2,DRUG ABUSE,0,3,18,9,1,31,0,0,0,0,0,0,0,0,0,0,0,0,31
2264,ANDHRA PRADESH,2003,2,ECONOMIC ISSUES,13,242,469,271,36,1031,7,64,114,33,18,236,0,0,0,0,0,0,1267
2810,ANDHRA PRADESH,2003,2,EXAM FAILURE,17,109,11,0,0,137,22,71,8,0,0,101,0,0,0,0,0,0,238
3356,ANDHRA PRADESH,2003,2,FAMILY PROBLEMS,31,494,625,293,78,1521,34,332,334,150,33,883,0,0,0,0,0,0,2404
3902,ANDHRA PRADESH,2003,2,HEALTH ISSUES,21,444,618,592,222,1897,38,408,354,240,79,1119,0,0,0,0,0,0,3016
4448,ANDHRA PRADESH,2003,2,HERO WORSHIP,0,11,30,14,5,60,2,19,4,3,0,28,0,0,0,0,0,0,88
4993,ANDHRA PRADESH,2003,2,ILLEGITIMATE PREGNANCY,0,0,0,0,0,0,0,20,3,0,0,23,0,0,0,0,0,0,23
5538,ANDHRA PRADESH,2003,2,LOVE AFFAIRS,6,119,31,1,0,157,2,80,16,1,0,99,0,0,0,0,0,0,256
6083,ANDHRA PRADESH,2003,2,MARITAL ISSUES,2,40,44,18,0,104,3,55,46,10,0,114,0,0,0,0,0,0,218
6629,ANDHRA PRADESH,2003,2,MENTAL HEALTH,7,159,247,94,28,535,20,108,101,56,14,299,0,0,0,0,0,0,834
7175,ANDHRA PRADESH,2003,2,OTHERS,30,422,457,279,78,1266,30,175,119,67,34,425,0,0,0,0,0,0,1691
7760,ANDHRA PRADESH,2003,2,"PHYSICAL ABUSE (RAPE,INCEST ETC.)",0,6,25,0,0,31,3,12,4,0,0,19,0,0,0,0,0,0,50
8266,ANDHRA PRADESH,2003,2,SOCIETAL ISSUES,1,11,29,20,5,66,3,9,13,6,1,32,0,0,0,0,0,0,98
119,ANDHRA PRADESH,2004,2,CAUSES NOT KNOWN,10,200,256,172,93,731,10,94,68,42,31,245,0,0,0,0,0,0,976
665,ANDHRA PRADESH,2004,2,DEATH OF DEAR PERSON,0,8,16,20,12,56,0,9,5,1,6,21,0,0,0,0,0,0,77
1211,ANDHRA PRADESH,2004,2,DOWRY DISPUTE,0,4,2,0,2,8,0,223,57,5,0,285,0,0,0,0,0,0,293
1757,ANDHRA PRADESH,2004,2,DRUG ABUSE,0,19,18,9,1,47,0,0,2,3,0,5,0,0,0,0,0,0,52
2303,ANDHRA PRADESH,2004,2,ECONOMIC ISSUES,4,426,908,673,165,2176,4,124,162,116,36,442,0,0,0,0,0,0,2618
2849,ANDHRA PRADESH,2004,2,EXAM FAILURE,8,90,16,0,0,114,16,52,7,0,0,75,0,0,0,0,0,0,189
3395,ANDHRA PRADESH,2004,2,FAMILY PROBLEMS,21,534,674,367,76,1672,26,433,299,112,35,905,0,0,0,0,0,0,2577
3941,ANDHRA PRADESH,2004,2,HEALTH ISSUES,9,544,692,436,246,1927,36,533,427,209,89,1294,0,0,0,0,0,0,3221
4487,ANDHRA PRADESH,2004,2,HERO WORSHIP,0,2,1,0,0,3,2,1,1,0,0,4,0,0,0,0,0,0,7
5032,ANDHRA PRADESH,2004,2,ILLEGITIMATE PREGNANCY,0,0,0,0,0,0,0,12,1,0,0,13,0,0,0,0,0,0,13
5577,ANDHRA PRADESH,2004,2,LOVE AFFAIRS,1,139,32,11,0,183,7,95,11,1,0,114,0,0,0,0,0,0,297
6122,ANDHRA PRADESH,2004,2,MARITAL ISSUES,0,51,39,16,1,107,1,80,43,10,0,134,0,0,0,0,0,0,241
6668,ANDHRA PRADESH,2004,2,MENTAL HEALTH,2,79,170,137,33,421,5,82,92,43,17,239,0,0,0,0,0,0,660
7214,ANDHRA PRADESH,2004,2,OTHERS,40,460,598,327,166,1591,35,212,155,139,96,637,0,0,0,0,0,0,2228
7799,ANDHRA PRADESH,2004,2,"PHYSICAL ABUSE (RAPE,INCEST ETC.)",0,1,2,0,0,3,0,6,12,2,0,20,0,0,0,0,0,0,23
8305,ANDHRA PRADESH,2004,2,SOCIETAL ISSUES,0,5,24,7,7,43,0,3,2,6,0,11,0,0,0,0,0,0,54
158,ANDHRA PRADESH,2005,2,CAUSES NOT KNOWN,22,171,196,137,94,620,8,91,71,29,12,211,0,0,0,0,0,0,831
704,ANDHRA PRADESH,2005,2,DEATH OF DEAR PERSON,0,16,20,17,15,68,0,5,9,5,2,21,0,0,0,0,0,0,89
1250,ANDHRA PRADESH,2005,2,DOWRY DISPUTE,0,0,0,0,0,0,0,166,66,1,0,233,0,0,0,0,0,0,233
1796,ANDHRA PRADESH,2005,2,DRUG ABUSE,0,1,10,6,0,17,0,2,0,0,0,2,0,0,0,0,0,0,19
2342,ANDHRA PRADESH,2005,2,ECONOMIC ISSUES,7,414,745,564,171,1901,7,94,152,95,34,382,0,0,0,0,0,0,2283
2888,ANDHRA PRADESH,2005,2,EXAM FAILURE,5,107,15,2,0,129,12,91,4,0,0,107,0,0,0,0,0,0,236
3434,ANDHRA PRADESH,2005,2,FAMILY PROBLEMS,30,516,625,362,111,1644,36,387,298,155,92,968,0,0,0,0,0,0,2612
3980,ANDHRA PRADESH,2005,2,HEALTH ISSUES,23,483,609,547,323,1985,53,562,385,263,178,1441,0,0,0,0,0,0,3426
4526,ANDHRA PRADESH,2005,2,HERO WORSHIP,0,0,2,1,2,5,0,1,2,1,0,4,0,0,0,0,0,0,9
5071,ANDHRA PRADESH,2005,2,ILLEGITIMATE PREGNANCY,0,0,0,0,0,0,0,11,0,0,0,11,0,0,0,0,0,0,11
5616,ANDHRA PRADESH,2005,2,LOVE AFFAIRS,2,97,26,4,0,129,3,107,15,0,0,125,0,0,0,0,0,0,254
6161,ANDHRA PRADESH,2005,2,MARITAL ISSUES,0,39,15,5,4,63,2,56,43,7,0,108,0,0,0,0,0,0,171
6707,ANDHRA PRADESH,2005,2,MENTAL HEALTH,1,101,204,122,64,492,5,103,110,73,39,330,0,0,0,0,0,0,822
7253,ANDHRA PRADESH,2005,2,OTHERS,53,491,708,366,158,1776,34,224,202,102,62,624,0,0,0,0,0,0,2400
7838,ANDHRA PRADESH,2005,2,"PHYSICAL ABUSE (RAPE,INCEST ETC.)",0,1,0,1,0,2,1,1,0,1,0,3,0,0,0,0,0,0,5
8344,ANDHRA PRADESH,2005,2,SOCIETAL ISSUES,0,7,3,22,2,34,0,3,3,1,0,7,0,0,0,0,0,0,41
197,ANDHRA PRADESH,2006,2,CAUSES NOT KNOWN,11,210,261,171,72,725,11,68,54,35,20,188,0,0,0,0,0,0,913
743,ANDHRA PRADESH,2006,2,DEATH OF DEAR PERSON,2,11,9,9,1,32,0,3,5,3,3,14,0,0,0,0,0,0,46
1289,ANDHRA PRADESH,2006,2,DOWRY DISPUTE,0,6,1,0,0,7,0,139,32,0,0,171,0,0,0,0,0,0,178
1835,ANDHRA PRADESH,2006,2,DRUG ABUSE,0,11,15,9,6,41,0,0,0,0,1,1,0,0,0,0,0,0,42
2381,ANDHRA PRADESH,2006,2,ECONOMIC ISSUES,14,399,853,549,115,1930,18,104,156,101,40,419,0,0,0,0,0,0,2349
2927,ANDHRA PRADESH,2006,2,EXAM FAILURE,12,99,12,0,0,123,7,83,0,0,0,90,0,0,0,0,0,0,213
3473,ANDHRA PRADESH,2006,2,FAMILY PROBLEMS,17,624,647,352,80,1720,28,446,275,97,34,880,0,0,0,0,0,0,2600
4019,ANDHRA PRADESH,2006,2,HEALTH ISSUES,35,598,719,498,261,2111,44,594,431,152,103,1324,0,0,0,0,0,0,3435
4565,ANDHRA PRADESH,2006,2,HERO WORSHIP,0,2,3,0,0,5,1,1,0,0,0,2,0,0,0,0,0,0,7
5110,ANDHRA PRADESH,2006,2,ILLEGITIMATE PREGNANCY,0,0,0,0,0,0,0,5,0,0,0,5,0,0,0,0,0,0,5
5655,ANDHRA PRADESH,2006,2,LOVE AFFAIRS,7,128,32,11,0,178,3,87,10,1,0,101,0,0,0,0,0,0,279
6200,ANDHRA PRADESH,2006,2,MARITAL ISSUES,0,31,32,4,0,67,1,89,42,4,0,136,0,0,0,0,0,0,203
6746,ANDHRA PRADESH,2006,2,MENTAL HEALTH,12,133,140,129,49,463,38,118,97,33,26,312,0,0,0,0,0,0,775
7292,ANDHRA PRADESH,2006,2,OTHERS,59,437,540,291,102,1429,41,239,247,153,64,744,0,0,0,0,0,0,2173
7877,ANDHRA PRADESH,2006,2,"PHYSICAL ABUSE (RAPE,INCEST ETC.)",0,0,3,1,0,4,0,3,1,1,0,5,0,0,0,0,0,0,9
8383,ANDHRA PRADESH,2006,2,SOCIETAL ISSUES,0,7,11,8,2,28,3,8,7,3,0,21,0,0,0,0,0,0,49
236,ANDHRA PRADESH,2007,2,CAUSES NOT KNOWN,10,274,294,207,86,871,13,146,97,74,48,378,0,0,0,0,0,0,1249
782,ANDHRA PRADESH,2007,2,DEATH OF DEAR PERSON,0,8,12,1,1,22,2,8,2,3,3,18,0,0,0,0,0,0,40
1328,ANDHRA PRADESH,2007,2,DOWRY DISPUTE,0,0,0,0,0,0,0,177,24,2,0,203,0,0,0,0,0,0,203
1874,ANDHRA PRADESH,2007,2,DRUG ABUSE,0,8,19,8,6,41,0,1,3,0,0,4,0,0,0,0,0,0,45
2420,ANDHRA PRADESH,2007,2,ECONOMIC ISSUES,7,429,934,592,235,2197,14,147,158,108,19,446,0,0,0,0,0,0,2643
2966,ANDHRA PRADESH,2007,2,EXAM FAILURE,10,103,15,0,0,128,23,69,2,8,0,102,0,0,0,0,0,0,230
3512,ANDHRA PRADESH,2007,2,FAMILY PROBLEMS,20,620,702,374,91,1807,31,384,286,122,30,853,0,0,0,0,0,0,2660
4058,ANDHRA PRADESH,2007,2,HEALTH ISSUES,27,581,738,507,315,2168,34,539,431,238,137,1379,0,0,0,0,0,0,3547
4603,ANDHRA PRADESH,2007,2,HERO WORSHIP,0,1,4,1,0,6,0,1,0,0,0,1,0,0,0,0,0,0,7
5148,ANDHRA PRADESH,2007,2,ILLEGITIMATE PREGNANCY,0,0,0,0,0,0,0,1,0,0,0,1,0,0,0,0,0,0,1
5693,ANDHRA PRADESH,2007,2,LOVE AFFAIRS,6,135,51,1,0,193,16,103,4,0,0,123,0,0,0,0,0,0,316
6239,ANDHRA PRADESH,2007,2,MARITAL ISSUES,0,43,32,6,2,83,2,78,31,6,0,117,0,0,0,0,0,0,200
6785,ANDHRA PRADESH,2007,2,MENTAL HEALTH,9,151,241,206,74,681,20,176,104,61,40,401,0,0,0,0,0,0,1082
7331,ANDHRA PRADESH,2007,2,OTHERS,30,571,605,399,116,1721,37,299,301,180,69,886,0,0,0,0,0,0,2607
7915,ANDHRA PRADESH,2007,2,"PHYSICAL ABUSE (RAPE,INCEST ETC.)",0,4,1,0,0,5,2,5,1,0,0,8,0,0,0,0,0,0,13
8422,ANDHRA PRADESH,2007,2,SOCIETAL ISSUES,2,8,12,2,2,26,0,5,6,2,0,13,0,0,0,0,0,0,39
275,ANDHRA PRADESH,2008,2,CAUSES NOT KNOWN,8,185,215,156,40,604,5,65,53,28,13,164,0,0,0,0,0,0,768
821,ANDHRA PRADESH,2008,2,DEATH OF DEAR PERSON,0,2,2,7,3,14,0,2,3,6,1,12,0,0,0,0,0,0,26
1367,ANDHRA PRADESH,2008,2,DOWRY DISPUTE,0,4,0,0,0,4,0,112,29,8,0,149,0,0,0,0,0,0,153
1913,ANDHRA PRADESH,2008,2,DRUG ABUSE,0,13,20,13,1,47,0,1,2,0,0,3,0,0,0,0,0,0,50
2459,ANDHRA PRADESH,2008,2,ECONOMIC ISSUES,3,436,825,650,160,2074,7,181,181,112,24,505,0,0,0,0,0,0,2579
3005,ANDHRA PRADESH,2008,2,EXAM FAILURE,13,131,4,0,0,148,12,62,0,1,0,75,0,0,0,0,0,0,223
3551,ANDHRA PRADESH,2008,2,FAMILY PROBLEMS,5,584,715,371,84,1759,24,351,347,103,38,863,0,0,0,0,0,0,2622
4097,ANDHRA PRADESH,2008,2,HEALTH ISSUES,10,465,739,609,260,2083,16,526,462,191,128,1323,0,0,0,0,0,0,3406
4642,ANDHRA PRADESH,2008,2,HERO WORSHIP,0,0,2,1,2,5,0,0,0,2,1,3,0,0,0,0,0,0,8
5187,ANDHRA PRADESH,2008,2,ILLEGITIMATE PREGNANCY,0,0,0,0,0,0,0,0,7,0,0,7,0,0,0,0,0,0,7
5732,ANDHRA PRADESH,2008,2,LOVE AFFAIRS,0,120,21,0,0,141,10,93,17,2,0,122,0,0,0,0,0,0,263
6278,ANDHRA PRADESH,2008,2,MARITAL ISSUES,0,48,46,15,1,110,0,61,53,7,0,121,0,0,0,0,0,0,231
6824,ANDHRA PRADESH,2008,2,MENTAL HEALTH,8,141,239,149,80,617,12,155,95,73,45,380,0,0,0,0,0,0,997
7370,ANDHRA PRADESH,2008,2,OTHERS,44,576,816,492,134,2062,33,272,334,204,57,900,0,0,0,0,0,0,2962
7954,ANDHRA PRADESH,2008,2,"PHYSICAL ABUSE (RAPE,INCEST ETC.)",0,0,0,0,0,0,0,1,0,0,0,1,0,0,0,0,0,0,1
8461,ANDHRA PRADESH,2008,2,SOCIETAL ISSUES,0,9,25,14,5,53,3,0,1,1,0,5,0,0,0,0,0,0,58
314,ANDHRA PRADESH,2009,2,CAUSES NOT KNOWN,3,239,289,165,79,775,11,75,78,32,19,215,0,0,0,0,0,0,990
860,ANDHRA PRADESH,2009,2,DEATH OF DEAR PERSON,0,2,31,26,9,68,1,8,2,7,5,23,0,0,0,0,0,0,91
1406,ANDHRA PRADESH,2009,2,DOWRY DISPUTE,0,1,10,5,0,16,0,146,12,2,0,160,0,0,0,0,0,0,176
1952,ANDHRA PRADESH,2009,2,DRUG ABUSE,0,25,31,14,4,74,0,0,0,2,1,3,0,0,0,0,0,0,77
2498,ANDHRA PRADESH,2009,2,ECONOMIC ISSUES,1,502,974,748,145,2370,9,154,207,122,42,534,0,0,0,0,0,0,2904
3044,ANDHRA PRADESH,2009,2,EXAM FAILURE,8,114,13,0,0,135,9,65,4,0,0,78,0,0,0,0,0,0,213
3590,ANDHRA PRADESH,2009,2,FAMILY PROBLEMS,9,503,716,359,48,1635,24,360,290,176,24,874,0,0,0,0,0,0,2509
4136,ANDHRA PRADESH,2009,2,HEALTH ISSUES,10,466,703,651,317,2147,14,453,370,251,113,1201,0,0,0,0,0,0,3348
4681,ANDHRA PRADESH,2009,2,HERO WORSHIP,0,18,5,69,0,92,0,1,1,0,0,2,0,0,0,0,0,0,94
5226,ANDHRA PRADESH,2009,2,ILLEGITIMATE PREGNANCY,0,0,0,0,0,0,0,3,1,0,0,4,0,0,0,0,0,0,4
5771,ANDHRA PRADESH,2009,2,LOVE AFFAIRS,4,112,22,0,0,138,6,81,11,0,0,98,0,0,0,0,0,0,236
6317,ANDHRA PRADESH,2009,2,MARITAL ISSUES,0,27,32,14,1,74,0,64,44,9,0,117,0,0,0,0,0,0,191
6863,ANDHRA PRADESH,2009,2,MENTAL HEALTH,6,132,190,101,71,500,3,132,88,49,49,321,0,0,0,0,0,0,821
7409,ANDHRA PRADESH,2009,2,OTHERS,26,574,664,420,107,1791,50,370,297,159,45,921,0,0,0,0,0,0,2712
7993,ANDHRA PRADESH,2009,2,"PHYSICAL ABUSE (RAPE,INCEST ETC.)",0,1,1,1,0,3,0,1,0,0,0,1,0,0,0,0,0,0,4
8500,ANDHRA PRADESH,2009,2,SOCIETAL ISSUES,0,11,41,13,4,69,0,21,15,20,5,61,0,0,0,0,0,0,130
353,ANDHRA PRADESH,2010,2,CAUSES NOT KNOWN,29,423,516,262,106,1336,39,143,153,62,29,426,0,0,0,0,0,0,1762
899,ANDHRA PRADESH,2010,2,DEATH OF DEAR PERSON,0,22,22,12,5,61,2,22,8,3,3,38,0,0,0,0,0,0,99
1445,ANDHRA PRADESH,2010,2,DOWRY DISPUTE,0,3,0,0,0,3,0,86,19,3,0,108,0,0,0,0,0,0,111
1991,ANDHRA PRADESH,2010,2,DRUG ABUSE,0,20,34,35,7,96,0,2,3,1,2,8,0,0,0,0,0,0,104
2537,ANDHRA PRADESH,2010,2,ECONOMIC ISSUES,0,584,928,586,136,2234,2,218,183,50,15,468,0,0,0,0,0,0,2702
3083,ANDHRA PRADESH,2010,2,EXAM FAILURE,15,145,0,0,0,160,15,74,0,0,0,89,0,0,0,0,0,0,249
3629,ANDHRA PRADESH,2010,2,FAMILY PROBLEMS,0,651,698,392,74,1815,0,417,284,102,53,856,0,0,0,0,0,0,2671
4175,ANDHRA PRADESH,2010,2,HEALTH ISSUES,25,642,695,709,366,2437,24,505,406,285,216,1436,0,0,0,0,0,0,3873
4720,ANDHRA PRADESH,2010,2,HERO WORSHIP,0,12,7,1,0,20,0,10,7,3,0,20,0,0,0,0,0,0,40
5265,ANDHRA PRADESH,2010,2,ILLEGITIMATE PREGNANCY,0,0,0,0,0,0,0,8,4,0,0,12,0,0,0,0,0,0,12
5810,ANDHRA PRADESH,2010,2,LOVE AFFAIRS,0,203,25,1,0,229,2,109,12,0,0,123,0,0,0,0,0,0,352
6356,ANDHRA PRADESH,2010,2,MARITAL ISSUES,0,58,51,5,0,114,2,103,59,15,1,180,0,0,0,0,0,0,294
6902,ANDHRA PRADESH,2010,2,MENTAL HEALTH,3,199,222,121,69,614,20,143,106,52,37,358,0,0,0,0,0,0,972
7448,ANDHRA PRADESH,2010,2,OTHERS,23,509,610,413,122,1677,24,260,308,95,72,759,0,0,0,0,0,0,2436
8032,ANDHRA PRADESH,2010,2,"PHYSICAL ABUSE (RAPE,INCEST ETC.)",0,0,0,0,0,0,0,2,0,0,0,2,0,0,0,0,0,0,2
8539,ANDHRA PRADESH,2010,2,SOCIETAL ISSUES,0,59,54,29,9,151,0,43,20,7,1,71,0,0,0,0,0,0,222
392,ANDHRA PRADESH,2011,2,CAUSES NOT KNOWN,22,267,414,280,141,1124,22,121,149,65,38,395,0,0,0,0,0,0,1519
938,ANDHRA PRADESH,2011,2,DEATH OF DEAR PERSON,0,1,9,5,1,16,3,11,2,8,5,29,0,0,0,0,0,0,45
1484,ANDHRA PRADESH,2011,2,DOWRY DISPUTE,0,21,42,9,1,73,0,201,151,5,0,357,0,0,0,0,0,0,430
2030,ANDHRA PRADESH,2011,2,DRUG ABUSE,3,35,48,21,8,115,0,5,3,1,2,11,0,0,0,0,0,0,126
2576,ANDHRA PRADESH,2011,2,ECONOMIC ISSUES,12,467,895,724,175,2273,6,188,241,75,18,528,0,0,0,0,0,0,2801
3122,ANDHRA PRADESH,2011,2,EXAM FAILURE,2,86,0,0,0,88,12,79,2,0,0,93,0,0,0,0,0,0,181
3668,ANDHRA PRADESH,2011,2,FAMILY PROBLEMS,7,599,701,432,93,1832,17,470,288,130,42,947,0,0,0,0,0,0,2779
4214,ANDHRA PRADESH,2011,2,HEALTH ISSUES,20,459,587,560,254,1880,20,525,338,203,125,1211,0,0,0,0,0,0,3091
4759,ANDHRA PRADESH,2011,2,HERO WORSHIP,0,1,0,0,0,1,0,1,2,0,0,3,0,0,0,0,0,0,4
5304,ANDHRA PRADESH,2011,2,ILLEGITIMATE PREGNANCY,0,0,0,0,0,0,0,15,1,0,0,16,0,0,0,0,0,0,16
5849,ANDHRA PRADESH,2011,2,LOVE AFFAIRS,3,151,15,2,0,171,15,142,8,0,0,165,0,0,0,0,0,0,336
6395,ANDHRA PRADESH,2011,2,MARITAL ISSUES,0,116,71,10,0,197,2,128,71,12,0,213,0,0,0,0,0,0,410
6941,ANDHRA PRADESH,2011,2,MENTAL HEALTH,8,173,200,135,141,657,10,140,108,108,40,406,0,0,0,0,0,0,1063
7487,ANDHRA PRADESH,2011,2,OTHERS,35,442,549,526,105,1657,35,253,190,53,42,573,0,0,0,0,0,0,2230
8071,ANDHRA PRADESH,2011,2,"PHYSICAL ABUSE (RAPE,INCEST ETC.)",0,0,0,0,0,0,1,2,1,0,0,4,0,0,0,0,0,0,4
8578,ANDHRA PRADESH,2011,2,SOCIETAL ISSUES,0,10,20,6,0,36,0,3,0,3,0,6,0,0,0,0,0,0,42
431,ANDHRA PRADESH,2012,2,CAUSES NOT KNOWN,23,232,383,207,85,930,20,121,83,47,15,286,0,0,0,0,0,0,1216
977,ANDHRA PRADESH,2012,2,DEATH OF DEAR PERSON,1,11,18,14,11,55,0,11,12,20,6,49,0,0,0,0,0,0,104
1523,ANDHRA PRADESH,2012,2,DOWRY DISPUTE,0,2,2,0,0,4,0,161,30,0,0,191,0,0,0,0,0,0,195
2069,ANDHRA PRADESH,2012,2,DRUG ABUSE,0,44,63,31,13,151,1,4,4,1,3,13,0,0,0,0,0,0,164
2615,ANDHRA PRADESH,2012,2,ECONOMIC ISSUES,3,455,905,568,132,2063,0,162,208,110,30,510,0,0,0,0,0,0,2573
3161,ANDHRA PRADESH,2012,2,EXAM FAILURE,8,75,10,0,0,93,11,62,2,0,0,75,0,0,0,0,0,0,168
3707,ANDHRA PRADESH,2012,2,FAMILY PROBLEMS,4,524,757,425,106,1816,18,385,287,117,28,835,0,0,0,0,0,0,2651
4253,ANDHRA PRADESH,2012,2,HEALTH ISSUES,8,369,562,546,300,1785,19,475,402,239,150,1285,0,0,0,0,0,0,3070
4798,ANDHRA PRADESH,2012,2,HERO WORSHIP,0,17,13,0,1,31,0,4,0,0,0,4,0,0,0,0,0,0,35
5343,ANDHRA PRADESH,2012,2,ILLEGITIMATE PREGNANCY,0,0,0,0,0,0,1,8,0,0,0,9,0,0,0,0,0,0,9
5888,ANDHRA PRADESH,2012,2,LOVE AFFAIRS,0,138,22,5,1,166,15,104,15,4,1,139,0,0,0,0,0,0,305
6434,ANDHRA PRADESH,2012,2,MARITAL ISSUES,0,63,44,8,1,116,1,123,87,15,3,229,0,0,0,0,0,0,345
6980,ANDHRA PRADESH,2012,2,MENTAL HEALTH,2,208,248,148,158,764,1,140,128,82,47,398,0,0,0,0,0,0,1162
7526,ANDHRA PRADESH,2012,2,OTHERS,15,390,567,374,139,1485,48,255,191,86,42,622,0,0,0,0,0,0,2107
8110,ANDHRA PRADESH,2012,2,"PHYSICAL ABUSE (RAPE,INCEST ETC.)",0,0,0,0,0,0,6,20,8,2,0,36,0,0,0,0,0,0,36
8617,ANDHRA PRADESH,2012,2,SOCIETAL ISSUES,1,15,34,14,4,68,2,11,9,7,1,30,0,0,0,0,0,0,98
470,ANDHRA PRADESH,2013,2,CAUSES NOT KNOWN,10,294,336,226,41,907,7,132,105,31,15,290,0,0,0,0,0,0,1197
1016,ANDHRA PRADESH,2013,2,DEATH OF DEAR PERSON,0,13,15,12,10,50,0,8,11,8,10,37,0,0,0,0,0,0,87
1562,ANDHRA PRADESH,2013,2,DOWRY DISPUTE,0,0,0,1,0,1,0,64,29,4,0,97,0,0,0,0,0,0,98
2108,ANDHRA PRADESH,2013,2,DRUG ABUSE,0,54,103,95,16,268,0,0,6,6,2,14,0,0,0,0,0,0,282
2654,ANDHRA PRADESH,2013,2,ECONOMIC ISSUES,2,552,791,519,78,1942,1,120,183,96,26,426,0,0,0,0,0,0,2368
3200,ANDHRA PRADESH,2013,2,EXAM FAILURE,4,108,31,0,0,143,3,83,6,0,0,92,0,0,0,0,0,0,235
3746,ANDHRA PRADESH,2013,2,FAMILY PROBLEMS,11,494,682,369,104,1660,7,442,355,111,36,951,0,0,0,0,0,0,2611
4292,ANDHRA PRADESH,2013,2,HEALTH ISSUES,10,411,576,549,408,1954,18,431,349,267,220,1285,0,0,0,0,0,0,3239
4837,ANDHRA PRADESH,2013,2,HERO WORSHIP,0,5,3,0,0,8,0,1,0,0,0,1,0,0,0,0,0,0,9
5382,ANDHRA PRADESH,2013,2,ILLEGITIMATE PREGNANCY,0,0,0,0,0,0,0,4,0,0,0,4,0,0,0,0,0,0,4
5927,ANDHRA PRADESH,2013,2,LOVE AFFAIRS,4,157,33,6,0,200,6,91,13,0,0,110,0,0,0,0,0,0,310
6473,ANDHRA PRADESH,2013,2,MARITAL ISSUES,0,62,78,24,1,165,0,110,97,7,1,215,0,0,0,0,0,0,380
7019,ANDHRA PRADESH,2013,2,MENTAL HEALTH,1,116,201,180,75,573,6,145,114,87,57,409,0,0,0,0,0,0,982
7565,ANDHRA PRADESH,2013,2,OTHERS,26,563,754,450,163,1956,33,282,221,151,57,744,0,0,0,0,0,0,2700
8149,ANDHRA PRADESH,2013,2,"PHYSICAL ABUSE (RAPE,INCEST ETC.)",0,0,0,0,0,0,0,4,2,0,0,6,0,0,0,0,0,0,6
8656,ANDHRA PRADESH,2013,2,SOCIETAL ISSUES,0,18,45,8,4,75,0,6,9,6,3,24,0,0,0,0,0,0,99
509,ANDHRA PRADESH,2014,2,CAUSES NOT KNOWN,3,135,175,101,32,446,4,44,31,18,7,104,0,0,0,0,0,0,550
1055,ANDHRA PRADESH,2014,2,DEATH OF DEAR PERSON,0,23,22,19,1,65,0,11,4,2,1,18,0,0,0,0,0,0,83
1601,ANDHRA PRADESH,2014,2,DOWRY DISPUTE,0,0,0,0,0,0,0,26,8,2,0,36,0,0,0,0,0,0,36
2147,ANDHRA PRADESH,2014,2,DRUG ABUSE,0,23,34,33,5,95,0,1,1,0,0,2,0,0,0,0,0,0,97
2693,ANDHRA PRADESH,2014,2,ECONOMIC ISSUES,0,188,259,131,24,602,2,24,26,8,4,64,0,0,0,0,0,0,666
3239,ANDHRA PRADESH,2014,2,EXAM FAILURE,2,53,0,0,0,55,2,34,1,1,0,38,0,0,0,0,0,0,93
3785,ANDHRA PRADESH,2014,2,FAMILY PROBLEMS,3,231,310,101,27,672,9,198,135,46,7,395,0,0,0,0,0,0,1067
4331,ANDHRA PRADESH,2014,2,HEALTH ISSUES,4,484,684,481,254,1907,12,477,296,181,118,1084,0,0,0,0,0,0,2991
4876,ANDHRA PRADESH,2014,2,HERO WORSHIP,0,0,0,0,0,0,0,0,0,0,0,0,0,0,0,0,0,0,0
5421,ANDHRA PRADESH,2014,2,ILLEGITIMATE PREGNANCY,0,0,0,0,0,0,0,0,0,0,0,0,0,0,0,0,0,0,0
5966,ANDHRA PRADESH,2014,2,LOVE AFFAIRS,0,80,7,0,0,87,1,48,0,0,0,49,0,0,0,0,0,0,136
6512,ANDHRA PRADESH,2014,2,MARITAL ISSUES,0,58,51,20,8,137,1,85,66,15,1,168,0,0,0,0,0,0,305
7058,ANDHRA PRADESH,2014,2,MENTAL HEALTH,0,44,48,25,18,135,0,33,18,9,6,66,0,0,0,0,0,0,201
7604,ANDHRA PRADESH,2014,2,OTHERS,9,398,422,200,70,1099,12,285,155,47,22,521,0,1,0,0,0,1,1621
7643,ANDHRA PRADESH,2014,2,PHYSICAL ABUSE,0,0,0,0,0,0,0,1,0,0,0,1,0,0,0,0,0,0,1
8695,ANDHRA PRADESH,2014,2,SOCIETAL ISSUES,0,5,0,0,1,6,0,5,0,0,0,5,0,0,0,0,0,0,11
3,ARUNACHAL PRADESH,2001,3,CAUSES NOT KNOWN,2,23,34,9,1,69,2,11,9,0,0,22,0,0,0,0,0,0,91
549,ARUNACHAL PRADESH,2001,3,DEATH OF DEAR PERSON,0,0,0,0,0,0,0,0,0,0,0,0,0,0,0,0,0,0,0
1095,ARUNACHAL PRADESH,2001,3,DOWRY DISPUTE,0,0,0,0,0,0,0,0,0,0,0,0,0,0,0,0,0,0,0
1641,ARUNACHAL PRADESH,2001,3,DRUG ABUSE,0,0,0,0,0,0,0,0,0,0,0,0,0,0,0,0,0,0,0
2187,ARUNACHAL PRADESH,2001,3,ECONOMIC ISSUES,0,0,3,1,0,4,0,4,0,0,0,4,0,0,0,0,0,0,8
2733,ARUNACHAL PRADESH,2001,3,EXAM FAILURE,0,0,0,0,0,0,0,0,0,0,0,0,0,0,0,0,0,0,0
3279,ARUNACHAL PRADESH,2001,3,FAMILY PROBLEMS,0,0,0,0,0,0,0,4,0,1,0,5,0,0,0,0,0,0,5
3825,ARUNACHAL PRADESH,2001,3,HEALTH ISSUES,0,0,1,1,0,2,0,1,0,0,0,1,0,0,0,0,0,0,3
4371,ARUNACHAL PRADESH,2001,3,HERO WORSHIP,0,0,0,0,0,0,0,0,0,0,0,0,0,0,0,0,0,0,0
4916,ARUNACHAL PRADESH,2001,3,ILLEGITIMATE PREGNANCY,0,0,0,0,0,0,0,0,0,0,0,0,0,0,0,0,0,0,0
5461,ARUNACHAL PRADESH,2001,3,LOVE AFFAIRS,0,1,0,0,0,1,0,2,0,0,0,2,0,0,0,0,0,0,3
6006,ARUNACHAL PRADESH,2001,3,MARITAL ISSUES,0,0,0,0,0,0,0,1,0,0,0,1,0,0,0,0,0,0,1
6552,ARUNACHAL PRADESH,2001,3,MENTAL HEALTH,0,0,0,0,0,0,0,0,0,0,0,0,0,0,0,0,0,0,0
7098,ARUNACHAL PRADESH,2001,3,OTHERS,0,0,0,0,0,0,0,0,0,0,0,0,0,0,0,0,0,0,0
7683,ARUNACHAL PRADESH,2001,3,"PHYSICAL ABUSE (RAPE,INCEST ETC.)",0,0,0,0,0,0,0,0,0,0,0,0,0,0,0,0,0,0,0
8189,ARUNACHAL PRADESH,2001,3,SOCIETAL ISSUES,0,0,0,0,0,0,0,0,0,0,0,0,0,0,0,0,0,0,0
42,ARUNACHAL PRADESH,2002,3,CAUSES NOT KNOWN,1,13,33,8,1,56,2,20,10,1,1,34,0,0,0,0,0,0,90
588,ARUNACHAL PRADESH,2002,3,DEATH OF DEAR PERSON,0,0,1,0,0,1,0,0,0,0,0,0,0,0,0,0,0,0,1
1134,ARUNACHAL PRADESH,2002,3,DOWRY DISPUTE,0,0,0,0,0,0,0,0,0,0,0,0,0,0,0,0,0,0,0
1680,ARUNACHAL PRADESH,2002,3,DRUG ABUSE,0,0,0,0,0,0,0,0,0,0,0,0,0,0,0,0,0,0,0
2226,ARUNACHAL PRADESH,2002,3,ECONOMIC ISSUES,0,1,0,0,0,1,0,2,0,0,0,2,0,0,0,0,0,0,3
2772,ARUNACHAL PRADESH,2002,3,EXAM FAILURE,0,1,0,0,0,1,0,1,0,0,0,1,0,0,0,0,0,0,2
3318,ARUNACHAL PRADESH,2002,3,FAMILY PROBLEMS,0,3,2,1,0,6,0,2,1,0,0,3,0,0,0,0,0,0,9
3864,ARUNACHAL PRADESH,2002,3,HEALTH ISSUES,0,1,1,0,1,3,0,0,0,0,0,0,0,0,0,0,0,0,3
4410,ARUNACHAL PRADESH,2002,3,HERO WORSHIP,0,0,0,0,0,0,0,0,0,0,0,0,0,0,0,0,0,0,0
4955,ARUNACHAL PRADESH,2002,3,ILLEGITIMATE PREGNANCY,0,0,0,0,0,0,0,0,0,0,0,0,0,0,0,0,0,0,0
5500,ARUNACHAL PRADESH,2002,3,LOVE AFFAIRS,0,1,0,0,0,1,0,2,0,0,0,2,0,0,0,0,0,0,3
6045,ARUNACHAL PRADESH,2002,3,MARITAL ISSUES,0,0,0,0,0,0,0,1,0,0,0,1,0,0,0,0,0,0,1
6591,ARUNACHAL PRADESH,2002,3,MENTAL HEALTH,0,0,1,0,1,2,0,0,0,0,0,0,0,0,0,0,0,0,2
7137,ARUNACHAL PRADESH,2002,3,OTHERS,0,0,0,0,0,0,0,0,0,0,0,0,0,0,0,0,0,0,0
7722,ARUNACHAL PRADESH,2002,3,"PHYSICAL ABUSE (RAPE,INCEST ETC.)",0,0,0,0,0,0,0,0,0,0,0,0,0,0,0,0,0,0,0
8228,ARUNACHAL PRADESH,2002,3,SOCIETAL ISSUES,0,0,0,0,0,0,0,0,0,0,0,0,0,0,0,0,0,0,0
81,ARUNACHAL PRADESH,2003,3,CAUSES NOT KNOWN,3,10,23,11,1,48,1,11,8,1,0,21,0,0,0,0,0,0,69
627,ARUNACHAL PRADESH,2003,3,DEATH OF DEAR PERSON,0,0,0,0,0,0,0,0,0,0,0,0,0,0,0,0,0,0,0
1173,ARUNACHAL PRADESH,2003,3,DOWRY DISPUTE,0,0,0,0,0,0,0,0,0,0,0,0,0,0,0,0,0,0,0
1719,ARUNACHAL PRADESH,2003,3,DRUG ABUSE,0,0,0,0,0,0,0,1,0,0,0,1,0,0,0,0,0,0,1
2265,ARUNACHAL PRADESH,2003,3,ECONOMIC ISSUES,0,0,0,0,0,0,0,0,0,0,0,0,0,0,0,0,0,0,0
2811,ARUNACHAL PRADESH,2003,3,EXAM FAILURE,0,0,0,0,0,0,0,0,0,0,0,0,0,0,0,0,0,0,0
3357,ARUNACHAL PRADESH,2003,3,FAMILY PROBLEMS,0,1,1,1,0,3,0,0,1,0,0,1,0,0,0,0,0,0,4
3903,ARUNACHAL PRADESH,2003,3,HEALTH ISSUES,0,0,0,0,1,1,0,0,1,0,0,1,0,0,0,0,0,0,2
4449,ARUNACHAL PRADESH,2003,3,HERO WORSHIP,0,0,0,0,0,0,0,0,0,0,0,0,0,0,0,0,0,0,0
4994,ARUNACHAL PRADESH,2003,3,ILLEGITIMATE PREGNANCY,0,0,0,0,0,0,0,0,0,0,0,0,0,0,0,0,0,0,0
5539,ARUNACHAL PRADESH,2003,3,LOVE AFFAIRS,0,0,0,0,0,0,0,2,0,0,0,2,0,0,0,0,0,0,2
6084,ARUNACHAL PRADESH,2003,3,MARITAL ISSUES,0,0,0,0,0,0,0,0,0,0,0,0,0,0,0,0,0,0,0
6630,ARUNACHAL PRADESH,2003,3,MENTAL HEALTH,0,0,2,0,0,2,0,0,0,1,0,1,0,0,0,0,0,0,3
7176,ARUNACHAL PRADESH,2003,3,OTHERS,0,0,0,0,0,0,0,0,0,0,0,0,0,0,0,0,0,0,0
7761,ARUNACHAL PRADESH,2003,3,"PHYSICAL ABUSE (RAPE,INCEST ETC.)",0,0,0,0,0,0,0,0,0,0,0,0,0,0,0,0,0,0,0
8267,ARUNACHAL PRADESH,2003,3,SOCIETAL ISSUES,0,0,0,0,0,0,0,0,0,0,0,0,0,0,0,0,0,0,0
120,ARUNACHAL PRADESH,2004,3,CAUSES NOT KNOWN,1,18,23,6,0,48,4,12,9,0,0,25,0,0,0,0,0,0,73
666,ARUNACHAL PRADESH,2004,3,DEATH OF DEAR PERSON,0,0,0,0,0,0,0,0,0,0,0,0,0,0,0,0,0,0,0
1212,ARUNACHAL PRADESH,2004,3,DOWRY DISPUTE,0,0,0,0,0,0,0,0,0,0,0,0,0,0,0,0,0,0,0
1758,ARUNACHAL PRADESH,2004,3,DRUG ABUSE,0,0,1,0,0,1,0,0,0,0,0,0,0,0,0,0,0,0,1
2304,ARUNACHAL PRADESH,2004,3,ECONOMIC ISSUES,0,0,0,0,0,0,0,0,2,0,0,2,0,0,0,0,0,0,2
2850,ARUNACHAL PRADESH,2004,3,EXAM FAILURE,0,0,0,0,0,0,0,0,0,0,0,0,0,0,0,0,0,0,0
3396,ARUNACHAL PRADESH,2004,3,FAMILY PROBLEMS,0,0,0,0,0,0,0,0,2,0,0,2,0,0,0,0,0,0,2
3942,ARUNACHAL PRADESH,2004,3,HEALTH ISSUES,0,0,0,0,0,0,0,0,0,0,0,0,0,0,0,0,0,0,0
4488,ARUNACHAL PRADESH,2004,3,HERO WORSHIP,0,0,0,0,0,0,0,0,0,0,0,0,0,0,0,0,0,0,0
5033,ARUNACHAL PRADESH,2004,3,ILLEGITIMATE PREGNANCY,0,0,0,0,0,0,0,0,0,0,0,0,0,0,0,0,0,0,0
5578,ARUNACHAL PRADESH,2004,3,LOVE AFFAIRS,0,0,0,0,0,0,0,0,0,0,0,0,0,0,0,0,0,0,0
6123,ARUNACHAL PRADESH,2004,3,MARITAL ISSUES,0,0,0,0,0,0,0,0,0,0,0,0,0,0,0,0,0,0,0
6669,ARUNACHAL PRADESH,2004,3,MENTAL HEALTH,0,0,0,0,0,0,0,1,0,0,0,1,0,0,0,0,0,0,1
7215,ARUNACHAL PRADESH,2004,3,OTHERS,0,0,0,0,0,0,0,0,0,0,0,0,0,0,0,0,0,0,0
7800,ARUNACHAL PRADESH,2004,3,"PHYSICAL ABUSE (RAPE,INCEST ETC.)",0,0,0,0,0,0,0,0,0,0,0,0,0,0,0,0,0,0,0
8306,ARUNACHAL PRADESH,2004,3,SOCIETAL ISSUES,0,0,0,0,0,0,0,0,0,0,0,0,0,0,0,0,0,0,0
159,ARUNACHAL PRADESH,2005,3,CAUSES NOT KNOWN,0,13,22,3,3,41,0,7,9,1,1,18,0,0,0,0,0,0,59
705,ARUNACHAL PRADESH,2005,3,DEATH OF DEAR PERSON,0,0,0,0,0,0,0,0,0,0,0,0,0,0,0,0,0,0,0
1251,ARUNACHAL PRADESH,2005,3,DOWRY DISPUTE,0,0,0,0,0,0,0,0,0,0,0,0,0,0,0,0,0,0,0
1797,ARUNACHAL PRADESH,2005,3,DRUG ABUSE,0,0,0,0,0,0,0,0,0,0,0,0,0,0,0,0,0,0,0
2343,ARUNACHAL PRADESH,2005,3,ECONOMIC ISSUES,0,0,0,0,0,0,0,0,0,0,0,0,0,0,0,0,0,0,0
2889,ARUNACHAL PRADESH,2005,3,EXAM FAILURE,0,0,0,0,0,0,0,0,0,0,0,0,0,0,0,0,0,0,0
3435,ARUNACHAL PRADESH,2005,3,FAMILY PROBLEMS,0,0,4,1,1,6,0,0,0,0,0,0,0,0,0,0,0,0,6
3981,ARUNACHAL PRADESH,2005,3,HEALTH ISSUES,0,0,2,0,0,2,0,0,0,0,0,0,0,0,0,0,0,0,2
4527,ARUNACHAL PRADESH,2005,3,HERO WORSHIP,0,0,0,0,0,0,0,0,0,0,0,0,0,0,0,0,0,0,0
5072,ARUNACHAL PRADESH,2005,3,ILLEGITIMATE PREGNANCY,0,0,0,0,0,0,0,0,0,0,0,0,0,0,0,0,0,0,0
5617,ARUNACHAL PRADESH,2005,3,LOVE AFFAIRS,0,0,0,0,0,0,0,1,0,0,0,1,0,0,0,0,0,0,1
6162,ARUNACHAL PRADESH,2005,3,MARITAL ISSUES,0,0,0,0,0,0,0,1,0,0,0,1,0,0,0,0,0,0,1
6708,ARUNACHAL PRADESH,2005,3,MENTAL HEALTH,0,0,0,0,0,0,0,0,0,0,0,0,0,0,0,0,0,0,0
7254,ARUNACHAL PRADESH,2005,3,OTHERS,0,0,0,0,0,0,0,0,0,0,0,0,0,0,0,0,0,0,0
7839,ARUNACHAL PRADESH,2005,3,"PHYSICAL ABUSE (RAPE,INCEST ETC.)",0,0,0,0,0,0,0,0,0,0,0,0,0,0,0,0,0,0,0
8345,ARUNACHAL PRADESH,2005,3,SOCIETAL ISSUES,0,0,0,0,0,0,0,1,0,0,0,1,0,0,0,0,0,0,1
198,ARUNACHAL PRADESH,2006,3,CAUSES NOT KNOWN,1,15,17,12,0,45,3,7,8,2,0,20,0,0,0,0,0,0,65
744,ARUNACHAL PRADESH,2006,3,DEATH OF DEAR PERSON,0,0,0,0,0,0,0,0,0,0,0,0,0,0,0,0,0,0,0
1290,ARUNACHAL PRADESH,2006,3,DOWRY DISPUTE,0,0,0,0,0,0,0,0,0,0,0,0,0,0,0,0,0,0,0
1836,ARUNACHAL PRADESH,2006,3,DRUG ABUSE,0,0,0,0,0,0,0,0,0,0,0,0,0,0,0,0,0,0,0
2382,ARUNACHAL PRADESH,2006,3,ECONOMIC ISSUES,0,0,0,0,0,0,0,0,0,0,0,0,0,0,0,0,0,0,0
2928,ARUNACHAL PRADESH,2006,3,EXAM FAILURE,0,0,0,0,0,0,0,1,0,0,0,1,0,0,0,0,0,0,1
3474,ARUNACHAL PRADESH,2006,3,FAMILY PROBLEMS,0,1,6,3,0,10,0,5,3,0,0,8,0,0,0,0,0,0,18
4020,ARUNACHAL PRADESH,2006,3,HEALTH ISSUES,0,0,1,0,0,1,0,0,0,0,0,0,0,0,0,0,0,0,1
4566,ARUNACHAL PRADESH,2006,3,HERO WORSHIP,0,0,0,0,0,0,0,0,0,0,0,0,0,0,0,0,0,0,0
5111,ARUNACHAL PRADESH,2006,3,ILLEGITIMATE PREGNANCY,0,0,0,0,0,0,0,0,0,0,0,0,0,0,0,0,0,0,0
5656,ARUNACHAL PRADESH,2006,3,LOVE AFFAIRS,0,2,0,0,0,2,0,1,0,0,0,1,0,0,0,0,0,0,3
6201,ARUNACHAL PRADESH,2006,3,MARITAL ISSUES,0,0,0,0,0,0,0,0,0,0,0,0,0,0,0,0,0,0,0
6747,ARUNACHAL PRADESH,2006,3,MENTAL HEALTH,0,0,0,0,0,0,0,0,0,1,0,1,0,0,0,0,0,0,1
7293,ARUNACHAL PRADESH,2006,3,OTHERS,0,10,21,6,1,38,0,1,1,0,0,2,0,0,0,0,0,0,40
7878,ARUNACHAL PRADESH,2006,3,"PHYSICAL ABUSE (RAPE,INCEST ETC.)",0,0,0,0,0,0,0,0,0,0,0,0,0,0,0,0,0,0,0
8384,ARUNACHAL PRADESH,2006,3,SOCIETAL ISSUES,0,0,0,0,0,0,0,0,0,0,0,0,0,0,0,0,0,0,0
237,ARUNACHAL PRADESH,2007,3,CAUSES NOT KNOWN,1,11,8,2,0,22,1,4,1,1,0,7,0,0,0,0,0,0,29
783,ARUNACHAL PRADESH,2007,3,DEATH OF DEAR PERSON,0,0,0,0,0,0,0,0,0,0,0,0,0,0,0,0,0,0,0
1329,ARUNACHAL PRADESH,2007,3,DOWRY DISPUTE,0,0,0,0,0,0,0,0,0,0,0,0,0,0,0,0,0,0,0
1875,ARUNACHAL PRADESH,2007,3,DRUG ABUSE,0,0,0,0,0,0,0,0,0,0,0,0,0,0,0,0,0,0,0
2421,ARUNACHAL PRADESH,2007,3,ECONOMIC ISSUES,1,5,9,1,0,16,0,1,1,0,0,2,0,0,0,0,0,0,18
2967,ARUNACHAL PRADESH,2007,3,EXAM FAILURE,0,0,0,0,0,0,0,0,0,0,0,0,0,0,0,0,0,0,0
3513,ARUNACHAL PRADESH,2007,3,FAMILY PROBLEMS,0,0,4,0,0,4,0,0,0,1,0,1,0,0,0,0,0,0,5
4059,ARUNACHAL PRADESH,2007,3,HEALTH ISSUES,0,0,1,0,0,1,0,0,0,0,0,0,0,0,0,0,0,0,1
4604,ARUNACHAL PRADESH,2007,3,HERO WORSHIP,0,0,0,0,0,0,0,0,0,0,0,0,0,0,0,0,0,0,0
5149,ARUNACHAL PRADESH,2007,3,ILLEGITIMATE PREGNANCY,0,0,0,0,0,0,0,0,0,0,0,0,0,0,0,0,0,0,0
5694,ARUNACHAL PRADESH,2007,3,LOVE AFFAIRS,0,1,0,0,0,1,0,1,0,0,0,1,0,0,0,0,0,0,2
6240,ARUNACHAL PRADESH,2007,3,MARITAL ISSUES,0,0,0,0,0,0,0,0,0,0,0,0,0,0,0,0,0,0,0
6786,ARUNACHAL PRADESH,2007,3,MENTAL HEALTH,0,1,4,0,0,5,0,0,0,0,0,0,0,0,0,0,0,0,5
7332,ARUNACHAL PRADESH,2007,3,OTHERS,0,21,18,7,3,49,4,8,8,0,0,20,0,0,0,0,0,0,69
7916,ARUNACHAL PRADESH,2007,3,"PHYSICAL ABUSE (RAPE,INCEST ETC.)",0,0,0,0,0,0,0,0,0,0,0,0,0,0,0,0,0,0,0
8423,ARUNACHAL PRADESH,2007,3,SOCIETAL ISSUES,0,0,0,0,0,0,0,0,0,0,0,0,0,0,0,0,0,0,0
276,ARUNACHAL PRADESH,2008,3,CAUSES NOT KNOWN,2,17,17,5,0,41,0,16,11,1,0,28,0,0,0,0,0,0,69
822,ARUNACHAL PRADESH,2008,3,DEATH OF DEAR PERSON,0,0,0,0,0,0,0,0,0,0,0,0,0,0,0,0,0,0,0
1368,ARUNACHAL PRADESH,2008,3,DOWRY DISPUTE,0,0,0,0,0,0,0,0,0,0,0,0,0,0,0,0,0,0,0
1914,ARUNACHAL PRADESH,2008,3,DRUG ABUSE,0,0,0,0,0,0,0,0,0,0,0,0,0,0,0,0,0,0,0
2460,ARUNACHAL PRADESH,2008,3,ECONOMIC ISSUES,0,0,0,0,0,0,0,0,0,0,0,0,0,0,0,0,0,0,0
3006,ARUNACHAL PRADESH,2008,3,EXAM FAILURE,0,0,0,0,0,0,0,1,0,0,0,1,0,0,0,0,0,0,1
3552,ARUNACHAL PRADESH,2008,3,FAMILY PROBLEMS,0,0,1,1,0,2,0,2,2,0,0,4,0,0,0,0,0,0,6
4098,ARUNACHAL PRADESH,2008,3,HEALTH ISSUES,0,1,1,1,0,3,0,0,0,0,0,0,0,0,0,0,0,0,3
4643,ARUNACHAL PRADESH,2008,3,HERO WORSHIP,0,0,0,0,0,0,0,0,0,0,0,0,0,0,0,0,0,0,0
5188,ARUNACHAL PRADESH,2008,3,ILLEGITIMATE PREGNANCY,0,0,0,0,0,0,0,0,0,0,0,0,0,0,0,0,0,0,0
5733,ARUNACHAL PRADESH,2008,3,LOVE AFFAIRS,0,3,0,0,0,3,0,0,0,0,0,0,0,0,0,0,0,0,3
6279,ARUNACHAL PRADESH,2008,3,MARITAL ISSUES,0,0,0,0,0,0,0,0,0,0,0,0,0,0,0,0,0,0,0
6825,ARUNACHAL PRADESH,2008,3,MENTAL HEALTH,0,0,1,0,0,1,0,0,0,0,0,0,0,0,0,0,0,0,1
7371,ARUNACHAL PRADESH,2008,3,OTHERS,0,22,5,0,0,27,0,0,0,0,0,0,0,0,0,0,0,0,27
7955,ARUNACHAL PRADESH,2008,3,"PHYSICAL ABUSE (RAPE,INCEST ETC.)",0,0,0,0,0,0,0,0,0,0,0,0,0,0,0,0,0,0,0
8462,ARUNACHAL PRADESH,2008,3,SOCIETAL ISSUES,0,0,0,0,0,0,0,0,0,0,0,0,0,0,0,0,0,0,0
315,ARUNACHAL PRADESH,2009,3,CAUSES NOT KNOWN,2,17,17,5,0,41,0,16,11,1,0,28,0,0,0,0,0,0,69
861,ARUNACHAL PRADESH,2009,3,DEATH OF DEAR PERSON,0,0,0,0,0,0,0,0,0,0,0,0,0,0,0,0,0,0,0
1407,ARUNACHAL PRADESH,2009,3,DOWRY DISPUTE,0,0,0,0,0,0,0,0,0,0,0,0,0,0,0,0,0,0,0
1953,ARUNACHAL PRADESH,2009,3,DRUG ABUSE,0,0,0,0,0,0,0,0,0,0,0,0,0,0,0,0,0,0,0
2499,ARUNACHAL PRADESH,2009,3,ECONOMIC ISSUES,0,0,0,0,0,0,0,0,0,0,0,0,0,0,0,0,0,0,0
3045,ARUNACHAL PRADESH,2009,3,EXAM FAILURE,0,0,0,0,0,0,0,1,0,0,0,1,0,0,0,0,0,0,1
3591,ARUNACHAL PRADESH,2009,3,FAMILY PROBLEMS,0,0,1,1,0,2,0,2,2,0,0,4,0,0,0,0,0,0,6
4137,ARUNACHAL PRADESH,2009,3,HEALTH ISSUES,0,1,1,1,0,3,0,0,0,0,0,0,0,0,0,0,0,0,3
4682,ARUNACHAL PRADESH,2009,3,HERO WORSHIP,0,0,0,0,0,0,0,0,0,0,0,0,0,0,0,0,0,0,0
5227,ARUNACHAL PRADESH,2009,3,ILLEGITIMATE PREGNANCY,0,0,0,0,0,0,0,0,0,0,0,0,0,0,0,0,0,0,0
5772,ARUNACHAL PRADESH,2009,3,LOVE AFFAIRS,0,3,0,0,0,3,0,0,0,0,0,0,0,0,0,0,0,0,3
6318,ARUNACHAL PRADESH,2009,3,MARITAL ISSUES,0,0,0,0,0,0,0,0,0,0,0,0,0,0,0,0,0,0,0
6864,ARUNACHAL PRADESH,2009,3,MENTAL HEALTH,0,0,1,0,0,1,0,0,0,0,0,0,0,0,0,0,0,0,1
7410,ARUNACHAL PRADESH,2009,3,OTHERS,0,22,5,0,0,27,0,0,0,0,0,0,0,0,0,0,0,0,27
7994,ARUNACHAL PRADESH,2009,3,"PHYSICAL ABUSE (RAPE,INCEST ETC.)",0,0,0,0,0,0,0,0,0,0,0,0,0,0,0,0,0,0,0
8501,ARUNACHAL PRADESH,2009,3,SOCIETAL ISSUES,0,0,0,0,0,0,0,0,0,0,0,0,0,0,0,0,0,0,0
354,ARUNACHAL PRADESH,2010,3,CAUSES NOT KNOWN,1,17,14,2,0,34,3,10,4,1,0,18,0,0,0,0,0,0,52
900,ARUNACHAL PRADESH,2010,3,DEATH OF DEAR PERSON,0,0,0,0,0,0,0,0,0,0,0,0,0,0,0,0,0,0,0
1446,ARUNACHAL PRADESH,2010,3,DOWRY DISPUTE,0,0,0,0,0,0,0,0,0,0,0,0,0,0,0,0,0,0,0
1992,ARUNACHAL PRADESH,2010,3,DRUG ABUSE,0,0,0,0,0,0,0,0,0,0,0,0,0,0,0,0,0,0,0
2538,ARUNACHAL PRADESH,2010,3,ECONOMIC ISSUES,0,3,0,0,0,3,0,0,0,0,0,0,0,0,0,0,0,0,3
3084,ARUNACHAL PRADESH,2010,3,EXAM FAILURE,0,0,0,0,0,0,0,0,0,0,0,0,0,0,0,0,0,0,0
3630,ARUNACHAL PRADESH,2010,3,FAMILY PROBLEMS,0,6,1,1,1,9,0,2,2,0,0,4,0,0,0,0,0,0,13
4176,ARUNACHAL PRADESH,2010,3,HEALTH ISSUES,0,0,1,0,0,1,0,0,0,0,0,0,0,0,0,0,0,0,1
4721,ARUNACHAL PRADESH,2010,3,HERO WORSHIP,0,0,0,0,0,0,0,0,0,0,0,0,0,0,0,0,0,0,0
5266,ARUNACHAL PRADESH,2010,3,ILLEGITIMATE PREGNANCY,0,0,0,0,0,0,0,0,0,0,0,0,0,0,0,0,0,0,0
5811,ARUNACHAL PRADESH,2010,3,LOVE AFFAIRS,0,0,0,0,0,0,0,2,0,0,0,2,0,0,0,0,0,0,2
6357,ARUNACHAL PRADESH,2010,3,MARITAL ISSUES,0,0,0,0,0,0,0,1,0,0,0,1,0,0,0,0,0,0,1
6903,ARUNACHAL PRADESH,2010,3,MENTAL HEALTH,1,0,1,0,0,2,0,0,0,0,0,0,0,0,0,0,0,0,2
7449,ARUNACHAL PRADESH,2010,3,OTHERS,2,21,15,3,1,42,1,11,2,1,0,15,0,0,0,0,0,0,57
8033,ARUNACHAL PRADESH,2010,3,"PHYSICAL ABUSE (RAPE,INCEST ETC.)",0,0,0,0,0,0,0,0,0,0,0,0,0,0,0,0,0,0,0
8540,ARUNACHAL PRADESH,2010,3,SOCIETAL ISSUES,0,0,0,0,0,0,0,0,0,0,0,0,0,0,0,0,0,0,0
393,ARUNACHAL PRADESH,2011,3,CAUSES NOT KNOWN,3,23,23,8,1,58,4,12,2,0,0,18,0,0,0,0,0,0,76
939,ARUNACHAL PRADESH,2011,3,DEATH OF DEAR PERSON,0,0,0,1,0,1,0,0,0,0,0,0,0,0,0,0,0,0,1
1485,ARUNACHAL PRADESH,2011,3,DOWRY DISPUTE,0,0,0,0,0,0,0,0,0,0,0,0,0,0,0,0,0,0,0
2031,ARUNACHAL PRADESH,2011,3,DRUG ABUSE,0,0,0,1,0,1,0,0,0,0,0,0,0,0,0,0,0,0,1
2577,ARUNACHAL PRADESH,2011,3,ECONOMIC ISSUES,0,0,1,0,0,1,0,0,1,0,0,1,0,0,0,0,0,0,2
3123,ARUNACHAL PRADESH,2011,3,EXAM FAILURE,0,0,0,0,0,0,0,0,0,0,0,0,0,0,0,0,0,0,0
3669,ARUNACHAL PRADESH,2011,3,FAMILY PROBLEMS,0,4,4,1,0,9,1,1,3,0,0,5,0,0,0,0,0,0,14
4215,ARUNACHAL PRADESH,2011,3,HEALTH ISSUES,0,0,2,2,1,5,0,0,0,0,0,0,0,0,0,0,0,0,5
4760,ARUNACHAL PRADESH,2011,3,HERO WORSHIP,0,0,0,0,0,0,0,0,0,0,0,0,0,0,0,0,0,0,0
5305,ARUNACHAL PRADESH,2011,3,ILLEGITIMATE PREGNANCY,0,0,0,0,0,0,0,0,0,0,0,0,0,0,0,0,0,0,0
5850,ARUNACHAL PRADESH,2011,3,LOVE AFFAIRS,0,1,0,0,0,1,0,1,0,0,0,1,0,0,0,0,0,0,2
6396,ARUNACHAL PRADESH,2011,3,MARITAL ISSUES,0,0,0,0,0,0,0,0,0,0,0,0,0,0,0,0,0,0,0
6942,ARUNACHAL PRADESH,2011,3,MENTAL HEALTH,0,0,0,0,1,1,0,0,0,0,1,1,0,0,0,0,0,0,2
7488,ARUNACHAL PRADESH,2011,3,OTHERS,1,10,4,7,0,22,0,5,3,1,0,9,0,0,0,0,0,0,31
8072,ARUNACHAL PRADESH,2011,3,"PHYSICAL ABUSE (RAPE,INCEST ETC.)",0,0,0,0,0,0,0,0,0,0,0,0,0,0,0,0,0,0,0
8579,ARUNACHAL PRADESH,2011,3,SOCIETAL ISSUES,0,0,0,0,0,0,0,0,0,0,0,0,0,0,0,0,0,0,0
432,ARUNACHAL PRADESH,2012,3,CAUSES NOT KNOWN,1,19,21,11,1,53,0,15,2,1,0,18,0,0,0,0,0,0,71
978,ARUNACHAL PRADESH,2012,3,DEATH OF DEAR PERSON,0,0,0,0,0,0,0,0,0,0,0,0,0,0,0,0,0,0,0
1524,ARUNACHAL PRADESH,2012,3,DOWRY DISPUTE,0,0,0,0,0,0,0,0,0,0,0,0,0,0,0,0,0,0,0
2070,ARUNACHAL PRADESH,2012,3,DRUG ABUSE,0,0,0,0,0,0,0,0,0,0,0,0,0,0,0,0,0,0,0
2616,ARUNACHAL PRADESH,2012,3,ECONOMIC ISSUES,0,0,2,3,0,5,0,0,0,0,0,0,0,0,0,0,0,0,5
3162,ARUNACHAL PRADESH,2012,3,EXAM FAILURE,0,0,0,0,0,0,0,0,0,0,0,0,0,0,0,0,0,0,0
3708,ARUNACHAL PRADESH,2012,3,FAMILY PROBLEMS,0,2,2,1,0,5,0,0,3,0,0,3,0,0,0,0,0,0,8
4254,ARUNACHAL PRADESH,2012,3,HEALTH ISSUES,0,1,2,2,0,5,0,0,0,0,0,0,0,0,0,0,0,0,5
4799,ARUNACHAL PRADESH,2012,3,HERO WORSHIP,0,0,0,0,0,0,0,0,0,0,0,0,0,0,0,0,0,0,0
5344,ARUNACHAL PRADESH,2012,3,ILLEGITIMATE PREGNANCY,0,0,0,0,0,0,0,0,0,0,0,0,0,0,0,0,0,0,0
5889,ARUNACHAL PRADESH,2012,3,LOVE AFFAIRS,0,2,0,0,0,2,0,1,0,0,0,1,0,0,0,0,0,0,3
6435,ARUNACHAL PRADESH,2012,3,MARITAL ISSUES,0,1,0,0,0,1,0,1,0,0,0,1,0,0,0,0,0,0,2
6981,ARUNACHAL PRADESH,2012,3,MENTAL HEALTH,0,0,1,1,0,2,0,0,0,0,0,0,0,0,0,0,0,0,2
7527,ARUNACHAL PRADESH,2012,3,OTHERS,0,3,11,13,0,27,0,3,4,0,0,7,0,0,0,0,0,0,34
8111,ARUNACHAL PRADESH,2012,3,"PHYSICAL ABUSE (RAPE,INCEST ETC.)",0,0,0,0,0,0,0,0,0,0,0,0,0,0,0,0,0,0,0
8618,ARUNACHAL PRADESH,2012,3,SOCIETAL ISSUES,0,0,0,0,0,0,0,0,0,0,0,0,0,0,0,0,0,0,0
471,ARUNACHAL PRADESH,2013,3,CAUSES NOT KNOWN,1,31,14,9,2,57,3,6,8,0,0,17,0,0,0,0,0,0,74
1017,ARUNACHAL PRADESH,2013,3,DEATH OF DEAR PERSON,2,0,2,1,0,5,0,0,0,1,0,1,0,0,0,0,0,0,6
1563,ARUNACHAL PRADESH,2013,3,DOWRY DISPUTE,0,0,0,0,0,0,0,0,0,0,0,0,0,0,0,0,0,0,0
2109,ARUNACHAL PRADESH,2013,3,DRUG ABUSE,0,0,0,0,0,0,0,0,1,0,0,1,0,0,0,0,0,0,1
2655,ARUNACHAL PRADESH,2013,3,ECONOMIC ISSUES,0,1,1,0,0,2,0,0,0,0,0,0,0,0,0,0,0,0,2
3201,ARUNACHAL PRADESH,2013,3,EXAM FAILURE,0,0,0,0,0,0,0,1,0,0,0,1,0,0,0,0,0,0,1
3747,ARUNACHAL PRADESH,2013,3,FAMILY PROBLEMS,1,5,8,7,2,23,0,8,3,1,0,12,0,0,0,0,0,0,35
4293,ARUNACHAL PRADESH,2013,3,HEALTH ISSUES,0,1,11,7,1,20,0,1,3,1,0,5,0,0,0,0,0,0,25
4838,ARUNACHAL PRADESH,2013,3,HERO WORSHIP,0,0,0,0,0,0,0,0,0,0,0,0,0,0,0,0,0,0,0
5383,ARUNACHAL PRADESH,2013,3,ILLEGITIMATE PREGNANCY,0,0,0,0,0,0,0,0,0,0,0,0,0,0,0,0,0,0,0
5928,ARUNACHAL PRADESH,2013,3,LOVE AFFAIRS,0,1,0,0,0,1,0,2,0,0,0,2,0,0,0,0,0,0,3
6474,ARUNACHAL PRADESH,2013,3,MARITAL ISSUES,0,1,2,0,0,3,0,3,0,0,0,3,0,0,0,0,0,0,6
7020,ARUNACHAL PRADESH,2013,3,MENTAL HEALTH,0,1,0,2,0,3,0,0,0,0,0,0,0,0,0,0,0,0,3
7566,ARUNACHAL PRADESH,2013,3,OTHERS,3,15,25,7,5,55,1,10,4,0,1,16,0,0,0,0,0,0,71
8150,ARUNACHAL PRADESH,2013,3,"PHYSICAL ABUSE (RAPE,INCEST ETC.)",0,0,0,0,0,0,0,0,0,0,0,0,0,0,0,0,0,0,0
8657,ARUNACHAL PRADESH,2013,3,SOCIETAL ISSUES,0,0,2,0,0,2,0,0,0,0,0,0,0,0,0,0,0,0,2
510,ARUNACHAL PRADESH,2014,3,CAUSES NOT KNOWN,0,22,14,5,1,42,2,10,0,0,0,12,0,0,0,0,0,0,54
1056,ARUNACHAL PRADESH,2014,3,DEATH OF DEAR PERSON,0,0,0,0,0,0,0,0,0,0,0,0,0,0,0,0,0,0,0
1602,ARUNACHAL PRADESH,2014,3,DOWRY DISPUTE,0,0,0,0,0,0,0,0,0,0,0,0,0,0,0,0,0,0,0
2148,ARUNACHAL PRADESH,2014,3,DRUG ABUSE,0,0,0,0,0,0,0,0,0,0,0,0,0,0,0,0,0,0,0
2694,ARUNACHAL PRADESH,2014,3,ECONOMIC ISSUES,0,2,1,0,0,3,0,2,0,0,0,2,0,0,0,0,0,0,5
3240,ARUNACHAL PRADESH,2014,3,EXAM FAILURE,0,0,0,0,0,0,0,0,0,0,0,0,0,0,0,0,0,0,0
3786,ARUNACHAL PRADESH,2014,3,FAMILY PROBLEMS,0,15,2,3,0,20,0,8,4,0,0,12,0,0,0,0,0,0,32
4332,ARUNACHAL PRADESH,2014,3,HEALTH ISSUES,0,1,0,0,2,3,0,8,0,0,0,8,0,0,0,0,0,0,11
4877,ARUNACHAL PRADESH,2014,3,HERO WORSHIP,0,0,0,0,0,0,0,0,0,0,0,0,0,0,0,0,0,0,0
5422,ARUNACHAL PRADESH,2014,3,ILLEGITIMATE PREGNANCY,0,0,0,0,0,0,0,0,0,0,0,0,0,0,0,0,0,0,0
5967,ARUNACHAL PRADESH,2014,3,LOVE AFFAIRS,0,2,0,0,0,2,0,2,0,0,0,2,0,0,0,0,0,0,4
6513,ARUNACHAL PRADESH,2014,3,MARITAL ISSUES,0,0,4,0,0,4,0,0,2,0,0,2,0,0,0,0,0,0,6
7059,ARUNACHAL PRADESH,2014,3,MENTAL HEALTH,0,1,0,0,0,1,0,0,0,0,0,0,0,0,0,0,0,0,1
7605,ARUNACHAL PRADESH,2014,3,OTHERS,2,12,17,8,0,39,0,10,3,1,0,14,0,0,0,0,0,0,53
7644,ARUNACHAL PRADESH,2014,3,PHYSICAL ABUSE,0,0,0,0,0,0,0,0,0,0,0,0,0,0,0,0,0,0,0
8696,ARUNACHAL PRADESH,2014,3,SOCIETAL ISSUES,2,0,0,0,0,2,0,0,0,0,0,0,0,0,0,0,0,0,2
4,ASSAM,2001,4,CAUSES NOT KNOWN,20,145,163,104,19,451,10,91,95,43,8,247,0,0,0,0,0,0,698
550,ASSAM,2001,4,DEATH OF DEAR PERSON,0,0,2,4,2,8,0,1,1,0,0,2,0,0,0,0,0,0,10
1096,ASSAM,2001,4,DOWRY DISPUTE,0,0,0,0,0,0,0,9,4,0,0,13,0,0,0,0,0,0,13
1642,ASSAM,2001,4,DRUG ABUSE,0,3,3,2,0,8,0,0,0,0,0,0,0,0,0,0,0,0,8
2188,ASSAM,2001,4,ECONOMIC ISSUES,0,153,254,159,16,582,0,52,41,23,1,117,0,0,0,0,0,0,699
2734,ASSAM,2001,4,EXAM FAILURE,4,47,4,0,0,55,1,16,4,0,0,21,0,0,0,0,0,0,76
3280,ASSAM,2001,4,FAMILY PROBLEMS,1,53,74,56,2,186,0,34,38,19,1,92,0,0,0,0,0,0,278
3826,ASSAM,2001,4,HEALTH ISSUES,2,18,23,23,10,76,2,6,10,10,3,31,0,0,0,0,0,0,107
4372,ASSAM,2001,4,HERO WORSHIP,0,0,0,0,0,0,0,0,0,0,0,0,0,0,0,0,0,0,0
4917,ASSAM,2001,4,ILLEGITIMATE PREGNANCY,0,0,0,0,0,0,0,12,4,0,0,16,0,0,0,0,0,0,16
5462,ASSAM,2001,4,LOVE AFFAIRS,1,131,95,17,0,244,0,117,39,2,0,158,0,0,0,0,0,0,402
6007,ASSAM,2001,4,MARITAL ISSUES,0,2,5,0,0,7,0,7,3,2,0,12,0,0,0,0,0,0,19
6553,ASSAM,2001,4,MENTAL HEALTH,0,5,11,10,6,32,0,4,6,8,3,21,0,0,0,0,0,0,53
7099,ASSAM,2001,4,OTHERS,7,49,60,42,6,164,3,31,21,11,0,66,0,0,0,0,0,0,230
7684,ASSAM,2001,4,"PHYSICAL ABUSE (RAPE,INCEST ETC.)",0,4,2,0,0,6,0,0,0,0,0,0,0,0,0,0,0,0,6
8190,ASSAM,2001,4,SOCIETAL ISSUES,0,10,6,1,0,17,3,3,8,1,0,15,0,0,0,0,0,0,32
43,ASSAM,2002,4,CAUSES NOT KNOWN,12,117,123,111,14,377,11,95,58,38,7,209,0,0,0,0,0,0,586
589,ASSAM,2002,4,DEATH OF DEAR PERSON,0,4,6,0,0,10,0,2,4,0,0,6,0,0,0,0,0,0,16
1135,ASSAM,2002,4,DOWRY DISPUTE,0,0,0,0,0,0,0,11,4,0,0,15,0,0,0,0,0,0,15
1681,ASSAM,2002,4,DRUG ABUSE,0,7,10,2,0,19,0,5,5,0,0,10,0,0,0,0,0,0,29
2227,ASSAM,2002,4,ECONOMIC ISSUES,0,140,234,129,4,507,0,53,31,22,1,107,0,0,0,0,0,0,614
2773,ASSAM,2002,4,EXAM FAILURE,2,25,5,0,0,32,4,9,3,0,0,16,0,0,0,0,0,0,48
3319,ASSAM,2002,4,FAMILY PROBLEMS,5,62,71,49,9,196,2,36,43,15,5,101,0,0,0,0,0,0,297
3865,ASSAM,2002,4,HEALTH ISSUES,0,34,58,39,12,143,0,18,25,16,4,63,0,0,0,0,0,0,206
4411,ASSAM,2002,4,HERO WORSHIP,0,0,0,0,0,0,0,0,0,0,0,0,0,0,0,0,0,0,0
4956,ASSAM,2002,4,ILLEGITIMATE PREGNANCY,0,0,0,0,0,0,0,17,8,0,0,25,0,0,0,0,0,0,25
5501,ASSAM,2002,4,LOVE AFFAIRS,2,92,87,3,0,184,5,78,42,3,0,128,0,0,0,0,0,0,312
6046,ASSAM,2002,4,MARITAL ISSUES,0,9,5,12,0,26,0,11,6,0,0,17,0,0,0,0,0,0,43
6592,ASSAM,2002,4,MENTAL HEALTH,0,5,19,5,7,36,0,1,9,4,3,17,0,0,0,0,0,0,53
7138,ASSAM,2002,4,OTHERS,2,57,55,25,6,145,2,30,30,5,4,71,0,0,0,0,0,0,216
7723,ASSAM,2002,4,"PHYSICAL ABUSE (RAPE,INCEST ETC.)",0,1,0,0,0,1,0,1,2,0,0,3,0,0,0,0,0,0,4
8229,ASSAM,2002,4,SOCIETAL ISSUES,0,11,7,6,2,26,0,9,5,5,1,20,0,0,0,0,0,0,46
82,ASSAM,2003,4,CAUSES NOT KNOWN,42,222,180,95,22,561,24,105,65,27,16,237,0,0,0,0,0,0,798
628,ASSAM,2003,4,DEATH OF DEAR PERSON,0,0,3,1,0,4,0,4,1,1,0,6,0,0,0,0,0,0,10
1174,ASSAM,2003,4,DOWRY DISPUTE,0,0,1,7,0,8,0,12,7,1,1,21,0,0,0,0,0,0,29
1720,ASSAM,2003,4,DRUG ABUSE,0,0,2,1,2,5,0,0,0,1,0,1,0,0,0,0,0,0,6
2266,ASSAM,2003,4,ECONOMIC ISSUES,0,91,136,81,6,314,0,55,28,18,1,102,0,0,0,0,0,0,416
2812,ASSAM,2003,4,EXAM FAILURE,4,40,7,0,0,51,6,25,2,0,0,33,0,0,0,0,0,0,84
3358,ASSAM,2003,4,FAMILY PROBLEMS,3,48,61,45,6,163,0,58,29,15,2,104,0,0,0,0,0,0,267
3904,ASSAM,2003,4,HEALTH ISSUES,1,5,24,31,12,73,0,2,9,7,4,22,0,0,0,0,0,0,95
4450,ASSAM,2003,4,HERO WORSHIP,0,0,0,0,0,0,0,0,0,0,0,0,0,0,0,0,0,0,0
4995,ASSAM,2003,4,ILLEGITIMATE PREGNANCY,0,0,0,0,0,0,0,15,4,0,0,19,0,0,0,0,0,0,19
5540,ASSAM,2003,4,LOVE AFFAIRS,1,151,43,8,0,203,3,139,23,2,0,167,0,0,0,0,0,0,370
6085,ASSAM,2003,4,MARITAL ISSUES,0,5,8,13,0,26,0,14,23,8,0,45,0,0,0,0,0,0,71
6631,ASSAM,2003,4,MENTAL HEALTH,1,14,13,11,3,42,2,11,3,5,1,22,0,0,0,0,0,0,64
7177,ASSAM,2003,4,OTHERS,7,89,70,22,12,200,10,65,29,16,9,129,0,0,0,0,0,0,329
7762,ASSAM,2003,4,"PHYSICAL ABUSE (RAPE,INCEST ETC.)",0,0,0,0,0,0,0,0,0,0,0,0,0,0,0,0,0,0,0
8268,ASSAM,2003,4,SOCIETAL ISSUES,2,6,9,8,1,26,3,7,2,0,0,12,0,0,0,0,0,0,38
121,ASSAM,2004,4,CAUSES NOT KNOWN,21,182,206,109,17,535,10,91,79,44,6,230,0,0,0,0,0,0,765
667,ASSAM,2004,4,DEATH OF DEAR PERSON,0,2,3,0,1,6,0,4,2,0,1,7,0,0,0,0,0,0,13
1213,ASSAM,2004,4,DOWRY DISPUTE,0,0,0,0,0,0,0,14,10,1,0,25,0,0,0,0,0,0,25
1759,ASSAM,2004,4,DRUG ABUSE,0,0,0,0,0,0,0,0,0,0,0,0,0,0,0,0,0,0,0
2305,ASSAM,2004,4,ECONOMIC ISSUES,0,140,231,158,21,550,0,54,51,39,1,145,0,0,0,0,0,0,695
2851,ASSAM,2004,4,EXAM FAILURE,8,46,0,0,0,54,4,48,0,0,0,52,0,0,0,0,0,0,106
3397,ASSAM,2004,4,FAMILY PROBLEMS,1,56,99,48,1,205,1,31,38,14,1,85,0,0,0,0,0,0,290
3943,ASSAM,2004,4,HEALTH ISSUES,0,24,43,36,17,120,0,4,25,10,3,42,0,0,0,0,0,0,162
4489,ASSAM,2004,4,HERO WORSHIP,0,0,0,0,0,0,0,0,0,0,0,0,0,0,0,0,0,0,0
5034,ASSAM,2004,4,ILLEGITIMATE PREGNANCY,0,0,0,0,0,0,0,6,6,0,0,12,0,0,0,0,0,0,12
5579,ASSAM,2004,4,LOVE AFFAIRS,1,169,116,2,0,288,0,118,37,1,0,156,0,0,0,0,0,0,444
6124,ASSAM,2004,4,MARITAL ISSUES,0,7,3,0,0,10,0,19,14,2,0,35,0,0,0,0,0,0,45
6670,ASSAM,2004,4,MENTAL HEALTH,0,6,5,7,3,21,0,4,2,3,0,9,0,0,0,0,0,0,30
7216,ASSAM,2004,4,OTHERS,10,52,56,16,12,146,3,52,32,6,2,95,0,0,0,0,0,0,241
7801,ASSAM,2004,4,"PHYSICAL ABUSE (RAPE,INCEST ETC.)",0,0,0,0,0,0,0,1,0,0,0,1,0,0,0,0,0,0,1
8307,ASSAM,2004,4,SOCIETAL ISSUES,0,7,2,1,0,10,0,0,0,0,0,0,0,0,0,0,0,0,10
160,ASSAM,2005,4,CAUSES NOT KNOWN,11,209,228,119,23,590,11,82,62,40,5,200,0,0,0,0,0,0,790
706,ASSAM,2005,4,DEATH OF DEAR PERSON,0,1,8,1,0,10,0,3,1,1,0,5,0,0,0,0,0,0,15
1252,ASSAM,2005,4,DOWRY DISPUTE,0,0,0,0,0,0,0,0,1,0,0,1,0,0,0,0,0,0,1
1798,ASSAM,2005,4,DRUG ABUSE,0,2,1,0,0,3,0,4,2,0,0,6,0,0,0,0,0,0,9
2344,ASSAM,2005,4,ECONOMIC ISSUES,0,90,166,135,13,404,0,25,53,20,3,101,0,0,0,0,0,0,505
2890,ASSAM,2005,4,EXAM FAILURE,17,31,1,0,0,49,9,40,0,0,0,49,0,0,0,0,0,0,98
3436,ASSAM,2005,4,FAMILY PROBLEMS,0,33,83,43,4,163,1,58,33,20,1,113,0,0,0,0,0,0,276
3982,ASSAM,2005,4,HEALTH ISSUES,0,39,92,53,15,199,0,7,34,9,9,59,0,0,0,0,0,0,258
4528,ASSAM,2005,4,HERO WORSHIP,0,1,0,0,0,1,0,4,2,0,0,6,0,0,0,0,0,0,7
5073,ASSAM,2005,4,ILLEGITIMATE PREGNANCY,0,0,0,0,0,0,0,5,5,0,0,10,0,0,0,0,0,0,10
5618,ASSAM,2005,4,LOVE AFFAIRS,1,141,97,7,0,246,3,108,50,4,0,165,0,0,0,0,0,0,411
6163,ASSAM,2005,4,MARITAL ISSUES,0,29,21,6,0,56,3,50,35,6,0,94,0,0,0,0,0,0,150
6709,ASSAM,2005,4,MENTAL HEALTH,0,9,7,2,2,20,2,2,4,1,0,9,0,0,0,0,0,0,29
7255,ASSAM,2005,4,OTHERS,7,55,58,31,16,167,6,32,15,11,0,64,0,0,0,0,0,0,231
7840,ASSAM,2005,4,"PHYSICAL ABUSE (RAPE,INCEST ETC.)",0,0,6,2,0,8,0,1,0,4,0,5,0,0,0,0,0,0,13
8346,ASSAM,2005,4,SOCIETAL ISSUES,0,3,23,9,0,35,2,4,2,0,0,8,0,0,0,0,0,0,43
199,ASSAM,2006,4,CAUSES NOT KNOWN,21,208,251,141,28,649,15,96,104,43,8,266,0,0,0,0,0,0,915
745,ASSAM,2006,4,DEATH OF DEAR PERSON,0,1,4,2,0,7,0,3,4,1,0,8,0,0,0,0,0,0,15
1291,ASSAM,2006,4,DOWRY DISPUTE,0,0,0,0,0,0,0,0,0,0,0,0,0,0,0,0,0,0,0
1837,ASSAM,2006,4,DRUG ABUSE,0,0,0,0,0,0,0,0,0,0,0,0,0,0,0,0,0,0,0
2383,ASSAM,2006,4,ECONOMIC ISSUES,0,121,178,72,8,379,0,27,61,15,0,103,0,0,0,0,0,0,482
2929,ASSAM,2006,4,EXAM FAILURE,16,56,1,0,0,73,10,46,1,0,0,57,0,0,0,0,0,0,130
3475,ASSAM,2006,4,FAMILY PROBLEMS,0,108,147,74,12,341,3,67,67,11,2,150,0,0,0,0,0,0,491
4021,ASSAM,2006,4,HEALTH ISSUES,2,29,65,55,22,173,1,15,29,18,4,67,0,0,0,0,0,0,240
4567,ASSAM,2006,4,HERO WORSHIP,0,0,0,0,0,0,0,0,0,0,0,0,0,0,0,0,0,0,0
5112,ASSAM,2006,4,ILLEGITIMATE PREGNANCY,0,0,0,0,0,0,0,12,5,0,0,17,0,0,0,0,0,0,17
5657,ASSAM,2006,4,LOVE AFFAIRS,0,168,134,6,0,308,2,109,33,2,0,146,0,0,0,0,0,0,454
6202,ASSAM,2006,4,MARITAL ISSUES,0,12,15,2,0,29,0,16,14,4,0,34,0,0,0,0,0,0,63
6748,ASSAM,2006,4,MENTAL HEALTH,0,5,7,12,4,28,0,1,3,2,0,6,0,0,0,0,0,0,34
7294,ASSAM,2006,4,OTHERS,5,45,47,21,7,125,1,21,26,11,1,60,0,0,0,0,0,0,185
7879,ASSAM,2006,4,"PHYSICAL ABUSE (RAPE,INCEST ETC.)",0,0,1,0,0,1,0,0,1,0,0,1,0,0,0,0,0,0,2
8385,ASSAM,2006,4,SOCIETAL ISSUES,0,0,3,0,0,3,0,0,0,0,0,0,0,0,0,0,0,0,3
238,ASSAM,2007,4,CAUSES NOT KNOWN,18,244,257,193,32,744,23,101,101,62,17,304,0,0,0,0,0,0,1048
784,ASSAM,2007,4,DEATH OF DEAR PERSON,0,2,1,2,0,5,0,4,0,2,1,7,0,0,0,0,0,0,12
1330,ASSAM,2007,4,DOWRY DISPUTE,0,0,0,0,0,0,0,3,4,0,0,7,0,0,0,0,0,0,7
1876,ASSAM,2007,4,DRUG ABUSE,0,1,0,0,0,1,0,0,0,0,0,0,0,0,0,0,0,0,1
2422,ASSAM,2007,4,ECONOMIC ISSUES,0,78,124,109,11,322,0,33,43,20,0,96,0,0,0,0,0,0,418
2968,ASSAM,2007,4,EXAM FAILURE,13,39,2,0,0,54,6,39,0,0,0,45,0,0,0,0,0,0,99
3514,ASSAM,2007,4,FAMILY PROBLEMS,1,75,95,69,4,244,1,45,55,8,3,112,0,0,0,0,0,0,356
4060,ASSAM,2007,4,HEALTH ISSUES,1,63,77,51,4,196,1,26,27,10,6,70,0,0,0,0,0,0,266
4605,ASSAM,2007,4,HERO WORSHIP,0,0,0,0,0,0,0,0,0,0,0,0,0,0,0,0,0,0,0
5150,ASSAM,2007,4,ILLEGITIMATE PREGNANCY,0,0,0,0,0,0,0,8,2,0,0,10,0,0,0,0,0,0,10
5695,ASSAM,2007,4,LOVE AFFAIRS,0,116,133,15,0,264,0,112,49,4,0,165,0,0,0,0,0,0,429
6241,ASSAM,2007,4,MARITAL ISSUES,0,5,5,3,1,14,0,22,18,7,2,49,0,0,0,0,0,0,63
6787,ASSAM,2007,4,MENTAL HEALTH,0,5,14,6,1,26,0,2,9,4,1,16,0,0,0,0,0,0,42
7333,ASSAM,2007,4,OTHERS,3,62,75,37,15,192,2,28,18,3,5,56,0,0,0,0,0,0,248
7917,ASSAM,2007,4,"PHYSICAL ABUSE (RAPE,INCEST ETC.)",0,5,11,22,0,38,0,0,5,0,0,5,0,0,0,0,0,0,43
8424,ASSAM,2007,4,SOCIETAL ISSUES,2,9,5,0,0,16,0,4,0,0,0,4,0,0,0,0,0,0,20
277,ASSAM,2008,4,CAUSES NOT KNOWN,13,247,255,101,21,637,9,113,79,38,12,251,0,0,0,0,0,0,888
823,ASSAM,2008,4,DEATH OF DEAR PERSON,0,20,23,5,0,48,0,4,12,0,0,16,0,0,0,0,0,0,64
1369,ASSAM,2008,4,DOWRY DISPUTE,0,0,0,0,0,0,0,6,2,0,0,8,0,0,0,0,0,0,8
1915,ASSAM,2008,4,DRUG ABUSE,0,6,4,3,2,15,0,0,1,1,0,2,0,0,0,0,0,0,17
2461,ASSAM,2008,4,ECONOMIC ISSUES,0,81,150,95,1,327,0,54,60,22,0,136,0,0,0,0,0,0,463
3007,ASSAM,2008,4,EXAM FAILURE,5,57,4,0,0,66,5,48,0,0,0,53,0,0,0,0,0,0,119
3553,ASSAM,2008,4,FAMILY PROBLEMS,2,84,84,56,11,237,2,62,98,18,0,180,0,0,0,0,0,0,417
4099,ASSAM,2008,4,HEALTH ISSUES,0,9,43,65,16,133,0,20,30,17,2,69,0,0,0,0,0,0,202
4644,ASSAM,2008,4,HERO WORSHIP,0,2,0,0,0,2,0,0,0,0,0,0,0,0,0,0,0,0,2
5189,ASSAM,2008,4,ILLEGITIMATE PREGNANCY,0,0,0,0,0,0,0,19,5,0,0,24,0,0,0,0,0,0,24
5734,ASSAM,2008,4,LOVE AFFAIRS,3,113,116,7,0,239,1,120,36,0,0,157,0,0,0,0,0,0,396
6280,ASSAM,2008,4,MARITAL ISSUES,0,5,10,0,0,15,0,13,11,7,0,31,0,0,0,0,0,0,46
6826,ASSAM,2008,4,MENTAL HEALTH,0,5,8,10,1,24,0,4,2,7,0,13,0,0,0,0,0,0,37
7372,ASSAM,2008,4,OTHERS,5,82,68,43,4,202,0,40,23,7,5,75,0,0,0,0,0,0,277
7956,ASSAM,2008,4,"PHYSICAL ABUSE (RAPE,INCEST ETC.)",0,0,1,8,0,9,0,0,1,3,0,4,0,0,0,0,0,0,13
8463,ASSAM,2008,4,SOCIETAL ISSUES,0,5,6,5,0,16,0,0,0,0,0,0,0,0,0,0,0,0,16
316,ASSAM,2009,4,CAUSES NOT KNOWN,16,167,174,113,26,496,13,86,86,80,15,280,0,0,0,0,0,0,776
862,ASSAM,2009,4,DEATH OF DEAR PERSON,0,3,10,0,0,13,0,3,7,0,0,10,0,0,0,0,0,0,23
1408,ASSAM,2009,4,DOWRY DISPUTE,0,0,0,1,0,1,0,11,8,1,0,20,0,0,0,0,0,0,21
1954,ASSAM,2009,4,DRUG ABUSE,0,19,4,3,0,26,0,14,8,0,2,24,0,0,0,0,0,0,50
2500,ASSAM,2009,4,ECONOMIC ISSUES,0,76,170,121,2,369,0,38,49,29,0,116,0,0,0,0,0,0,485
3046,ASSAM,2009,4,EXAM FAILURE,7,64,6,3,0,80,1,42,3,3,0,49,0,0,0,0,0,0,129
3592,ASSAM,2009,4,FAMILY PROBLEMS,0,103,126,68,14,311,2,76,50,25,3,156,0,0,0,0,0,0,467
4138,ASSAM,2009,4,HEALTH ISSUES,0,17,37,38,6,98,0,18,18,10,3,49,0,0,0,0,0,0,147
4683,ASSAM,2009,4,HERO WORSHIP,0,0,0,0,0,0,0,2,0,0,0,2,0,0,0,0,0,0,2
5228,ASSAM,2009,4,ILLEGITIMATE PREGNANCY,0,0,0,0,0,0,0,15,6,0,0,21,0,0,0,0,0,0,21
5773,ASSAM,2009,4,LOVE AFFAIRS,0,100,93,6,0,199,1,112,35,4,0,152,0,0,0,0,0,0,351
6319,ASSAM,2009,4,MARITAL ISSUES,0,22,19,17,2,60,1,29,23,8,2,63,0,0,0,0,0,0,123
6865,ASSAM,2009,4,MENTAL HEALTH,0,6,10,5,0,21,0,0,4,4,0,8,0,0,0,0,0,0,29
7411,ASSAM,2009,4,OTHERS,4,76,57,39,11,187,6,59,35,15,1,116,0,0,0,0,0,0,303
7995,ASSAM,2009,4,"PHYSICAL ABUSE (RAPE,INCEST ETC.)",0,2,2,4,0,8,0,3,4,0,0,7,0,0,0,0,0,0,15
8502,ASSAM,2009,4,SOCIETAL ISSUES,0,0,4,7,2,13,0,6,4,1,0,11,0,0,0,0,0,0,24
355,ASSAM,2010,4,CAUSES NOT KNOWN,21,231,234,129,40,655,19,109,85,57,9,279,0,0,0,0,0,0,934
901,ASSAM,2010,4,DEATH OF DEAR PERSON,1,7,12,3,0,23,0,1,13,2,0,16,0,0,0,0,0,0,39
1447,ASSAM,2010,4,DOWRY DISPUTE,0,0,0,0,0,0,0,10,7,0,0,17,0,0,0,0,0,0,17
1993,ASSAM,2010,4,DRUG ABUSE,0,3,0,3,1,7,1,5,3,0,2,11,0,0,0,0,0,0,18
2539,ASSAM,2010,4,ECONOMIC ISSUES,0,84,143,117,2,346,0,32,46,13,0,91,0,0,0,0,0,0,437
3085,ASSAM,2010,4,EXAM FAILURE,9,74,8,0,0,91,1,50,0,0,0,51,0,0,0,0,0,0,142
3631,ASSAM,2010,4,FAMILY PROBLEMS,2,114,123,92,5,336,2,65,36,13,1,117,0,0,0,0,0,0,453
4177,ASSAM,2010,4,HEALTH ISSUES,1,41,75,59,16,192,1,27,32,31,7,98,0,0,0,0,0,0,290
4722,ASSAM,2010,4,HERO WORSHIP,0,0,0,0,0,0,0,0,0,0,0,0,0,0,0,0,0,0,0
5267,ASSAM,2010,4,ILLEGITIMATE PREGNANCY,0,0,0,0,0,0,0,13,2,0,0,15,0,0,0,0,0,0,15
5812,ASSAM,2010,4,LOVE AFFAIRS,0,128,86,5,0,219,4,123,42,0,0,169,0,0,0,0,0,0,388
6358,ASSAM,2010,4,MARITAL ISSUES,0,8,6,0,0,14,0,27,16,0,0,43,0,0,0,0,0,0,57
6904,ASSAM,2010,4,MENTAL HEALTH,0,12,10,10,0,32,0,1,3,4,0,8,0,0,0,0,0,0,40
7450,ASSAM,2010,4,OTHERS,0,42,36,19,6,103,3,22,14,2,3,44,0,0,0,0,0,0,147
8034,ASSAM,2010,4,"PHYSICAL ABUSE (RAPE,INCEST ETC.)",0,0,0,0,0,0,0,2,2,0,0,4,0,0,0,0,0,0,4
8541,ASSAM,2010,4,SOCIETAL ISSUES,0,1,2,5,0,8,1,2,1,0,0,4,0,0,0,0,0,0,12
394,ASSAM,2011,4,CAUSES NOT KNOWN,16,135,190,124,17,482,3,75,109,50,4,241,0,0,0,0,0,0,723
940,ASSAM,2011,4,DEATH OF DEAR PERSON,0,8,16,10,0,34,0,4,2,1,0,7,0,0,0,0,0,0,41
1486,ASSAM,2011,4,DOWRY DISPUTE,0,0,0,0,0,0,0,4,5,0,0,9,0,0,0,0,0,0,9
2032,ASSAM,2011,4,DRUG ABUSE,0,3,3,2,0,8,0,2,3,2,0,7,0,0,0,0,0,0,15
2578,ASSAM,2011,4,ECONOMIC ISSUES,1,114,140,107,10,372,0,51,78,30,0,159,0,0,0,0,0,0,531
3124,ASSAM,2011,4,EXAM FAILURE,1,104,1,2,0,108,0,61,1,2,0,64,0,0,0,0,0,0,172
3670,ASSAM,2011,4,FAMILY PROBLEMS,1,53,120,64,3,241,2,52,29,17,0,100,0,0,0,0,0,0,341
4216,ASSAM,2011,4,HEALTH ISSUES,0,27,61,49,7,144,1,19,33,6,5,64,0,0,0,0,0,0,208
4761,ASSAM,2011,4,HERO WORSHIP,0,0,2,2,0,4,0,0,0,0,0,0,0,0,0,0,0,0,4
5306,ASSAM,2011,4,ILLEGITIMATE PREGNANCY,0,0,0,0,0,0,0,8,3,1,0,12,0,0,0,0,0,0,12
5851,ASSAM,2011,4,LOVE AFFAIRS,0,170,100,0,0,270,1,100,30,0,0,131,0,0,0,0,0,0,401
6397,ASSAM,2011,4,MARITAL ISSUES,0,7,8,3,1,19,0,10,21,3,1,35,0,0,0,0,0,0,54
6943,ASSAM,2011,4,MENTAL HEALTH,0,13,15,18,1,47,0,4,7,6,0,17,0,0,0,0,0,0,64
7489,ASSAM,2011,4,OTHERS,1,29,26,27,6,89,3,14,11,3,3,34,0,0,0,0,0,0,123
8073,ASSAM,2011,4,"PHYSICAL ABUSE (RAPE,INCEST ETC.)",0,0,0,0,0,0,0,0,2,2,0,4,0,0,0,0,0,0,4
8580,ASSAM,2011,4,SOCIETAL ISSUES,0,4,4,0,0,8,0,6,7,3,0,16,0,0,0,0,0,0,24
433,ASSAM,2012,4,CAUSES NOT KNOWN,30,187,280,179,30,706,14,99,102,74,7,296,0,0,0,0,0,0,1002
979,ASSAM,2012,4,DEATH OF DEAR PERSON,0,7,4,2,1,14,0,4,3,1,0,8,0,0,0,0,0,0,22
1525,ASSAM,2012,4,DOWRY DISPUTE,0,0,0,0,0,0,0,1,0,0,0,1,0,0,0,0,0,0,1
2071,ASSAM,2012,4,DRUG ABUSE,0,0,6,6,0,12,0,1,2,1,0,4,0,0,0,0,0,0,16
2617,ASSAM,2012,4,ECONOMIC ISSUES,0,98,153,164,9,424,0,7,48,29,0,84,0,0,0,0,0,0,508
3163,ASSAM,2012,4,EXAM FAILURE,0,80,2,3,0,85,0,62,2,0,0,64,0,0,0,0,0,0,149
3709,ASSAM,2012,4,FAMILY PROBLEMS,2,78,131,75,2,288,0,28,48,15,0,91,0,0,0,0,0,0,379
4255,ASSAM,2012,4,HEALTH ISSUES,3,42,101,118,6,270,0,16,46,33,1,96,0,0,0,0,0,0,366
4800,ASSAM,2012,4,HERO WORSHIP,0,0,2,2,0,4,0,0,0,0,0,0,0,0,0,0,0,0,4
5345,ASSAM,2012,4,ILLEGITIMATE PREGNANCY,0,0,0,0,0,0,0,9,2,0,0,11,0,0,0,0,0,0,11
5890,ASSAM,2012,4,LOVE AFFAIRS,0,160,166,4,0,330,1,111,50,2,0,164,0,0,0,0,0,0,494
6436,ASSAM,2012,4,MARITAL ISSUES,1,1,10,7,1,20,1,12,10,2,1,26,0,0,0,0,0,0,46
6982,ASSAM,2012,4,MENTAL HEALTH,1,7,16,10,0,34,0,3,1,0,0,4,0,0,0,0,0,0,38
7528,ASSAM,2012,4,OTHERS,0,18,74,37,1,130,0,7,7,4,0,18,0,0,0,0,0,0,148
8112,ASSAM,2012,4,"PHYSICAL ABUSE (RAPE,INCEST ETC.)",0,0,0,0,0,0,0,2,0,0,0,2,0,0,0,0,0,0,2
8619,ASSAM,2012,4,SOCIETAL ISSUES,0,17,38,20,0,75,0,0,1,2,0,3,0,0,0,0,0,0,78
472,ASSAM,2013,4,CAUSES NOT KNOWN,8,242,376,147,15,788,2,72,171,90,12,347,0,0,0,0,0,0,1135
1018,ASSAM,2013,4,DEATH OF DEAR PERSON,0,6,14,8,0,28,0,3,0,0,0,3,0,0,0,0,0,0,31
1564,ASSAM,2013,4,DOWRY DISPUTE,0,0,0,0,0,0,0,0,2,0,0,2,0,0,0,0,0,0,2
2110,ASSAM,2013,4,DRUG ABUSE,0,2,2,2,0,6,0,0,0,0,0,0,0,0,0,0,0,0,6
2656,ASSAM,2013,4,ECONOMIC ISSUES,1,58,185,198,5,447,0,13,44,31,0,88,0,0,0,0,0,0,535
3202,ASSAM,2013,4,EXAM FAILURE,0,98,9,6,0,113,1,48,5,0,0,54,0,0,0,0,0,0,167
3748,ASSAM,2013,4,FAMILY PROBLEMS,0,79,125,73,1,278,0,35,49,19,0,103,0,0,0,0,0,0,381
4294,ASSAM,2013,4,HEALTH ISSUES,1,45,104,87,5,242,0,12,27,22,0,61,0,0,0,0,0,0,303
4839,ASSAM,2013,4,HERO WORSHIP,0,2,0,3,0,5,0,0,0,0,0,0,0,0,0,0,0,0,5
5384,ASSAM,2013,4,ILLEGITIMATE PREGNANCY,0,0,0,0,0,0,0,5,4,0,0,9,0,0,0,0,0,0,9
5929,ASSAM,2013,4,LOVE AFFAIRS,0,230,188,17,0,435,1,157,57,0,0,215,0,0,0,0,0,0,650
6475,ASSAM,2013,4,MARITAL ISSUES,0,7,8,1,0,16,0,10,8,3,0,21,0,0,0,0,0,0,37
7021,ASSAM,2013,4,MENTAL HEALTH,0,11,8,6,0,25,0,2,1,1,1,5,0,0,0,0,0,0,30
7567,ASSAM,2013,4,OTHERS,1,28,41,43,3,116,3,38,20,13,0,74,0,0,0,0,0,0,190
8151,ASSAM,2013,4,"PHYSICAL ABUSE (RAPE,INCEST ETC.)",0,0,0,0,0,0,0,0,2,0,0,2,0,0,0,0,0,0,2
8658,ASSAM,2013,4,SOCIETAL ISSUES,0,15,30,13,1,59,0,4,3,4,0,11,0,0,0,0,0,0,70
511,ASSAM,2014,4,CAUSES NOT KNOWN,4,206,250,155,24,639,0,137,107,69,6,319,0,0,0,0,0,0,958
1057,ASSAM,2014,4,DEATH OF DEAR PERSON,0,15,14,12,0,41,0,0,0,0,0,0,0,0,0,0,0,0,41
1603,ASSAM,2014,4,DOWRY DISPUTE,0,0,0,0,0,0,0,8,1,0,0,9,0,0,0,0,0,0,9
2149,ASSAM,2014,4,DRUG ABUSE,0,0,0,1,0,1,0,0,0,0,0,0,0,0,0,0,0,0,1
2695,ASSAM,2014,4,ECONOMIC ISSUES,0,97,137,102,5,341,0,24,36,0,0,60,0,0,0,0,0,0,401
3241,ASSAM,2014,4,EXAM FAILURE,0,149,2,0,0,151,0,103,0,0,0,103,0,0,0,0,0,0,254
3787,ASSAM,2014,4,FAMILY PROBLEMS,1,75,90,49,0,215,0,60,34,15,2,111,0,0,0,0,0,0,326
4333,ASSAM,2014,4,HEALTH ISSUES,0,68,84,67,15,234,0,16,24,5,0,45,0,0,0,0,0,0,279
4878,ASSAM,2014,4,HERO WORSHIP,0,0,0,0,0,0,0,0,0,0,0,0,0,0,0,0,0,0,0
5423,ASSAM,2014,4,ILLEGITIMATE PREGNANCY,0,0,0,0,0,0,0,0,0,0,0,0,0,0,0,0,0,0,0
5968,ASSAM,2014,4,LOVE AFFAIRS,0,209,113,12,1,335,1,126,57,0,0,184,0,0,0,0,0,0,519
6514,ASSAM,2014,4,MARITAL ISSUES,0,17,13,4,0,34,0,40,10,1,0,51,0,0,0,0,0,0,85
7060,ASSAM,2014,4,MENTAL HEALTH,0,2,2,5,1,10,0,0,0,1,0,1,0,0,0,0,0,0,11
7606,ASSAM,2014,4,OTHERS,2,221,257,136,18,634,1,112,62,27,2,204,0,0,0,0,0,0,838
7645,ASSAM,2014,4,PHYSICAL ABUSE,0,0,0,0,0,0,0,0,0,0,0,0,0,0,0,0,0,0,0
8697,ASSAM,2014,4,SOCIETAL ISSUES,0,6,6,7,3,22,2,2,1,0,0,5,0,0,0,0,0,0,27
5,BIHAR,2001,5,CAUSES NOT KNOWN,1,11,9,5,2,28,2,15,10,5,2,34,0,0,0,0,0,0,62
551,BIHAR,2001,5,DEATH OF DEAR PERSON,0,0,0,0,0,0,0,5,5,0,0,10,0,0,0,0,0,0,10
1097,BIHAR,2001,5,DOWRY DISPUTE,0,0,1,0,0,1,0,9,6,1,0,16,0,0,0,0,0,0,17
1643,BIHAR,2001,5,DRUG ABUSE,0,2,1,0,2,5,0,0,1,1,0,2,0,0,0,0,0,0,7
2189,BIHAR,2001,5,ECONOMIC ISSUES,0,0,3,0,1,4,0,0,0,0,0,0,0,0,0,0,0,0,4
2735,BIHAR,2001,5,EXAM FAILURE,1,11,5,1,0,18,1,4,1,1,0,7,0,0,0,0,0,0,25
3281,BIHAR,2001,5,FAMILY PROBLEMS,2,52,44,10,7,115,5,64,22,14,3,108,0,0,0,0,0,0,223
3827,BIHAR,2001,5,HEALTH ISSUES,0,7,3,5,1,16,0,1,1,1,0,3,0,0,0,0,0,0,19
4373,BIHAR,2001,5,HERO WORSHIP,0,0,0,0,0,0,0,9,2,0,0,11,0,0,0,0,0,0,11
4918,BIHAR,2001,5,ILLEGITIMATE PREGNANCY,0,4,2,0,0,6,1,1,2,0,0,4,0,0,0,0,0,0,10
5463,BIHAR,2001,5,LOVE AFFAIRS,1,9,1,0,0,11,1,11,3,0,0,15,0,0,0,0,0,0,26
6008,BIHAR,2001,5,MARITAL ISSUES,0,6,5,0,1,12,0,7,4,0,0,11,0,0,0,0,0,0,23
6554,BIHAR,2001,5,MENTAL HEALTH,0,2,4,0,1,7,0,2,2,1,0,5,0,0,0,0,0,0,12
7100,BIHAR,2001,5,OTHERS,3,22,40,9,1,75,4,25,35,3,3,70,0,0,0,0,0,0,145
7685,BIHAR,2001,5,"PHYSICAL ABUSE (RAPE,INCEST ETC.)",0,0,0,0,0,0,0,0,0,0,0,0,0,0,0,0,0,0,0
8191,BIHAR,2001,5,SOCIETAL ISSUES,0,5,3,1,0,9,0,0,0,0,0,0,0,0,0,0,0,0,9
44,BIHAR,2002,5,CAUSES NOT KNOWN,2,12,23,15,2,54,1,15,8,2,2,28,0,0,0,0,0,0,82
590,BIHAR,2002,5,DEATH OF DEAR PERSON,0,0,0,1,0,1,1,0,1,1,2,5,0,0,0,0,0,0,6
1136,BIHAR,2002,5,DOWRY DISPUTE,0,1,0,0,0,1,0,14,7,0,0,21,0,0,0,0,0,0,22
1682,BIHAR,2002,5,DRUG ABUSE,1,4,5,2,0,12,2,3,0,1,0,6,0,0,0,0,0,0,18
2228,BIHAR,2002,5,ECONOMIC ISSUES,0,4,12,1,1,18,0,2,1,0,0,3,0,0,0,0,0,0,21
2774,BIHAR,2002,5,EXAM FAILURE,1,2,0,0,0,3,0,1,0,0,0,1,0,0,0,0,0,0,4
3320,BIHAR,2002,5,FAMILY PROBLEMS,8,35,57,15,5,120,3,55,35,20,1,114,0,0,0,0,0,0,234
3866,BIHAR,2002,5,HEALTH ISSUES,0,11,8,9,3,31,0,3,4,3,0,10,0,0,0,0,0,0,41
4412,BIHAR,2002,5,HERO WORSHIP,0,0,0,0,0,0,0,0,0,0,0,0,0,0,0,0,0,0,0
4957,BIHAR,2002,5,ILLEGITIMATE PREGNANCY,0,0,0,0,0,0,0,0,0,0,0,0,0,0,0,0,0,0,0
5502,BIHAR,2002,5,LOVE AFFAIRS,0,10,5,0,0,15,1,8,2,1,0,12,0,0,0,0,0,0,27
6047,BIHAR,2002,5,MARITAL ISSUES,0,2,4,1,0,7,0,13,9,2,0,24,0,0,0,0,0,0,31
6593,BIHAR,2002,5,MENTAL HEALTH,0,3,3,2,1,9,0,0,2,1,0,3,0,0,0,0,0,0,12
7139,BIHAR,2002,5,OTHERS,11,70,43,20,4,148,5,30,25,3,0,63,0,0,0,0,0,0,211
7724,BIHAR,2002,5,"PHYSICAL ABUSE (RAPE,INCEST ETC.)",0,0,0,0,0,0,0,0,0,0,0,0,0,0,0,0,0,0,0
8230,BIHAR,2002,5,SOCIETAL ISSUES,0,3,2,2,0,7,0,1,2,1,0,4,0,0,0,0,0,0,11
83,BIHAR,2003,5,CAUSES NOT KNOWN,17,21,28,21,0,87,4,21,16,2,1,44,0,0,0,0,0,0,131
629,BIHAR,2003,5,DEATH OF DEAR PERSON,0,0,1,0,0,1,2,9,5,0,0,16,0,0,0,0,0,0,17
1175,BIHAR,2003,5,DOWRY DISPUTE,0,0,1,0,0,1,0,17,12,0,0,29,0,0,0,0,0,0,30
1721,BIHAR,2003,5,DRUG ABUSE,0,1,2,1,1,5,0,0,0,0,0,0,0,0,0,0,0,0,5
2267,BIHAR,2003,5,ECONOMIC ISSUES,0,1,6,2,0,9,0,3,2,0,0,5,0,0,0,0,0,0,14
2813,BIHAR,2003,5,EXAM FAILURE,2,7,0,0,0,9,1,2,0,0,0,3,0,0,0,0,0,0,12
3359,BIHAR,2003,5,FAMILY PROBLEMS,4,37,33,15,8,97,4,24,19,5,0,52,0,0,0,0,0,0,149
3905,BIHAR,2003,5,HEALTH ISSUES,0,6,9,4,3,22,0,2,5,2,1,10,0,0,0,0,0,0,32
4451,BIHAR,2003,5,HERO WORSHIP,0,1,0,2,0,3,0,0,1,0,0,1,0,0,0,0,0,0,4
4996,BIHAR,2003,5,ILLEGITIMATE PREGNANCY,0,0,0,0,0,0,0,2,1,0,0,3,0,0,0,0,0,0,3
5541,BIHAR,2003,5,LOVE AFFAIRS,1,8,0,0,0,9,0,7,1,0,0,8,0,0,0,0,0,0,17
6086,BIHAR,2003,5,MARITAL ISSUES,3,2,3,0,0,8,1,5,1,0,0,7,0,0,0,0,0,0,15
6632,BIHAR,2003,5,MENTAL HEALTH,0,3,0,0,0,3,0,0,0,0,0,0,0,0,0,0,0,0,3
7178,BIHAR,2003,5,OTHERS,22,47,19,6,0,94,3,34,27,3,2,69,0,0,0,0,0,0,163
7763,BIHAR,2003,5,"PHYSICAL ABUSE (RAPE,INCEST ETC.)",0,1,1,0,0,2,0,1,0,0,0,1,0,0,0,0,0,0,3
8269,BIHAR,2003,5,SOCIETAL ISSUES,0,0,1,0,0,1,0,0,0,0,0,0,0,0,0,0,0,0,1
122,BIHAR,2004,5,CAUSES NOT KNOWN,7,17,10,3,1,38,4,10,7,0,0,21,0,0,0,0,0,0,59
668,BIHAR,2004,5,DEATH OF DEAR PERSON,1,0,1,0,0,2,0,0,0,0,0,0,0,0,0,0,0,0,2
1214,BIHAR,2004,5,DOWRY DISPUTE,0,2,0,0,0,2,0,4,3,0,0,7,0,0,0,0,0,0,9
1760,BIHAR,2004,5,DRUG ABUSE,0,1,3,0,0,4,0,1,0,0,0,1,0,0,0,0,0,0,5
2306,BIHAR,2004,5,ECONOMIC ISSUES,1,3,3,3,0,10,0,0,2,0,0,2,0,0,0,0,0,0,12
2852,BIHAR,2004,5,EXAM FAILURE,1,2,0,0,0,3,3,1,0,0,0,4,0,0,0,0,0,0,7
3398,BIHAR,2004,5,FAMILY PROBLEMS,3,26,34,11,9,83,1,21,23,8,4,57,0,0,0,0,0,0,140
3944,BIHAR,2004,5,HEALTH ISSUES,0,2,6,2,3,13,0,3,2,2,1,8,0,0,0,0,0,0,21
4490,BIHAR,2004,5,HERO WORSHIP,0,0,0,1,0,1,0,1,0,0,1,2,0,0,0,0,0,0,3
5035,BIHAR,2004,5,ILLEGITIMATE PREGNANCY,0,0,0,0,0,0,0,1,0,0,0,1,0,0,0,0,0,0,1
5580,BIHAR,2004,5,LOVE AFFAIRS,0,2,1,0,0,3,1,0,0,0,0,1,0,0,0,0,0,0,4
6125,BIHAR,2004,5,MARITAL ISSUES,0,2,5,0,0,7,0,4,3,1,0,8,0,0,0,0,0,0,15
6671,BIHAR,2004,5,MENTAL HEALTH,1,3,1,4,2,11,0,3,2,1,0,6,0,0,0,0,0,0,17
7217,BIHAR,2004,5,OTHERS,2,15,12,6,0,35,0,10,9,2,0,21,0,0,0,0,0,0,56
7802,BIHAR,2004,5,"PHYSICAL ABUSE (RAPE,INCEST ETC.)",0,0,0,0,0,0,0,0,0,0,0,0,0,0,0,0,0,0,0
8308,BIHAR,2004,5,SOCIETAL ISSUES,0,0,0,0,0,0,0,0,0,0,0,0,0,0,0,0,0,0,0
161,BIHAR,2005,5,CAUSES NOT KNOWN,0,11,6,3,3,23,0,11,6,2,1,20,0,0,0,0,0,0,43
707,BIHAR,2005,5,DEATH OF DEAR PERSON,0,0,0,0,0,0,0,0,0,1,0,1,0,0,0,0,0,0,1
1253,BIHAR,2005,5,DOWRY DISPUTE,0,0,7,0,0,7,0,10,0,0,0,10,0,0,0,0,0,0,17
1799,BIHAR,2005,5,DRUG ABUSE,0,4,3,2,0,9,0,2,1,0,0,3,0,0,0,0,0,0,12
2345,BIHAR,2005,5,ECONOMIC ISSUES,0,0,4,1,0,5,0,0,0,0,0,0,0,0,0,0,0,0,5
2891,BIHAR,2005,5,EXAM FAILURE,2,11,1,1,0,15,0,1,3,1,0,5,0,0,0,0,0,0,20
3437,BIHAR,2005,5,FAMILY PROBLEMS,1,18,32,10,3,64,1,17,16,2,0,36,0,0,0,0,0,0,100
3983,BIHAR,2005,5,HEALTH ISSUES,0,8,5,7,5,25,0,3,2,2,2,9,0,0,0,0,0,0,34
4529,BIHAR,2005,5,HERO WORSHIP,0,0,1,5,0,6,0,0,0,0,0,0,0,0,0,0,0,0,6
5074,BIHAR,2005,5,ILLEGITIMATE PREGNANCY,0,0,0,0,0,0,0,0,0,4,0,4,0,0,0,0,0,0,4
5619,BIHAR,2005,5,LOVE AFFAIRS,0,1,0,0,0,1,0,3,0,0,0,3,0,0,0,0,0,0,4
6164,BIHAR,2005,5,MARITAL ISSUES,0,12,1,0,0,13,0,13,8,2,0,23,0,0,0,0,0,0,36
6710,BIHAR,2005,5,MENTAL HEALTH,2,5,1,0,1,9,0,4,1,2,0,7,0,0,0,0,0,0,16
7256,BIHAR,2005,5,OTHERS,9,52,43,39,2,145,4,22,35,7,3,71,0,0,0,0,0,0,216
7841,BIHAR,2005,5,"PHYSICAL ABUSE (RAPE,INCEST ETC.)",0,0,0,0,0,0,0,7,1,0,0,8,0,0,0,0,0,0,8
8347,BIHAR,2005,5,SOCIETAL ISSUES,0,1,2,2,0,5,0,11,4,0,1,16,0,0,0,0,0,0,21
200,BIHAR,2006,5,CAUSES NOT KNOWN,5,18,14,6,1,44,2,17,18,5,0,42,0,0,0,0,0,0,86
746,BIHAR,2006,5,DEATH OF DEAR PERSON,0,0,0,0,1,1,0,1,0,2,0,3,0,0,0,0,0,0,4
1292,BIHAR,2006,5,DOWRY DISPUTE,0,1,0,0,0,1,0,16,12,0,0,28,0,0,0,0,0,0,29
1838,BIHAR,2006,5,DRUG ABUSE,0,5,3,1,0,9,0,0,0,0,0,0,0,0,0,0,0,0,9
2384,BIHAR,2006,5,ECONOMIC ISSUES,0,3,3,1,2,9,0,1,5,1,0,7,0,0,0,0,0,0,16
2930,BIHAR,2006,5,EXAM FAILURE,4,5,0,0,0,9,2,3,0,0,0,5,0,0,0,0,0,0,14
3476,BIHAR,2006,5,FAMILY PROBLEMS,3,27,35,11,1,77,4,32,30,10,1,77,0,0,0,0,0,0,154
4022,BIHAR,2006,5,HEALTH ISSUES,0,0,3,2,0,5,0,1,3,0,0,4,0,0,0,0,0,0,9
4568,BIHAR,2006,5,HERO WORSHIP,0,4,4,0,0,8,1,6,6,0,0,13,0,0,0,0,0,0,21
5113,BIHAR,2006,5,ILLEGITIMATE PREGNANCY,0,1,0,0,0,1,0,2,1,0,0,3,0,0,0,0,0,0,4
5658,BIHAR,2006,5,LOVE AFFAIRS,1,21,2,0,0,24,4,12,6,0,0,22,0,0,0,0,0,0,46
6203,BIHAR,2006,5,MARITAL ISSUES,0,5,3,0,1,9,0,8,13,3,0,24,0,0,0,0,0,0,33
6749,BIHAR,2006,5,MENTAL HEALTH,0,6,9,7,2,24,0,11,11,12,2,36,0,0,0,0,0,0,60
7295,BIHAR,2006,5,OTHERS,15,27,21,7,3,73,11,10,22,5,2,50,0,0,0,0,0,0,123
7880,BIHAR,2006,5,"PHYSICAL ABUSE (RAPE,INCEST ETC.)",0,0,3,0,0,3,0,3,2,0,0,5,0,0,0,0,0,0,8
8386,BIHAR,2006,5,SOCIETAL ISSUES,0,0,2,0,0,2,0,0,0,0,0,0,0,0,0,0,0,0,2
239,BIHAR,2007,5,CAUSES NOT KNOWN,3,11,12,15,6,47,7,6,2,2,5,22,0,0,0,0,0,0,69
785,BIHAR,2007,5,DEATH OF DEAR PERSON,0,0,0,1,0,1,0,0,0,0,0,0,0,0,0,0,0,0,1
1331,BIHAR,2007,5,DOWRY DISPUTE,0,7,0,0,0,7,0,10,5,4,0,19,0,0,0,0,0,0,26
1877,BIHAR,2007,5,DRUG ABUSE,1,6,13,6,1,27,1,0,2,1,0,4,0,0,0,0,0,0,31
2423,BIHAR,2007,5,ECONOMIC ISSUES,0,33,18,8,4,63,1,11,5,0,0,17,0,0,0,0,0,0,80
2969,BIHAR,2007,5,EXAM FAILURE,8,8,2,0,0,18,12,3,0,0,0,15,0,0,0,0,0,0,33
3515,BIHAR,2007,5,FAMILY PROBLEMS,5,39,40,21,3,108,5,47,34,17,7,110,0,0,0,0,0,0,218
4061,BIHAR,2007,5,HEALTH ISSUES,2,13,7,17,7,46,2,8,2,19,8,39,0,0,0,0,0,0,85
4606,BIHAR,2007,5,HERO WORSHIP,0,5,2,0,0,7,2,1,0,0,0,3,0,0,0,0,0,0,10
5151,BIHAR,2007,5,ILLEGITIMATE PREGNANCY,0,0,0,0,0,0,0,5,0,0,0,5,0,0,0,0,0,0,5
5696,BIHAR,2007,5,LOVE AFFAIRS,0,30,2,0,0,32,0,41,3,0,0,44,0,0,0,0,0,0,76
6242,BIHAR,2007,5,MARITAL ISSUES,6,11,2,7,0,26,1,16,20,0,0,37,0,0,0,0,0,0,63
6788,BIHAR,2007,5,MENTAL HEALTH,1,16,5,3,0,25,0,12,7,1,1,21,0,0,0,0,0,0,46
7334,BIHAR,2007,5,OTHERS,7,33,42,37,7,126,13,36,36,7,2,94,0,0,0,0,0,0,220
7918,BIHAR,2007,5,"PHYSICAL ABUSE (RAPE,INCEST ETC.)",0,0,0,0,0,0,0,0,0,0,0,0,0,0,0,0,0,0,0
8425,BIHAR,2007,5,SOCIETAL ISSUES,0,0,1,0,0,1,0,0,1,0,0,1,0,0,0,0,0,0,2
278,BIHAR,2008,5,CAUSES NOT KNOWN,1,41,54,29,9,134,4,29,20,11,4,68,0,0,0,0,0,0,202
824,BIHAR,2008,5,DEATH OF DEAR PERSON,0,1,0,0,4,5,0,0,0,1,0,1,0,0,0,0,0,0,6
1370,BIHAR,2008,5,DOWRY DISPUTE,0,0,0,0,0,0,0,14,10,2,0,26,0,0,0,0,0,0,26
1916,BIHAR,2008,5,DRUG ABUSE,0,5,8,5,2,20,0,2,1,0,0,3,0,0,0,0,0,0,23
2462,BIHAR,2008,5,ECONOMIC ISSUES,2,11,13,8,4,38,1,3,7,0,2,13,0,0,0,0,0,0,51
3008,BIHAR,2008,5,EXAM FAILURE,1,11,0,0,0,12,1,10,0,0,0,11,0,0,0,0,0,0,23
3554,BIHAR,2008,5,FAMILY PROBLEMS,2,33,29,15,2,81,4,27,34,5,1,71,0,0,0,0,0,0,152
4100,BIHAR,2008,5,HEALTH ISSUES,8,12,12,3,20,55,5,4,5,4,10,28,0,0,0,0,0,0,83
4645,BIHAR,2008,5,HERO WORSHIP,0,0,0,0,0,0,0,0,0,0,0,0,0,0,0,0,0,0,0
5190,BIHAR,2008,5,ILLEGITIMATE PREGNANCY,0,0,0,0,0,0,0,1,0,0,0,1,0,0,0,0,0,0,1
5735,BIHAR,2008,5,LOVE AFFAIRS,0,17,3,0,0,20,3,22,3,0,0,28,0,0,0,0,0,0,48
6281,BIHAR,2008,5,MARITAL ISSUES,3,5,4,0,0,12,0,7,4,0,0,11,0,0,0,0,0,0,23
6827,BIHAR,2008,5,MENTAL HEALTH,0,6,4,2,1,13,3,0,0,1,0,4,0,0,0,0,0,0,17
7373,BIHAR,2008,5,OTHERS,18,73,74,35,15,215,12,46,61,16,6,141,0,0,0,0,0,0,356
7957,BIHAR,2008,5,"PHYSICAL ABUSE (RAPE,INCEST ETC.)",0,3,1,0,0,4,0,0,0,0,0,0,0,0,0,0,0,0,4
8464,BIHAR,2008,5,SOCIETAL ISSUES,0,0,0,0,0,0,0,0,0,0,0,0,0,0,0,0,0,0,0
317,BIHAR,2009,5,CAUSES NOT KNOWN,1,31,35,16,5,88,3,23,37,13,0,76,0,0,0,0,0,0,164
863,BIHAR,2009,5,DEATH OF DEAR PERSON,0,0,1,0,0,1,0,1,0,0,0,1,0,0,0,0,0,0,2
1409,BIHAR,2009,5,DOWRY DISPUTE,0,13,3,0,0,16,0,46,73,0,0,119,0,0,0,0,0,0,135
1955,BIHAR,2009,5,DRUG ABUSE,0,9,6,7,0,22,0,0,1,0,0,1,0,0,0,0,0,0,23
2501,BIHAR,2009,5,ECONOMIC ISSUES,1,2,5,1,0,9,2,0,1,0,0,3,0,0,0,0,0,0,12
3047,BIHAR,2009,5,EXAM FAILURE,4,11,2,0,0,17,1,9,1,0,0,11,0,0,0,0,0,0,28
3593,BIHAR,2009,5,FAMILY PROBLEMS,1,21,28,12,1,63,1,23,25,3,0,52,0,0,0,0,0,0,115
4139,BIHAR,2009,5,HEALTH ISSUES,2,8,11,4,9,34,0,7,5,3,0,15,0,0,0,0,0,0,49
4684,BIHAR,2009,5,HERO WORSHIP,0,0,0,0,0,0,0,0,0,0,0,0,0,0,0,0,0,0,0
5229,BIHAR,2009,5,ILLEGITIMATE PREGNANCY,0,0,0,0,0,0,1,3,0,0,0,4,0,0,0,0,0,0,4
5774,BIHAR,2009,5,LOVE AFFAIRS,2,9,4,0,0,15,4,24,0,0,0,28,0,0,0,0,0,0,43
6320,BIHAR,2009,5,MARITAL ISSUES,0,24,13,0,0,37,0,26,9,0,10,45,0,0,0,0,0,0,82
6866,BIHAR,2009,5,MENTAL HEALTH,0,5,4,0,1,10,3,3,2,0,0,8,0,0,0,0,0,0,18
7412,BIHAR,2009,5,OTHERS,11,69,81,33,6,200,10,62,78,21,1,172,0,0,0,0,0,0,372
7996,BIHAR,2009,5,"PHYSICAL ABUSE (RAPE,INCEST ETC.)",0,0,0,0,0,0,0,0,0,0,0,0,0,0,0,0,0,0,0
8503,BIHAR,2009,5,SOCIETAL ISSUES,0,0,0,2,0,2,0,1,0,1,0,2,0,0,0,0,0,0,4
356,BIHAR,2010,5,CAUSES NOT KNOWN,11,26,32,9,4,82,8,23,19,6,1,57,0,0,0,0,0,0,139
902,BIHAR,2010,5,DEATH OF DEAR PERSON,0,2,0,0,0,2,0,0,0,1,1,2,0,0,0,0,0,0,4
1448,BIHAR,2010,5,DOWRY DISPUTE,0,12,6,0,0,18,0,35,14,3,1,53,0,0,0,0,0,0,71
1994,BIHAR,2010,5,DRUG ABUSE,0,1,25,3,1,30,0,1,2,0,0,3,0,0,0,0,0,0,33
2540,BIHAR,2010,5,ECONOMIC ISSUES,0,9,7,2,2,20,2,4,1,0,0,7,0,0,0,0,0,0,27
3086,BIHAR,2010,5,EXAM FAILURE,2,17,7,0,0,26,0,20,6,0,0,26,0,0,0,0,0,0,52
3632,BIHAR,2010,5,FAMILY PROBLEMS,4,14,33,16,2,69,4,22,21,8,2,57,0,0,0,0,0,0,126
4178,BIHAR,2010,5,HEALTH ISSUES,0,6,10,7,4,27,0,2,3,4,1,10,0,0,0,0,0,0,37
4723,BIHAR,2010,5,HERO WORSHIP,0,0,0,0,0,0,0,0,0,0,0,0,0,0,0,0,0,0,0
5268,BIHAR,2010,5,ILLEGITIMATE PREGNANCY,0,0,0,0,0,0,0,5,6,0,0,11,0,0,0,0,0,0,11
5813,BIHAR,2010,5,LOVE AFFAIRS,5,23,9,0,0,37,11,26,3,0,0,40,0,0,0,0,0,0,77
6359,BIHAR,2010,5,MARITAL ISSUES,0,22,8,1,0,31,5,25,11,0,0,41,0,0,0,0,0,0,72
6905,BIHAR,2010,5,MENTAL HEALTH,2,8,5,2,0,17,4,4,4,1,0,13,0,0,0,0,0,0,30
7451,BIHAR,2010,5,OTHERS,16,87,130,95,23,351,19,60,69,30,15,193,0,0,0,0,0,0,544
8035,BIHAR,2010,5,"PHYSICAL ABUSE (RAPE,INCEST ETC.)",0,1,0,1,0,2,1,0,0,0,0,1,0,0,0,0,0,0,3
8542,BIHAR,2010,5,SOCIETAL ISSUES,0,0,0,0,0,0,0,0,0,0,0,0,0,0,0,0,0,0,0
395,BIHAR,2011,5,CAUSES NOT KNOWN,1,12,13,3,3,32,0,7,5,4,2,18,0,0,0,0,0,0,50
941,BIHAR,2011,5,DEATH OF DEAR PERSON,0,0,0,0,0,0,0,0,0,0,0,0,0,0,0,0,0,0,0
1487,BIHAR,2011,5,DOWRY DISPUTE,0,0,0,0,0,0,0,10,6,2,0,18,0,0,0,0,0,0,18
2033,BIHAR,2011,5,DRUG ABUSE,0,3,3,2,0,8,0,0,0,0,0,0,0,0,0,0,0,0,8
2579,BIHAR,2011,5,ECONOMIC ISSUES,0,4,2,5,1,12,0,1,4,0,1,6,0,0,0,0,0,0,18
3125,BIHAR,2011,5,EXAM FAILURE,4,9,4,0,0,17,2,14,4,0,0,20,0,0,0,0,0,0,37
3671,BIHAR,2011,5,FAMILY PROBLEMS,0,31,23,19,0,73,1,26,29,3,1,60,0,0,0,0,0,0,133
4217,BIHAR,2011,5,HEALTH ISSUES,0,1,7,15,11,34,0,1,1,1,1,4,0,0,0,0,0,0,38
4762,BIHAR,2011,5,HERO WORSHIP,0,0,0,0,0,0,0,0,0,0,0,0,0,0,0,0,0,0,0
5307,BIHAR,2011,5,ILLEGITIMATE PREGNANCY,0,0,0,0,0,0,3,1,0,0,0,4,0,0,0,0,0,0,4
5852,BIHAR,2011,5,LOVE AFFAIRS,0,23,6,1,0,30,0,17,3,0,0,20,0,0,0,0,0,0,50
6398,BIHAR,2011,5,MARITAL ISSUES,0,4,3,4,1,12,2,10,10,2,0,24,0,0,0,0,0,0,36
6944,BIHAR,2011,5,MENTAL HEALTH,0,4,0,0,1,5,0,3,2,2,0,7,0,0,0,0,0,0,12
7490,BIHAR,2011,5,OTHERS,11,59,100,38,12,220,31,59,62,5,9,166,0,0,0,0,0,0,386
8074,BIHAR,2011,5,"PHYSICAL ABUSE (RAPE,INCEST ETC.)",0,0,0,0,0,0,2,0,0,0,0,2,0,0,0,0,0,0,2
8581,BIHAR,2011,5,SOCIETAL ISSUES,0,0,2,1,0,3,0,0,0,0,0,0,0,0,0,0,0,0,3
434,BIHAR,2012,5,CAUSES NOT KNOWN,1,19,84,6,3,113,0,19,16,7,2,44,0,0,0,0,0,0,157
980,BIHAR,2012,5,DEATH OF DEAR PERSON,0,0,0,0,0,0,0,0,0,0,0,0,0,0,0,0,0,0,0
1526,BIHAR,2012,5,DOWRY DISPUTE,0,0,2,0,0,2,0,4,8,1,0,13,0,0,0,0,0,0,15
2072,BIHAR,2012,5,DRUG ABUSE,0,1,5,3,1,10,0,0,0,0,0,0,0,0,0,0,0,0,10
2618,BIHAR,2012,5,ECONOMIC ISSUES,0,0,3,1,0,4,0,0,0,0,0,0,0,0,0,0,0,0,4
3164,BIHAR,2012,5,EXAM FAILURE,0,13,2,0,0,15,0,10,1,0,0,11,0,0,0,0,0,0,26
3710,BIHAR,2012,5,FAMILY PROBLEMS,0,20,18,8,0,46,1,11,17,5,0,34,0,0,0,0,0,0,80
4256,BIHAR,2012,5,HEALTH ISSUES,0,1,3,14,4,22,0,1,3,3,0,7,0,0,0,0,0,0,29
4801,BIHAR,2012,5,HERO WORSHIP,0,0,0,0,0,0,0,8,3,0,0,11,0,0,0,0,0,0,11
5346,BIHAR,2012,5,ILLEGITIMATE PREGNANCY,0,0,0,0,0,0,0,1,0,0,0,1,0,0,0,0,0,0,1
5891,BIHAR,2012,5,LOVE AFFAIRS,0,23,3,0,0,26,1,30,3,0,0,34,0,0,0,0,0,0,60
6437,BIHAR,2012,5,MARITAL ISSUES,0,8,6,1,0,15,0,6,3,0,0,9,0,0,0,0,0,0,24
6983,BIHAR,2012,5,MENTAL HEALTH,0,7,11,10,5,33,0,9,5,2,2,18,0,0,0,0,0,0,51
7529,BIHAR,2012,5,OTHERS,4,60,74,20,7,165,4,36,64,11,7,122,0,0,0,0,0,0,287
8113,BIHAR,2012,5,"PHYSICAL ABUSE (RAPE,INCEST ETC.)",0,0,0,0,0,0,0,0,0,0,0,0,0,0,0,0,0,0,0
8620,BIHAR,2012,5,SOCIETAL ISSUES,0,3,1,0,0,4,0,0,0,0,0,0,0,0,0,0,0,0,4
473,BIHAR,2013,5,CAUSES NOT KNOWN,1,10,12,0,4,27,11,13,11,3,0,38,0,0,0,0,0,0,65
1019,BIHAR,2013,5,DEATH OF DEAR PERSON,0,0,0,0,0,0,0,0,0,0,0,0,0,0,0,0,0,0,0
1565,BIHAR,2013,5,DOWRY DISPUTE,0,1,0,0,0,1,0,10,4,0,0,14,0,0,0,0,0,0,15
2111,BIHAR,2013,5,DRUG ABUSE,0,0,15,13,1,29,0,0,0,0,0,0,0,0,0,0,0,0,29
2657,BIHAR,2013,5,ECONOMIC ISSUES,0,4,6,5,3,18,0,0,1,0,1,2,0,0,0,0,0,0,20
3203,BIHAR,2013,5,EXAM FAILURE,0,18,4,0,0,22,0,4,3,0,0,7,0,0,0,0,0,0,29
3749,BIHAR,2013,5,FAMILY PROBLEMS,0,15,36,10,1,62,2,20,24,5,0,51,0,0,0,0,0,0,113
4295,BIHAR,2013,5,HEALTH ISSUES,0,1,4,6,1,12,0,2,3,1,0,6,0,0,0,0,0,0,18
4840,BIHAR,2013,5,HERO WORSHIP,0,0,0,0,0,0,0,1,0,0,0,1,0,0,0,0,0,0,1
5385,BIHAR,2013,5,ILLEGITIMATE PREGNANCY,0,0,0,0,0,0,2,6,6,0,0,14,0,0,0,0,0,0,14
5930,BIHAR,2013,5,LOVE AFFAIRS,3,17,5,0,0,25,3,16,2,0,0,21,0,0,0,0,0,0,46
6476,BIHAR,2013,5,MARITAL ISSUES,2,7,6,2,1,18,3,14,7,2,0,26,0,0,0,0,0,0,44
7022,BIHAR,2013,5,MENTAL HEALTH,4,3,5,1,1,14,1,1,2,1,1,6,0,0,0,0,0,0,20
7568,BIHAR,2013,5,OTHERS,16,99,159,87,37,398,24,91,97,20,5,237,0,0,0,0,0,0,635
8152,BIHAR,2013,5,"PHYSICAL ABUSE (RAPE,INCEST ETC.)",0,0,0,0,0,0,1,2,0,0,0,3,0,0,0,0,0,0,3
8659,BIHAR,2013,5,SOCIETAL ISSUES,0,1,1,2,0,4,0,1,0,0,0,1,0,0,0,0,0,0,5
512,BIHAR,2014,5,CAUSES NOT KNOWN,0,4,8,4,0,16,0,4,4,0,0,8,0,0,0,0,0,0,24
1058,BIHAR,2014,5,DEATH OF DEAR PERSON,0,1,1,0,0,2,0,1,0,0,0,1,0,0,0,0,0,0,3
1604,BIHAR,2014,5,DOWRY DISPUTE,0,0,2,1,0,3,0,28,2,0,0,30,0,0,0,0,0,0,33
2150,BIHAR,2014,5,DRUG ABUSE,1,9,3,0,0,13,0,0,2,1,0,3,0,0,0,0,0,0,16
2696,BIHAR,2014,5,ECONOMIC ISSUES,0,6,43,6,50,105,0,0,12,6,0,18,0,0,0,0,0,0,123
3242,BIHAR,2014,5,EXAM FAILURE,1,17,1,0,0,19,0,18,5,0,0,23,0,0,0,0,0,0,42
3788,BIHAR,2014,5,FAMILY PROBLEMS,0,19,19,8,0,46,1,26,18,3,2,50,0,0,0,0,0,0,96
4334,BIHAR,2014,5,HEALTH ISSUES,0,1,9,15,4,29,0,2,15,17,0,34,0,0,0,0,0,0,63
4879,BIHAR,2014,5,HERO WORSHIP,0,0,0,0,0,0,0,0,0,0,0,0,0,0,0,0,0,0,0
5424,BIHAR,2014,5,ILLEGITIMATE PREGNANCY,0,0,0,0,0,0,0,0,0,0,0,0,0,0,0,0,0,0,0
5969,BIHAR,2014,5,LOVE AFFAIRS,4,16,0,0,0,20,1,23,8,0,0,32,0,0,0,0,0,0,52
6515,BIHAR,2014,5,MARITAL ISSUES,0,74,23,19,1,117,0,74,34,3,0,111,0,0,0,0,0,0,228
7061,BIHAR,2014,5,MENTAL HEALTH,0,1,3,1,0,5,0,0,1,1,0,2,0,0,0,0,0,0,7
7607,BIHAR,2014,5,OTHERS,5,61,45,35,2,148,2,48,30,6,0,86,0,0,0,0,0,0,234
7646,BIHAR,2014,5,PHYSICAL ABUSE,0,0,0,0,0,0,0,2,1,0,0,3,0,0,0,0,0,0,3
8698,BIHAR,2014,5,SOCIETAL ISSUES,0,0,0,0,0,0,0,0,0,0,0,0,0,0,0,0,0,0,0
6,CHANDIGARH,2001,6,CAUSES NOT KNOWN,0,0,0,0,0,0,0,0,0,0,0,0,0,0,0,0,0,0,0
552,CHANDIGARH,2001,6,DEATH OF DEAR PERSON,0,0,0,0,0,0,0,0,0,0,0,0,0,0,0,0,0,0,0
1098,CHANDIGARH,2001,6,DOWRY DISPUTE,0,0,0,0,0,0,0,3,2,0,0,5,0,0,0,0,0,0,5
1644,CHANDIGARH,2001,6,DRUG ABUSE,0,0,0,0,0,0,0,0,0,0,0,0,0,0,0,0,0,0,0
2190,CHANDIGARH,2001,6,ECONOMIC ISSUES,0,1,0,0,0,1,0,1,0,0,0,1,0,0,0,0,0,0,2
2736,CHANDIGARH,2001,6,EXAM FAILURE,0,0,0,0,0,0,0,2,0,0,0,2,0,0,0,0,0,0,2
3282,CHANDIGARH,2001,6,FAMILY PROBLEMS,0,1,2,0,0,3,0,0,2,0,0,2,0,0,0,0,0,0,5
3828,CHANDIGARH,2001,6,HEALTH ISSUES,0,4,3,2,0,9,0,5,3,2,0,10,0,0,0,0,0,0,19
4374,CHANDIGARH,2001,6,HERO WORSHIP,0,0,0,0,0,0,0,0,0,0,0,0,0,0,0,0,0,0,0
4919,CHANDIGARH,2001,6,ILLEGITIMATE PREGNANCY,0,0,0,0,0,0,0,0,0,0,0,0,0,0,0,0,0,0,0
5464,CHANDIGARH,2001,6,LOVE AFFAIRS,0,0,0,0,0,0,0,1,0,0,0,1,0,0,0,0,0,0,1
6009,CHANDIGARH,2001,6,MARITAL ISSUES,0,0,1,0,0,1,0,1,2,0,0,3,0,0,0,0,0,0,4
6555,CHANDIGARH,2001,6,MENTAL HEALTH,0,0,0,0,0,0,0,0,0,0,0,0,0,0,0,0,0,0,0
7101,CHANDIGARH,2001,6,OTHERS,0,14,9,0,2,25,0,5,2,0,0,7,0,0,0,0,0,0,32
7686,CHANDIGARH,2001,6,"PHYSICAL ABUSE (RAPE,INCEST ETC.)",0,0,0,0,0,0,0,0,0,0,0,0,0,0,0,0,0,0,0
8192,CHANDIGARH,2001,6,SOCIETAL ISSUES,0,0,0,0,0,0,0,0,0,0,0,0,0,0,0,0,0,0,0
45,CHANDIGARH,2002,6,CAUSES NOT KNOWN,0,2,4,1,0,7,0,1,0,0,0,1,0,0,0,0,0,0,8
591,CHANDIGARH,2002,6,DEATH OF DEAR PERSON,0,0,0,0,0,0,0,0,0,0,0,0,0,0,0,0,0,0,0
1137,CHANDIGARH,2002,6,DOWRY DISPUTE,0,1,0,0,0,1,0,0,0,0,0,0,0,0,0,0,0,0,1
1683,CHANDIGARH,2002,6,DRUG ABUSE,0,1,0,0,0,1,0,0,0,0,0,0,0,0,0,0,0,0,1
2229,CHANDIGARH,2002,6,ECONOMIC ISSUES,0,1,2,0,0,3,0,0,1,0,0,1,0,0,0,0,0,0,4
2775,CHANDIGARH,2002,6,EXAM FAILURE,0,0,0,0,0,0,0,2,0,0,0,2,0,0,0,0,0,0,2
3321,CHANDIGARH,2002,6,FAMILY PROBLEMS,0,4,8,0,0,12,0,11,3,0,0,14,0,0,0,0,0,0,26
3867,CHANDIGARH,2002,6,HEALTH ISSUES,0,0,0,0,0,0,0,0,0,0,0,0,0,0,0,0,0,0,0
4413,CHANDIGARH,2002,6,HERO WORSHIP,0,0,0,0,0,0,0,0,0,0,0,0,0,0,0,0,0,0,0
4958,CHANDIGARH,2002,6,ILLEGITIMATE PREGNANCY,0,0,0,0,0,0,0,1,0,0,0,1,0,0,0,0,0,0,1
5503,CHANDIGARH,2002,6,LOVE AFFAIRS,0,5,0,0,0,5,0,4,0,0,0,4,0,0,0,0,0,0,9
6048,CHANDIGARH,2002,6,MARITAL ISSUES,0,0,0,0,0,0,0,1,1,0,0,2,0,0,0,0,0,0,2
6594,CHANDIGARH,2002,6,MENTAL HEALTH,1,2,5,2,0,10,1,2,1,0,0,4,0,0,0,0,0,0,14
7140,CHANDIGARH,2002,6,OTHERS,0,7,6,0,0,13,0,1,1,1,2,5,0,0,0,0,0,0,18
7725,CHANDIGARH,2002,6,"PHYSICAL ABUSE (RAPE,INCEST ETC.)",0,0,0,0,0,0,0,0,0,0,0,0,0,0,0,0,0,0,0
8231,CHANDIGARH,2002,6,SOCIETAL ISSUES,0,0,1,0,0,1,0,0,0,0,0,0,0,0,0,0,0,0,1
84,CHANDIGARH,2003,6,CAUSES NOT KNOWN,0,4,1,1,0,6,1,2,0,0,0,3,0,0,0,0,0,0,9
630,CHANDIGARH,2003,6,DEATH OF DEAR PERSON,0,0,0,0,0,0,0,0,0,0,0,0,0,0,0,0,0,0,0
1176,CHANDIGARH,2003,6,DOWRY DISPUTE,0,0,0,0,0,0,0,3,0,0,0,3,0,0,0,0,0,0,3
1722,CHANDIGARH,2003,6,DRUG ABUSE,0,2,2,0,0,4,0,0,0,0,0,0,0,0,0,0,0,0,4
2268,CHANDIGARH,2003,6,ECONOMIC ISSUES,0,1,3,0,0,4,0,0,0,0,0,0,0,0,0,0,0,0,4
2814,CHANDIGARH,2003,6,EXAM FAILURE,0,0,0,0,0,0,0,2,0,0,0,2,0,0,0,0,0,0,2
3360,CHANDIGARH,2003,6,FAMILY PROBLEMS,0,7,9,4,1,21,0,7,4,0,0,11,0,0,0,0,0,0,32
3906,CHANDIGARH,2003,6,HEALTH ISSUES,0,0,0,0,0,0,0,1,0,1,0,2,0,0,0,0,0,0,2
4452,CHANDIGARH,2003,6,HERO WORSHIP,0,0,0,0,0,0,0,0,0,0,0,0,0,0,0,0,0,0,0
4997,CHANDIGARH,2003,6,ILLEGITIMATE PREGNANCY,0,0,0,0,0,0,0,0,0,0,0,0,0,0,0,0,0,0,0
5542,CHANDIGARH,2003,6,LOVE AFFAIRS,0,2,0,0,0,2,0,0,0,0,0,0,0,0,0,0,0,0,2
6087,CHANDIGARH,2003,6,MARITAL ISSUES,0,1,0,0,0,1,0,1,0,0,0,1,0,0,0,0,0,0,2
6633,CHANDIGARH,2003,6,MENTAL HEALTH,0,6,0,0,2,8,0,2,1,0,2,5,0,0,0,0,0,0,13
7179,CHANDIGARH,2003,6,OTHERS,0,7,12,3,0,22,0,4,3,1,0,8,0,0,0,0,0,0,30
7764,CHANDIGARH,2003,6,"PHYSICAL ABUSE (RAPE,INCEST ETC.)",0,0,0,0,0,0,0,0,0,0,0,0,0,0,0,0,0,0,0
8270,CHANDIGARH,2003,6,SOCIETAL ISSUES,0,0,0,0,0,0,0,0,0,0,0,0,0,0,0,0,0,0,0
123,CHANDIGARH,2004,6,CAUSES NOT KNOWN,0,3,6,0,1,10,0,2,0,1,0,3,0,0,0,0,0,0,13
669,CHANDIGARH,2004,6,DEATH OF DEAR PERSON,0,0,0,0,0,0,0,0,0,0,0,0,0,0,0,0,0,0,0
1215,CHANDIGARH,2004,6,DOWRY DISPUTE,0,0,0,0,0,0,0,2,0,0,0,2,0,0,0,0,0,0,2
1761,CHANDIGARH,2004,6,DRUG ABUSE,0,3,2,0,0,5,0,0,0,0,0,0,0,0,0,0,0,0,5
2307,CHANDIGARH,2004,6,ECONOMIC ISSUES,0,4,2,0,0,6,0,1,0,0,0,1,0,0,0,0,0,0,7
2853,CHANDIGARH,2004,6,EXAM FAILURE,0,3,0,0,0,3,0,4,0,0,0,4,0,0,0,0,0,0,7
3399,CHANDIGARH,2004,6,FAMILY PROBLEMS,0,2,8,3,0,13,0,3,0,0,0,3,0,0,0,0,0,0,16
3945,CHANDIGARH,2004,6,HEALTH ISSUES,0,4,1,4,0,9,0,0,0,1,0,1,0,0,0,0,0,0,10
4491,CHANDIGARH,2004,6,HERO WORSHIP,0,0,0,0,0,0,0,0,0,0,0,0,0,0,0,0,0,0,0
5036,CHANDIGARH,2004,6,ILLEGITIMATE PREGNANCY,0,0,0,0,0,0,0,0,0,0,0,0,0,0,0,0,0,0,0
5581,CHANDIGARH,2004,6,LOVE AFFAIRS,0,2,0,0,0,2,0,5,1,0,0,6,0,0,0,0,0,0,8
6126,CHANDIGARH,2004,6,MARITAL ISSUES,0,0,0,0,0,0,0,0,1,0,0,1,0,0,0,0,0,0,1
6672,CHANDIGARH,2004,6,MENTAL HEALTH,0,2,2,0,0,4,0,1,0,0,0,1,0,0,0,0,0,0,5
7218,CHANDIGARH,2004,6,OTHERS,0,0,0,0,0,0,0,0,0,0,0,0,0,0,0,0,0,0,0
7803,CHANDIGARH,2004,6,"PHYSICAL ABUSE (RAPE,INCEST ETC.)",0,0,0,0,0,0,0,0,0,0,0,0,0,0,0,0,0,0,0
8309,CHANDIGARH,2004,6,SOCIETAL ISSUES,0,0,0,0,0,0,0,1,0,0,0,1,0,0,0,0,0,0,1
162,CHANDIGARH,2005,6,CAUSES NOT KNOWN,0,10,7,2,0,19,0,8,1,1,0,10,0,0,0,0,0,0,29
708,CHANDIGARH,2005,6,DEATH OF DEAR PERSON,0,0,0,0,0,0,0,0,0,0,0,0,0,0,0,0,0,0,0
1254,CHANDIGARH,2005,6,DOWRY DISPUTE,0,0,0,0,0,0,0,0,0,0,0,0,0,0,0,0,0,0,0
1800,CHANDIGARH,2005,6,DRUG ABUSE,0,3,2,0,0,5,0,0,0,0,0,0,0,0,0,0,0,0,5
2346,CHANDIGARH,2005,6,ECONOMIC ISSUES,0,5,0,0,0,5,0,0,0,0,0,0,0,0,0,0,0,0,5
2892,CHANDIGARH,2005,6,EXAM FAILURE,0,2,0,0,0,2,0,1,0,0,0,1,0,0,0,0,0,0,3
3438,CHANDIGARH,2005,6,FAMILY PROBLEMS,0,8,6,5,0,19,0,4,4,2,0,10,0,0,0,0,0,0,29
3984,CHANDIGARH,2005,6,HEALTH ISSUES,0,2,0,2,0,4,0,0,0,0,0,0,0,0,0,0,0,0,4
4530,CHANDIGARH,2005,6,HERO WORSHIP,0,0,0,0,0,0,0,0,0,0,0,0,0,0,0,0,0,0,0
5075,CHANDIGARH,2005,6,ILLEGITIMATE PREGNANCY,0,0,0,0,0,0,0,0,0,0,0,0,0,0,0,0,0,0,0
5620,CHANDIGARH,2005,6,LOVE AFFAIRS,0,0,0,0,0,0,0,1,0,0,0,1,0,0,0,0,0,0,1
6165,CHANDIGARH,2005,6,MARITAL ISSUES,0,0,0,0,0,0,0,0,0,0,0,0,0,0,0,0,0,0,0
6711,CHANDIGARH,2005,6,MENTAL HEALTH,1,2,0,0,0,3,0,0,0,0,0,0,0,0,0,0,0,0,3
7257,CHANDIGARH,2005,6,OTHERS,1,0,1,1,0,3,1,1,0,1,0,3,0,0,0,0,0,0,6
7842,CHANDIGARH,2005,6,"PHYSICAL ABUSE (RAPE,INCEST ETC.)",0,0,0,0,0,0,0,0,0,0,0,0,0,0,0,0,0,0,0
8348,CHANDIGARH,2005,6,SOCIETAL ISSUES,0,1,2,0,0,3,0,0,1,0,0,1,0,0,0,0,0,0,4
201,CHANDIGARH,2006,6,CAUSES NOT KNOWN,0,11,6,1,1,19,1,5,2,1,1,10,0,0,0,0,0,0,29
747,CHANDIGARH,2006,6,DEATH OF DEAR PERSON,0,0,0,0,0,0,0,0,0,0,0,0,0,0,0,0,0,0,0
1293,CHANDIGARH,2006,6,DOWRY DISPUTE,0,0,0,0,0,0,0,0,1,0,0,1,0,0,0,0,0,0,1
1839,CHANDIGARH,2006,6,DRUG ABUSE,0,0,1,0,0,1,0,0,0,0,0,0,0,0,0,0,0,0,1
2385,CHANDIGARH,2006,6,ECONOMIC ISSUES,0,0,12,0,0,12,0,0,0,0,0,0,0,0,0,0,0,0,12
2931,CHANDIGARH,2006,6,EXAM FAILURE,0,2,0,0,0,2,0,0,0,0,0,0,0,0,0,0,0,0,2
3477,CHANDIGARH,2006,6,FAMILY PROBLEMS,0,5,7,1,0,13,1,4,2,0,0,7,0,0,0,0,0,0,20
4023,CHANDIGARH,2006,6,HEALTH ISSUES,0,0,0,1,0,1,0,0,1,0,0,1,0,0,0,0,0,0,2
4569,CHANDIGARH,2006,6,HERO WORSHIP,0,0,0,0,0,0,0,0,0,0,0,0,0,0,0,0,0,0,0
5114,CHANDIGARH,2006,6,ILLEGITIMATE PREGNANCY,0,8,0,0,0,8,0,2,0,0,0,2,0,0,0,0,0,0,10
5659,CHANDIGARH,2006,6,LOVE AFFAIRS,0,0,0,0,0,0,0,0,0,0,0,0,0,0,0,0,0,0,0
6204,CHANDIGARH,2006,6,MARITAL ISSUES,0,0,0,0,0,0,0,0,0,0,0,0,0,0,0,0,0,0,0
6750,CHANDIGARH,2006,6,MENTAL HEALTH,0,0,0,0,0,0,0,3,0,0,0,3,0,0,0,0,0,0,3
7296,CHANDIGARH,2006,6,OTHERS,0,0,0,0,0,0,0,0,0,0,0,0,0,0,0,0,0,0,0
7881,CHANDIGARH,2006,6,"PHYSICAL ABUSE (RAPE,INCEST ETC.)",0,0,0,0,0,0,0,0,0,0,0,0,0,0,0,0,0,0,0
8387,CHANDIGARH,2006,6,SOCIETAL ISSUES,0,0,0,0,0,0,0,0,0,0,0,0,0,0,0,0,0,0,0
240,CHANDIGARH,2007,6,CAUSES NOT KNOWN,2,5,1,0,0,8,0,0,0,0,1,1,0,0,0,0,0,0,9
786,CHANDIGARH,2007,6,DEATH OF DEAR PERSON,0,0,0,0,0,0,0,0,0,0,0,0,0,0,0,0,0,0,0
1332,CHANDIGARH,2007,6,DOWRY DISPUTE,0,0,0,0,0,0,0,1,0,0,0,1,0,0,0,0,0,0,1
1878,CHANDIGARH,2007,6,DRUG ABUSE,0,0,0,0,0,0,0,0,0,0,0,0,0,0,0,0,0,0,0
2424,CHANDIGARH,2007,6,ECONOMIC ISSUES,0,8,3,1,0,12,0,0,1,0,0,1,0,0,0,0,0,0,13
2970,CHANDIGARH,2007,6,EXAM FAILURE,0,8,0,0,0,8,0,0,0,0,0,0,0,0,0,0,0,0,8
3516,CHANDIGARH,2007,6,FAMILY PROBLEMS,0,4,13,6,0,23,0,9,6,1,0,16,0,0,0,0,0,0,39
4062,CHANDIGARH,2007,6,HEALTH ISSUES,0,0,4,1,3,8,0,0,0,0,0,0,0,0,0,0,0,0,8
4607,CHANDIGARH,2007,6,HERO WORSHIP,0,0,0,0,0,0,0,0,0,0,0,0,0,0,0,0,0,0,0
5152,CHANDIGARH,2007,6,ILLEGITIMATE PREGNANCY,0,0,0,0,0,0,0,0,0,0,0,0,0,0,0,0,0,0,0
5697,CHANDIGARH,2007,6,LOVE AFFAIRS,0,1,0,0,0,1,0,1,0,0,0,1,0,0,0,0,0,0,2
6243,CHANDIGARH,2007,6,MARITAL ISSUES,0,0,0,0,0,0,0,0,0,0,0,0,0,0,0,0,0,0,0
6789,CHANDIGARH,2007,6,MENTAL HEALTH,0,0,0,0,0,0,0,0,0,0,0,0,0,0,0,0,0,0,0
7335,CHANDIGARH,2007,6,OTHERS,0,0,0,0,0,0,0,0,1,0,1,2,0,0,0,0,0,0,2
7919,CHANDIGARH,2007,6,"PHYSICAL ABUSE (RAPE,INCEST ETC.)",0,0,0,0,0,0,0,0,0,0,0,0,0,0,0,0,0,0,0
8426,CHANDIGARH,2007,6,SOCIETAL ISSUES,0,0,0,0,0,0,0,0,0,0,0,0,0,0,0,0,0,0,0
279,CHANDIGARH,2008,6,CAUSES NOT KNOWN,0,2,0,3,0,5,0,0,0,0,0,0,0,0,0,0,0,0,5
825,CHANDIGARH,2008,6,DEATH OF DEAR PERSON,0,0,0,0,0,0,0,0,0,0,0,0,0,0,0,0,0,0,0
1371,CHANDIGARH,2008,6,DOWRY DISPUTE,0,0,0,0,0,0,0,2,0,0,0,2,0,0,0,0,0,0,2
1917,CHANDIGARH,2008,6,DRUG ABUSE,0,3,1,0,0,4,0,0,0,0,0,0,0,0,0,0,0,0,4
2463,CHANDIGARH,2008,6,ECONOMIC ISSUES,0,5,6,4,0,15,0,0,0,0,0,0,0,0,0,0,0,0,15
3009,CHANDIGARH,2008,6,EXAM FAILURE,0,3,0,0,0,3,0,2,0,0,0,2,0,0,0,0,0,0,5
3555,CHANDIGARH,2008,6,FAMILY PROBLEMS,0,3,8,3,0,14,0,8,6,1,0,15,0,0,0,0,0,0,29
4101,CHANDIGARH,2008,6,HEALTH ISSUES,0,2,4,3,1,10,0,0,0,1,0,1,0,0,0,0,0,0,11
4646,CHANDIGARH,2008,6,HERO WORSHIP,0,0,0,0,0,0,0,0,0,0,0,0,0,0,0,0,0,0,0
5191,CHANDIGARH,2008,6,ILLEGITIMATE PREGNANCY,0,0,0,0,0,0,0,0,0,0,0,0,0,0,0,0,0,0,0
5736,CHANDIGARH,2008,6,LOVE AFFAIRS,0,4,0,0,0,4,0,4,0,0,0,4,0,0,0,0,0,0,8
6282,CHANDIGARH,2008,6,MARITAL ISSUES,0,0,0,0,0,0,0,0,1,0,0,1,0,0,0,0,0,0,1
6828,CHANDIGARH,2008,6,MENTAL HEALTH,0,0,0,2,0,2,0,0,0,0,0,0,0,0,0,0,0,0,2
7374,CHANDIGARH,2008,6,OTHERS,0,0,0,0,0,0,0,0,0,0,0,0,0,0,0,0,0,0,0
7958,CHANDIGARH,2008,6,"PHYSICAL ABUSE (RAPE,INCEST ETC.)",0,0,0,0,0,0,0,0,0,0,0,0,0,0,0,0,0,0,0
8465,CHANDIGARH,2008,6,SOCIETAL ISSUES,0,0,0,1,0,1,0,0,0,0,0,0,0,0,0,0,0,0,1
318,CHANDIGARH,2009,6,CAUSES NOT KNOWN,0,2,7,1,1,11,0,5,4,1,0,10,0,0,0,0,0,0,21
864,CHANDIGARH,2009,6,DEATH OF DEAR PERSON,0,0,0,0,0,0,0,0,0,0,0,0,0,0,0,0,0,0,0
1410,CHANDIGARH,2009,6,DOWRY DISPUTE,0,0,0,0,0,0,0,1,0,0,0,1,0,0,0,0,0,0,1
1956,CHANDIGARH,2009,6,DRUG ABUSE,0,1,0,0,0,1,0,0,0,0,0,0,0,0,0,0,0,0,1
2502,CHANDIGARH,2009,6,ECONOMIC ISSUES,0,1,2,0,0,3,0,0,0,0,1,1,0,0,0,0,0,0,4
3048,CHANDIGARH,2009,6,EXAM FAILURE,0,4,0,0,0,4,0,4,0,0,0,4,0,0,0,0,0,0,8
3594,CHANDIGARH,2009,6,FAMILY PROBLEMS,0,5,7,5,0,17,1,8,4,0,1,14,0,0,0,0,0,0,31
4140,CHANDIGARH,2009,6,HEALTH ISSUES,0,0,0,0,0,0,0,0,1,0,0,1,0,0,0,0,0,0,1
4685,CHANDIGARH,2009,6,HERO WORSHIP,0,0,0,0,0,0,0,0,0,0,0,0,0,0,0,0,0,0,0
5230,CHANDIGARH,2009,6,ILLEGITIMATE PREGNANCY,0,0,0,0,0,0,0,0,0,0,0,0,0,0,0,0,0,0,0
5775,CHANDIGARH,2009,6,LOVE AFFAIRS,0,2,0,0,0,2,0,0,0,0,0,0,0,0,0,0,0,0,2
6321,CHANDIGARH,2009,6,MARITAL ISSUES,0,0,0,0,0,0,0,0,0,0,0,0,0,0,0,0,0,0,0
6867,CHANDIGARH,2009,6,MENTAL HEALTH,0,0,0,0,0,0,0,0,0,0,0,0,0,0,0,0,0,0,0
7413,CHANDIGARH,2009,6,OTHERS,0,1,0,0,0,1,0,0,0,0,0,0,0,0,0,0,0,0,1
7997,CHANDIGARH,2009,6,"PHYSICAL ABUSE (RAPE,INCEST ETC.)",0,0,2,1,1,4,0,0,0,0,0,0,0,0,0,0,0,0,4
8504,CHANDIGARH,2009,6,SOCIETAL ISSUES,0,0,0,1,0,1,0,0,0,0,0,0,0,0,0,0,0,0,1
357,CHANDIGARH,2010,6,CAUSES NOT KNOWN,0,0,1,0,0,1,0,0,0,0,0,0,0,0,0,0,0,0,1
903,CHANDIGARH,2010,6,DEATH OF DEAR PERSON,0,0,0,0,0,0,0,0,0,0,0,0,0,0,0,0,0,0,0
1449,CHANDIGARH,2010,6,DOWRY DISPUTE,0,0,0,0,0,0,0,0,0,0,0,0,0,0,0,0,0,0,0
1995,CHANDIGARH,2010,6,DRUG ABUSE,0,0,0,0,0,0,0,0,0,0,0,0,0,0,0,0,0,0,0
2541,CHANDIGARH,2010,6,ECONOMIC ISSUES,0,4,4,1,0,9,0,0,0,0,0,0,0,0,0,0,0,0,9
3087,CHANDIGARH,2010,6,EXAM FAILURE,0,0,0,0,0,0,1,4,0,0,0,5,0,0,0,0,0,0,5
3633,CHANDIGARH,2010,6,FAMILY PROBLEMS,0,1,0,1,0,2,1,13,7,1,0,22,0,0,0,0,0,0,24
4179,CHANDIGARH,2010,6,HEALTH ISSUES,0,1,0,1,1,3,0,4,1,1,1,7,0,0,0,0,0,0,10
4724,CHANDIGARH,2010,6,HERO WORSHIP,0,0,0,0,0,0,0,0,0,0,0,0,0,0,0,0,0,0,0
5269,CHANDIGARH,2010,6,ILLEGITIMATE PREGNANCY,0,0,0,0,0,0,0,0,0,0,0,0,0,0,0,0,0,0,0
5814,CHANDIGARH,2010,6,LOVE AFFAIRS,0,5,0,0,0,5,0,1,0,0,0,1,0,0,0,0,0,0,6
6360,CHANDIGARH,2010,6,MARITAL ISSUES,0,0,0,0,0,0,0,0,0,0,0,0,0,0,0,0,0,0,0
6906,CHANDIGARH,2010,6,MENTAL HEALTH,0,0,0,0,0,0,0,0,0,0,0,0,0,0,0,0,0,0,0
7452,CHANDIGARH,2010,6,OTHERS,0,3,7,1,0,11,0,3,1,0,0,4,0,0,0,0,0,0,15
8036,CHANDIGARH,2010,6,"PHYSICAL ABUSE (RAPE,INCEST ETC.)",0,0,0,0,0,0,0,0,1,0,0,1,0,0,0,0,0,0,1
8543,CHANDIGARH,2010,6,SOCIETAL ISSUES,0,0,0,0,0,0,0,0,0,0,0,0,0,0,0,0,0,0,0
396,CHANDIGARH,2011,6,CAUSES NOT KNOWN,0,0,1,0,0,1,0,0,0,0,0,0,0,0,0,0,0,0,1
942,CHANDIGARH,2011,6,DEATH OF DEAR PERSON,0,0,0,0,0,0,0,0,0,0,0,0,0,0,0,0,0,0,0
1488,CHANDIGARH,2011,6,DOWRY DISPUTE,0,0,0,0,0,0,0,0,0,0,0,0,0,0,0,0,0,0,0
2034,CHANDIGARH,2011,6,DRUG ABUSE,0,2,1,1,0,4,0,0,0,0,0,0,0,0,0,0,0,0,4
2580,CHANDIGARH,2011,6,ECONOMIC ISSUES,0,1,0,0,0,1,0,0,0,0,0,0,0,0,0,0,0,0,1
3126,CHANDIGARH,2011,6,EXAM FAILURE,0,0,0,0,0,0,0,0,0,0,0,0,0,0,0,0,0,0,0
3672,CHANDIGARH,2011,6,FAMILY PROBLEMS,0,3,1,0,0,4,0,13,3,1,0,17,0,0,0,0,0,0,21
4218,CHANDIGARH,2011,6,HEALTH ISSUES,0,1,0,3,0,4,0,0,1,0,0,1,0,0,0,0,0,0,5
4763,CHANDIGARH,2011,6,HERO WORSHIP,0,0,0,0,0,0,0,0,0,0,0,0,0,0,0,0,0,0,0
5308,CHANDIGARH,2011,6,ILLEGITIMATE PREGNANCY,0,0,0,0,0,0,0,0,0,0,0,0,0,0,0,0,0,0,0
5853,CHANDIGARH,2011,6,LOVE AFFAIRS,0,0,0,0,0,0,0,1,0,0,0,1,0,0,0,0,0,0,1
6399,CHANDIGARH,2011,6,MARITAL ISSUES,0,0,0,0,0,0,0,0,0,0,0,0,0,0,0,0,0,0,0
6945,CHANDIGARH,2011,6,MENTAL HEALTH,0,0,0,0,0,0,0,0,0,0,0,0,0,0,0,0,0,0,0
7491,CHANDIGARH,2011,6,OTHERS,0,17,16,9,1,43,0,17,10,2,0,29,0,0,0,0,0,0,72
8075,CHANDIGARH,2011,6,"PHYSICAL ABUSE (RAPE,INCEST ETC.)",0,0,0,0,0,0,0,0,0,0,0,0,0,0,0,0,0,0,0
8582,CHANDIGARH,2011,6,SOCIETAL ISSUES,0,0,0,0,0,0,0,0,0,0,0,0,0,0,0,0,0,0,0
435,CHANDIGARH,2012,6,CAUSES NOT KNOWN,0,0,1,0,0,1,0,0,0,0,0,0,0,0,0,0,0,0,1
981,CHANDIGARH,2012,6,DEATH OF DEAR PERSON,0,0,0,0,0,0,0,0,0,0,0,0,0,0,0,0,0,0,0
1527,CHANDIGARH,2012,6,DOWRY DISPUTE,0,0,0,0,0,0,0,0,0,0,0,0,0,0,0,0,0,0,0
2073,CHANDIGARH,2012,6,DRUG ABUSE,0,4,2,0,0,6,0,0,0,0,0,0,0,0,0,0,0,0,6
2619,CHANDIGARH,2012,6,ECONOMIC ISSUES,0,11,5,0,0,16,0,2,2,0,0,4,0,0,0,0,0,0,20
3165,CHANDIGARH,2012,6,EXAM FAILURE,0,0,0,0,0,0,0,1,0,0,0,1,0,0,0,0,0,0,1
3711,CHANDIGARH,2012,6,FAMILY PROBLEMS,2,4,9,5,0,20,0,7,3,0,1,11,0,0,0,0,0,0,31
4257,CHANDIGARH,2012,6,HEALTH ISSUES,0,0,0,0,0,0,0,1,0,0,0,1,0,0,0,0,0,0,1
4802,CHANDIGARH,2012,6,HERO WORSHIP,0,0,0,0,0,0,0,0,0,0,0,0,0,0,0,0,0,0,0
5347,CHANDIGARH,2012,6,ILLEGITIMATE PREGNANCY,0,0,0,0,0,0,0,0,0,0,0,0,0,0,0,0,0,0,0
5892,CHANDIGARH,2012,6,LOVE AFFAIRS,0,0,0,0,0,0,0,1,0,0,0,1,0,0,0,0,0,0,1
6438,CHANDIGARH,2012,6,MARITAL ISSUES,0,0,0,0,0,0,0,0,0,0,0,0,0,0,0,0,0,0,0
6984,CHANDIGARH,2012,6,MENTAL HEALTH,0,0,0,0,0,0,0,0,0,0,0,0,0,0,0,0,0,0,0
7530,CHANDIGARH,2012,6,OTHERS,0,14,14,3,1,32,1,17,3,0,0,21,0,0,0,0,0,0,53
8114,CHANDIGARH,2012,6,"PHYSICAL ABUSE (RAPE,INCEST ETC.)",0,0,0,0,0,0,0,0,0,0,0,0,0,0,0,0,0,0,0
8621,CHANDIGARH,2012,6,SOCIETAL ISSUES,0,0,0,0,0,0,0,0,0,0,0,0,0,0,0,0,0,0,0
474,CHANDIGARH,2013,6,CAUSES NOT KNOWN,0,3,3,3,0,9,0,5,2,0,0,7,0,0,0,0,0,0,16
1020,CHANDIGARH,2013,6,DEATH OF DEAR PERSON,0,0,0,0,0,0,0,0,0,0,0,0,0,0,0,0,0,0,0
1566,CHANDIGARH,2013,6,DOWRY DISPUTE,0,0,0,0,0,0,0,0,0,0,0,0,0,0,0,0,0,0,0
2112,CHANDIGARH,2013,6,DRUG ABUSE,0,0,0,0,0,0,0,0,0,0,0,0,0,0,0,0,0,0,0
2658,CHANDIGARH,2013,6,ECONOMIC ISSUES,0,2,3,0,0,5,0,0,0,0,0,0,0,0,0,0,0,0,5
3204,CHANDIGARH,2013,6,EXAM FAILURE,0,2,0,0,0,2,0,2,0,0,0,2,0,0,0,0,0,0,4
3750,CHANDIGARH,2013,6,FAMILY PROBLEMS,0,10,11,6,2,29,0,9,7,2,0,18,0,0,0,0,0,0,47
4296,CHANDIGARH,2013,6,HEALTH ISSUES,0,1,1,1,0,3,0,0,0,0,0,0,0,0,0,0,0,0,3
4841,CHANDIGARH,2013,6,HERO WORSHIP,0,0,0,0,0,0,0,0,0,0,0,0,0,0,0,0,0,0,0
5386,CHANDIGARH,2013,6,ILLEGITIMATE PREGNANCY,0,0,0,0,0,0,0,0,0,0,0,0,0,0,0,0,0,0,0
5931,CHANDIGARH,2013,6,LOVE AFFAIRS,0,10,0,0,0,10,1,9,0,0,0,10,0,0,0,0,0,0,20
6477,CHANDIGARH,2013,6,MARITAL ISSUES,0,0,0,0,0,0,0,0,0,0,0,0,0,0,0,0,0,0,0
7023,CHANDIGARH,2013,6,MENTAL HEALTH,0,0,0,0,0,0,0,0,0,0,0,0,0,0,0,0,0,0,0
7569,CHANDIGARH,2013,6,OTHERS,0,0,0,1,0,1,0,1,0,0,0,1,0,0,0,0,0,0,2
8153,CHANDIGARH,2013,6,"PHYSICAL ABUSE (RAPE,INCEST ETC.)",0,0,0,0,0,0,0,0,0,0,0,0,0,0,0,0,0,0,0
8660,CHANDIGARH,2013,6,SOCIETAL ISSUES,0,0,0,0,0,0,0,0,0,0,0,0,0,0,0,0,0,0,0
513,CHANDIGARH,2014,6,CAUSES NOT KNOWN,0,6,3,6,1,16,0,5,5,0,0,10,0,0,0,0,0,0,26
1059,CHANDIGARH,2014,6,DEATH OF DEAR PERSON,0,0,0,0,0,0,0,0,0,0,0,0,0,0,0,0,0,0,0
1605,CHANDIGARH,2014,6,DOWRY DISPUTE,0,0,0,0,0,0,0,0,0,0,0,0,0,0,0,0,0,0,0
2151,CHANDIGARH,2014,6,DRUG ABUSE,0,1,0,0,0,1,0,0,0,0,0,0,0,0,0,0,0,0,1
2697,CHANDIGARH,2014,6,ECONOMIC ISSUES,0,8,0,0,0,8,0,5,1,0,0,6,0,0,0,0,0,0,14
3243,CHANDIGARH,2014,6,EXAM FAILURE,0,3,0,0,0,3,0,2,0,0,0,2,0,0,0,0,0,0,5
3789,CHANDIGARH,2014,6,FAMILY PROBLEMS,0,0,10,0,0,10,0,0,0,0,0,0,0,0,0,0,0,0,10
4335,CHANDIGARH,2014,6,HEALTH ISSUES,0,0,14,0,0,14,0,0,4,6,0,10,0,0,0,0,0,0,24
4880,CHANDIGARH,2014,6,HERO WORSHIP,0,0,0,0,0,0,0,0,0,0,0,0,0,0,0,0,0,0,0
5425,CHANDIGARH,2014,6,ILLEGITIMATE PREGNANCY,0,0,0,0,0,0,0,0,0,0,0,0,0,0,0,0,0,0,0
5970,CHANDIGARH,2014,6,LOVE AFFAIRS,0,10,0,0,0,10,0,11,0,0,0,11,0,0,0,0,0,0,21
6516,CHANDIGARH,2014,6,MARITAL ISSUES,0,0,0,0,0,0,0,0,0,0,0,0,0,0,0,0,0,0,0
7062,CHANDIGARH,2014,6,MENTAL HEALTH,0,0,0,0,0,0,0,0,0,0,0,0,0,0,0,0,0,0,0
7608,CHANDIGARH,2014,6,OTHERS,0,3,3,5,0,11,0,5,0,0,0,5,0,0,0,0,0,0,16
7647,CHANDIGARH,2014,6,PHYSICAL ABUSE,0,0,0,0,0,0,0,0,0,0,0,0,0,0,0,0,0,0,0
8699,CHANDIGARH,2014,6,SOCIETAL ISSUES,0,0,0,0,0,0,0,0,0,0,0,0,0,0,0,0,0,0,0
7,CHHATTISGARH,2001,7,CAUSES NOT KNOWN,17,227,272,178,84,778,13,176,119,67,27,402,0,0,0,0,0,0,1180
553,CHHATTISGARH,2001,7,DEATH OF DEAR PERSON,0,1,3,1,0,5,0,3,0,2,0,5,0,0,0,0,0,0,10
1099,CHHATTISGARH,2001,7,DOWRY DISPUTE,0,8,8,0,0,16,0,33,12,0,0,45,0,0,0,0,0,0,61
1645,CHHATTISGARH,2001,7,DRUG ABUSE,1,11,39,15,3,69,0,8,3,3,0,14,0,0,0,0,0,0,83
2191,CHHATTISGARH,2001,7,ECONOMIC ISSUES,1,32,56,36,13,138,0,7,8,1,2,18,0,0,0,0,0,0,156
2737,CHHATTISGARH,2001,7,EXAM FAILURE,2,34,5,0,0,41,8,13,1,0,0,22,0,0,0,0,0,0,63
3283,CHHATTISGARH,2001,7,FAMILY PROBLEMS,4,78,126,69,20,297,5,68,81,29,5,188,0,0,0,0,0,0,485
3829,CHHATTISGARH,2001,7,HEALTH ISSUES,3,94,126,114,83,420,2,50,63,44,23,182,0,0,0,0,0,0,602
4375,CHHATTISGARH,2001,7,HERO WORSHIP,0,0,0,0,0,0,0,0,0,1,0,1,0,0,0,0,0,0,1
4920,CHHATTISGARH,2001,7,ILLEGITIMATE PREGNANCY,0,0,0,0,0,0,0,7,2,0,0,9,0,0,0,0,0,0,9
5465,CHHATTISGARH,2001,7,LOVE AFFAIRS,0,41,19,6,0,66,4,49,15,4,0,72,0,0,0,0,0,0,138
6010,CHHATTISGARH,2001,7,MARITAL ISSUES,0,27,23,2,3,55,5,38,20,3,1,67,0,0,0,0,0,0,122
6556,CHHATTISGARH,2001,7,MENTAL HEALTH,1,53,59,35,19,167,0,28,22,11,5,66,0,0,0,0,0,0,233
7102,CHHATTISGARH,2001,7,OTHERS,15,170,203,95,57,540,12,142,62,27,28,271,0,0,0,0,0,0,811
7687,CHHATTISGARH,2001,7,"PHYSICAL ABUSE (RAPE,INCEST ETC.)",0,4,3,1,1,9,0,6,5,1,0,12,0,0,0,0,0,0,21
8193,CHHATTISGARH,2001,7,SOCIETAL ISSUES,0,12,13,11,3,39,0,6,5,0,0,11,0,0,0,0,0,0,50
46,CHHATTISGARH,2002,7,CAUSES NOT KNOWN,31,227,337,240,68,903,15,133,132,74,26,380,0,0,0,0,0,0,1283
592,CHHATTISGARH,2002,7,DEATH OF DEAR PERSON,0,6,6,3,1,16,0,8,3,0,0,11,0,0,0,0,0,0,27
1138,CHHATTISGARH,2002,7,DOWRY DISPUTE,0,1,0,0,0,1,1,46,3,0,0,50,0,0,0,0,0,0,51
1684,CHHATTISGARH,2002,7,DRUG ABUSE,0,10,16,17,1,44,0,2,0,1,0,3,0,0,0,0,0,0,47
2230,CHHATTISGARH,2002,7,ECONOMIC ISSUES,3,20,41,21,2,87,0,2,5,2,0,9,0,0,0,0,0,0,96
2776,CHHATTISGARH,2002,7,EXAM FAILURE,1,30,0,0,0,31,0,16,0,0,0,16,0,0,0,0,0,0,47
3322,CHHATTISGARH,2002,7,FAMILY PROBLEMS,4,113,97,69,16,299,3,86,65,20,3,177,0,0,0,0,0,0,476
3868,CHHATTISGARH,2002,7,HEALTH ISSUES,4,100,145,112,65,426,5,68,73,39,23,208,0,0,0,0,0,0,634
4414,CHHATTISGARH,2002,7,HERO WORSHIP,0,0,1,0,0,1,0,3,0,0,0,3,0,0,0,0,0,0,4
4959,CHHATTISGARH,2002,7,ILLEGITIMATE PREGNANCY,0,3,0,0,0,3,0,9,1,0,0,10,0,0,0,0,0,0,13
5504,CHHATTISGARH,2002,7,LOVE AFFAIRS,0,42,9,1,0,52,3,37,6,2,0,48,0,0,0,0,0,0,100
6049,CHHATTISGARH,2002,7,MARITAL ISSUES,0,16,9,4,0,29,0,30,13,0,1,44,0,0,0,0,0,0,73
6595,CHHATTISGARH,2002,7,MENTAL HEALTH,0,61,71,27,8,167,1,24,24,11,6,66,0,0,0,0,0,0,233
7141,CHHATTISGARH,2002,7,OTHERS,42,157,176,107,52,534,34,113,74,30,14,265,0,0,0,0,0,0,799
7726,CHHATTISGARH,2002,7,"PHYSICAL ABUSE (RAPE,INCEST ETC.)",0,4,1,0,0,5,0,6,3,1,0,10,0,0,0,0,0,0,15
8232,CHHATTISGARH,2002,7,SOCIETAL ISSUES,0,4,19,5,3,31,0,11,8,2,0,21,0,0,0,0,0,0,52
85,CHHATTISGARH,2003,7,CAUSES NOT KNOWN,28,260,259,139,33,719,30,170,96,49,9,354,0,0,0,0,0,0,1073
631,CHHATTISGARH,2003,7,DEATH OF DEAR PERSON,4,17,22,24,14,81,2,8,7,5,5,27,0,0,0,0,0,0,108
1177,CHHATTISGARH,2003,7,DOWRY DISPUTE,0,0,0,0,0,0,0,37,9,0,0,46,0,0,0,0,0,0,46
1723,CHHATTISGARH,2003,7,DRUG ABUSE,1,26,34,24,2,87,0,0,4,7,0,11,0,0,0,0,0,0,98
2269,CHHATTISGARH,2003,7,ECONOMIC ISSUES,0,29,34,17,3,83,3,5,10,4,3,25,0,0,0,0,0,0,108
2815,CHHATTISGARH,2003,7,EXAM FAILURE,4,15,4,0,0,23,2,15,1,0,0,18,0,0,0,0,0,0,41
3361,CHHATTISGARH,2003,7,FAMILY PROBLEMS,4,92,93,59,29,277,10,117,58,22,13,220,0,0,0,0,0,0,497
3907,CHHATTISGARH,2003,7,HEALTH ISSUES,6,75,69,94,49,293,10,48,37,20,9,124,0,0,0,0,0,0,417
4453,CHHATTISGARH,2003,7,HERO WORSHIP,0,0,0,0,0,0,0,0,0,1,0,1,0,0,0,0,0,0,1
4998,CHHATTISGARH,2003,7,ILLEGITIMATE PREGNANCY,0,0,0,0,0,0,0,5,2,2,0,9,0,0,0,0,0,0,9
5543,CHHATTISGARH,2003,7,LOVE AFFAIRS,3,33,14,1,0,51,5,22,10,1,0,38,0,0,0,0,0,0,89
6088,CHHATTISGARH,2003,7,MARITAL ISSUES,0,10,9,0,1,20,0,22,10,2,1,35,0,0,0,0,0,0,55
6634,CHHATTISGARH,2003,7,MENTAL HEALTH,1,37,62,35,9,144,4,17,19,11,4,55,0,0,0,0,0,0,199
7180,CHHATTISGARH,2003,7,OTHERS,50,246,273,156,70,795,38,151,107,37,21,354,0,0,0,0,0,0,1149
7765,CHHATTISGARH,2003,7,"PHYSICAL ABUSE (RAPE,INCEST ETC.)",2,0,1,0,0,3,1,2,1,0,0,4,0,0,0,0,0,0,7
8271,CHHATTISGARH,2003,7,SOCIETAL ISSUES,0,6,4,5,1,16,1,3,2,0,0,6,0,0,0,0,0,0,22
124,CHHATTISGARH,2004,7,CAUSES NOT KNOWN,15,222,334,271,100,942,20,164,138,88,31,441,0,0,0,0,0,0,1383
670,CHHATTISGARH,2004,7,DEATH OF DEAR PERSON,0,1,4,4,2,11,0,2,1,2,1,6,0,0,0,0,0,0,17
1216,CHHATTISGARH,2004,7,DOWRY DISPUTE,0,2,1,1,0,4,0,41,10,2,0,53,0,0,0,0,0,0,57
1762,CHHATTISGARH,2004,7,DRUG ABUSE,0,14,17,7,1,39,0,0,0,2,1,3,0,0,0,0,0,0,42
2308,CHHATTISGARH,2004,7,ECONOMIC ISSUES,0,30,38,14,3,85,1,2,6,2,0,11,0,0,0,0,0,0,96
2854,CHHATTISGARH,2004,7,EXAM FAILURE,3,22,4,0,0,29,3,13,1,0,0,17,0,0,0,0,0,0,46
3400,CHHATTISGARH,2004,7,FAMILY PROBLEMS,4,133,171,114,30,452,2,125,79,33,6,245,0,0,0,0,0,0,697
3946,CHHATTISGARH,2004,7,HEALTH ISSUES,0,94,115,107,65,381,4,78,60,38,20,200,0,0,0,0,0,0,581
4492,CHHATTISGARH,2004,7,HERO WORSHIP,0,0,0,0,0,0,0,0,0,0,0,0,0,0,0,0,0,0,0
5037,CHHATTISGARH,2004,7,ILLEGITIMATE PREGNANCY,0,0,0,0,0,0,0,2,1,0,0,3,0,0,0,0,0,0,3
5582,CHHATTISGARH,2004,7,LOVE AFFAIRS,0,49,14,2,0,65,1,41,9,1,0,52,0,0,0,0,0,0,117
6127,CHHATTISGARH,2004,7,MARITAL ISSUES,0,17,10,3,0,30,0,26,12,3,0,41,0,0,0,0,0,0,71
6673,CHHATTISGARH,2004,7,MENTAL HEALTH,3,56,79,30,12,180,5,26,23,10,2,66,0,0,0,0,0,0,246
7219,CHHATTISGARH,2004,7,OTHERS,52,232,265,149,52,750,56,127,116,44,17,360,0,0,0,0,0,0,1110
7804,CHHATTISGARH,2004,7,"PHYSICAL ABUSE (RAPE,INCEST ETC.)",0,1,3,0,0,4,0,4,4,0,0,8,0,0,0,0,0,0,12
8310,CHHATTISGARH,2004,7,SOCIETAL ISSUES,0,6,2,5,1,14,0,3,0,0,0,3,0,0,0,0,0,0,17
163,CHHATTISGARH,2005,7,CAUSES NOT KNOWN,28,364,362,149,42,945,18,215,130,37,18,418,0,0,0,0,0,0,1363
709,CHHATTISGARH,2005,7,DEATH OF DEAR PERSON,1,2,8,6,1,18,4,4,4,3,0,15,0,0,0,0,0,0,33
1255,CHHATTISGARH,2005,7,DOWRY DISPUTE,0,1,2,0,0,3,0,55,6,1,1,63,0,0,0,0,0,0,66
1801,CHHATTISGARH,2005,7,DRUG ABUSE,2,16,45,31,15,109,1,5,7,5,6,24,0,0,0,0,0,0,133
2347,CHHATTISGARH,2005,7,ECONOMIC ISSUES,0,27,35,21,6,89,1,4,2,4,1,12,0,0,0,0,0,0,101
2893,CHHATTISGARH,2005,7,EXAM FAILURE,5,19,0,0,0,24,0,11,1,0,0,12,0,0,0,0,0,0,36
3439,CHHATTISGARH,2005,7,FAMILY PROBLEMS,9,115,112,99,19,354,3,158,90,32,5,288,0,0,0,0,0,0,642
3985,CHHATTISGARH,2005,7,HEALTH ISSUES,14,114,142,107,64,441,7,60,60,37,21,185,0,0,0,0,0,0,626
4531,CHHATTISGARH,2005,7,HERO WORSHIP,0,2,3,1,0,6,0,3,1,0,0,4,0,0,0,0,0,0,10
5076,CHHATTISGARH,2005,7,ILLEGITIMATE PREGNANCY,1,1,2,0,0,4,0,2,0,0,0,2,0,0,0,0,0,0,6
5621,CHHATTISGARH,2005,7,LOVE AFFAIRS,0,34,12,1,0,47,1,28,3,0,0,32,0,0,0,0,0,0,79
6166,CHHATTISGARH,2005,7,MARITAL ISSUES,12,33,32,9,0,86,5,33,15,4,0,57,0,0,0,0,0,0,143
6712,CHHATTISGARH,2005,7,MENTAL HEALTH,2,57,94,56,11,220,2,37,27,17,5,88,0,0,0,0,0,0,308
7258,CHHATTISGARH,2005,7,OTHERS,82,270,311,188,74,925,30,119,115,68,29,361,0,0,0,0,0,0,1286
7843,CHHATTISGARH,2005,7,"PHYSICAL ABUSE (RAPE,INCEST ETC.)",1,2,4,3,1,11,0,3,2,0,0,5,0,0,0,0,0,0,16
8349,CHHATTISGARH,2005,7,SOCIETAL ISSUES,3,5,10,5,0,23,1,5,2,1,1,10,0,0,0,0,0,0,33
202,CHHATTISGARH,2006,7,CAUSES NOT KNOWN,57,433,407,191,55,1143,50,252,138,52,23,515,0,0,0,0,0,0,1658
748,CHHATTISGARH,2006,7,DEATH OF DEAR PERSON,0,2,3,2,0,7,1,3,0,0,0,4,0,0,0,0,0,0,11
1294,CHHATTISGARH,2006,7,DOWRY DISPUTE,0,0,0,0,0,0,0,42,8,2,1,53,0,0,0,0,0,0,53
1840,CHHATTISGARH,2006,7,DRUG ABUSE,0,20,49,22,9,100,0,0,5,5,3,13,0,0,0,0,0,0,113
2386,CHHATTISGARH,2006,7,ECONOMIC ISSUES,2,30,42,15,3,92,0,7,7,6,2,22,0,0,0,0,0,0,114
2932,CHHATTISGARH,2006,7,EXAM FAILURE,6,19,0,0,0,25,4,9,0,0,0,13,0,0,0,0,0,0,38
3478,CHHATTISGARH,2006,7,FAMILY PROBLEMS,3,121,160,74,20,378,5,170,102,28,3,308,0,0,0,0,0,0,686
4024,CHHATTISGARH,2006,7,HEALTH ISSUES,4,97,114,120,68,403,7,65,53,41,19,185,0,0,0,0,0,0,588
4570,CHHATTISGARH,2006,7,HERO WORSHIP,0,0,0,0,0,0,0,0,0,0,0,0,0,0,0,0,0,0,0
5115,CHHATTISGARH,2006,7,ILLEGITIMATE PREGNANCY,0,0,0,0,0,0,0,7,0,0,0,7,0,0,0,0,0,0,7
5660,CHHATTISGARH,2006,7,LOVE AFFAIRS,3,38,11,2,0,54,3,32,7,1,0,43,0,0,0,0,0,0,97
6205,CHHATTISGARH,2006,7,MARITAL ISSUES,0,15,9,3,2,29,0,14,6,0,0,20,0,0,0,0,0,0,49
6751,CHHATTISGARH,2006,7,MENTAL HEALTH,2,44,80,25,4,155,1,30,29,12,7,79,0,0,0,0,0,0,234
7297,CHHATTISGARH,2006,7,OTHERS,35,245,195,131,44,650,24,125,67,39,20,275,0,0,0,0,0,0,925
7882,CHHATTISGARH,2006,7,"PHYSICAL ABUSE (RAPE,INCEST ETC.)",0,1,3,2,0,6,1,16,3,1,1,22,0,0,0,0,0,0,28
8388,CHHATTISGARH,2006,7,SOCIETAL ISSUES,0,2,12,3,1,18,0,3,3,1,0,7,0,0,0,0,0,0,25
241,CHHATTISGARH,2007,7,CAUSES NOT KNOWN,19,338,411,274,104,1146,23,226,163,87,23,522,0,0,0,0,0,0,1668
787,CHHATTISGARH,2007,7,DEATH OF DEAR PERSON,0,1,4,2,0,7,0,1,1,3,0,5,0,0,0,0,0,0,12
1333,CHHATTISGARH,2007,7,DOWRY DISPUTE,0,1,0,0,0,1,0,27,4,0,0,31,0,0,0,0,0,0,32
1879,CHHATTISGARH,2007,7,DRUG ABUSE,0,28,48,30,10,116,0,0,4,3,1,8,0,0,0,0,0,0,124
2425,CHHATTISGARH,2007,7,ECONOMIC ISSUES,0,67,37,22,4,130,2,9,10,2,0,23,0,0,0,0,0,0,153
2971,CHHATTISGARH,2007,7,EXAM FAILURE,3,22,0,0,0,25,2,14,0,0,0,16,0,0,0,0,0,0,41
3517,CHHATTISGARH,2007,7,FAMILY PROBLEMS,6,115,145,85,27,378,2,146,95,28,3,274,0,0,0,0,0,0,652
4063,CHHATTISGARH,2007,7,HEALTH ISSUES,3,97,95,88,84,367,3,68,44,45,20,180,0,0,0,0,0,0,547
4608,CHHATTISGARH,2007,7,HERO WORSHIP,0,1,2,0,0,3,0,0,0,0,0,0,0,0,0,0,0,0,3
5153,CHHATTISGARH,2007,7,ILLEGITIMATE PREGNANCY,0,0,0,0,0,0,1,0,3,0,0,4,0,0,0,0,0,0,4
5698,CHHATTISGARH,2007,7,LOVE AFFAIRS,1,35,15,0,0,51,3,41,11,0,0,55,0,0,0,0,0,0,106
6244,CHHATTISGARH,2007,7,MARITAL ISSUES,0,12,5,0,0,17,1,28,16,1,0,46,0,0,0,0,0,0,63
6790,CHHATTISGARH,2007,7,MENTAL HEALTH,2,54,54,32,13,155,1,18,22,14,5,60,0,0,0,0,0,0,215
7336,CHHATTISGARH,2007,7,OTHERS,44,271,278,152,76,821,21,131,90,46,32,320,0,0,0,0,0,0,1141
7920,CHHATTISGARH,2007,7,"PHYSICAL ABUSE (RAPE,INCEST ETC.)",0,4,5,1,0,10,0,20,7,3,1,31,0,0,0,0,0,0,41
8427,CHHATTISGARH,2007,7,SOCIETAL ISSUES,0,1,24,2,2,29,0,2,6,0,0,8,0,0,0,0,0,0,37
280,CHHATTISGARH,2008,7,CAUSES NOT KNOWN,37,375,415,195,47,1069,42,268,145,68,21,544,0,0,0,0,0,0,1613
826,CHHATTISGARH,2008,7,DEATH OF DEAR PERSON,0,5,10,5,4,24,0,8,3,3,0,14,0,0,0,0,0,0,38
1372,CHHATTISGARH,2008,7,DOWRY DISPUTE,1,0,0,0,0,1,1,49,9,0,0,59,0,0,0,0,0,0,60
1918,CHHATTISGARH,2008,7,DRUG ABUSE,0,44,57,43,13,157,0,1,3,4,0,8,0,0,0,0,0,0,165
2464,CHHATTISGARH,2008,7,ECONOMIC ISSUES,0,45,40,24,3,112,0,2,3,2,0,7,0,0,0,0,0,0,119
3010,CHHATTISGARH,2008,7,EXAM FAILURE,5,25,1,0,0,31,3,19,0,0,0,22,0,0,0,0,0,0,53
3556,CHHATTISGARH,2008,7,FAMILY PROBLEMS,4,201,237,121,45,608,4,191,109,39,9,352,0,0,0,0,0,0,960
4102,CHHATTISGARH,2008,7,HEALTH ISSUES,2,110,131,112,64,419,10,85,86,37,20,238,0,0,0,0,0,0,657
4647,CHHATTISGARH,2008,7,HERO WORSHIP,0,0,0,0,0,0,0,0,0,0,0,0,0,0,0,0,0,0,0
5192,CHHATTISGARH,2008,7,ILLEGITIMATE PREGNANCY,0,0,0,0,0,0,0,4,0,0,0,4,0,0,0,0,0,0,4
5737,CHHATTISGARH,2008,7,LOVE AFFAIRS,1,63,11,3,0,78,3,49,11,2,0,65,0,0,0,0,0,0,143
6283,CHHATTISGARH,2008,7,MARITAL ISSUES,0,13,8,0,0,21,0,19,8,3,0,30,0,0,0,0,0,0,51
6829,CHHATTISGARH,2008,7,MENTAL HEALTH,0,80,62,33,10,185,3,31,19,12,8,73,0,0,0,0,0,0,258
7375,CHHATTISGARH,2008,7,OTHERS,15,157,169,138,30,509,16,89,65,43,7,220,0,0,0,0,0,0,729
7959,CHHATTISGARH,2008,7,"PHYSICAL ABUSE (RAPE,INCEST ETC.)",0,1,4,2,0,7,0,32,13,3,0,48,0,0,0,0,0,0,55
8466,CHHATTISGARH,2008,7,SOCIETAL ISSUES,0,6,11,9,1,27,0,7,4,2,0,13,0,0,0,0,0,0,40
319,CHHATTISGARH,2009,7,CAUSES NOT KNOWN,21,371,412,331,131,1266,13,295,205,104,33,650,0,0,0,0,0,0,1916
865,CHHATTISGARH,2009,7,DEATH OF DEAR PERSON,0,1,2,1,0,4,1,13,1,2,1,18,0,0,0,0,0,0,22
1411,CHHATTISGARH,2009,7,DOWRY DISPUTE,0,0,0,1,0,1,0,47,11,0,0,58,0,0,0,0,0,0,59
1957,CHHATTISGARH,2009,7,DRUG ABUSE,0,39,76,41,12,168,0,1,7,4,2,14,0,0,0,0,0,0,182
2503,CHHATTISGARH,2009,7,ECONOMIC ISSUES,0,26,42,19,3,90,0,2,5,3,1,11,0,0,0,0,0,0,101
3049,CHHATTISGARH,2009,7,EXAM FAILURE,1,23,0,0,0,24,3,14,2,0,0,19,0,0,0,0,0,0,43
3595,CHHATTISGARH,2009,7,FAMILY PROBLEMS,3,139,140,73,14,369,6,143,91,28,7,275,0,0,0,0,0,0,644
4141,CHHATTISGARH,2009,7,HEALTH ISSUES,2,119,158,154,71,504,6,82,85,48,24,245,0,0,0,0,0,0,749
4686,CHHATTISGARH,2009,7,HERO WORSHIP,0,0,0,0,0,0,0,1,0,0,0,1,0,0,0,0,0,0,1
5231,CHHATTISGARH,2009,7,ILLEGITIMATE PREGNANCY,0,0,0,0,0,0,0,1,0,0,0,1,0,0,0,0,0,0,1
5776,CHHATTISGARH,2009,7,LOVE AFFAIRS,1,40,16,0,0,57,1,19,6,1,0,27,0,0,0,0,0,0,84
6322,CHHATTISGARH,2009,7,MARITAL ISSUES,0,20,9,6,0,35,0,16,8,8,0,32,0,0,0,0,0,0,67
6868,CHHATTISGARH,2009,7,MENTAL HEALTH,8,52,58,37,10,165,5,40,27,12,2,86,0,0,0,0,0,0,251
7414,CHHATTISGARH,2009,7,OTHERS,68,372,402,258,99,1199,38,140,120,75,28,401,0,0,0,0,0,0,1600
7998,CHHATTISGARH,2009,7,"PHYSICAL ABUSE (RAPE,INCEST ETC.)",0,4,0,3,3,10,1,42,6,2,2,53,0,0,0,0,0,0,63
8505,CHHATTISGARH,2009,7,SOCIETAL ISSUES,0,19,27,13,3,62,2,17,13,4,2,38,0,0,0,0,0,0,100
358,CHHATTISGARH,2010,7,CAUSES NOT KNOWN,41,492,563,433,171,1700,21,279,260,113,48,721,0,0,0,0,0,0,2421
904,CHHATTISGARH,2010,7,DEATH OF DEAR PERSON,0,2,2,3,0,7,0,0,4,1,0,5,0,0,0,0,0,0,12
1450,CHHATTISGARH,2010,7,DOWRY DISPUTE,0,0,0,0,0,0,0,54,16,0,0,70,0,0,0,0,0,0,70
1996,CHHATTISGARH,2010,7,DRUG ABUSE,1,43,89,46,9,188,0,5,5,3,2,15,0,0,0,0,0,0,203
2542,CHHATTISGARH,2010,7,ECONOMIC ISSUES,0,32,49,17,9,107,0,2,12,2,1,17,0,0,0,0,0,0,124
3088,CHHATTISGARH,2010,7,EXAM FAILURE,2,24,0,0,0,26,1,18,0,0,0,19,0,0,0,0,0,0,45
3634,CHHATTISGARH,2010,7,FAMILY PROBLEMS,6,171,172,115,26,490,4,154,96,33,8,295,0,0,0,0,0,0,785
4180,CHHATTISGARH,2010,7,HEALTH ISSUES,4,121,123,147,95,490,2,65,61,51,25,204,0,0,0,0,0,0,694
4725,CHHATTISGARH,2010,7,HERO WORSHIP,0,0,0,0,1,1,0,0,0,0,0,0,0,0,0,0,0,0,1
5270,CHHATTISGARH,2010,7,ILLEGITIMATE PREGNANCY,0,0,0,0,0,0,0,2,0,0,0,2,0,0,0,0,0,0,2
5815,CHHATTISGARH,2010,7,LOVE AFFAIRS,1,48,10,3,0,62,2,42,8,0,0,52,0,0,0,0,0,0,114
6361,CHHATTISGARH,2010,7,MARITAL ISSUES,0,7,18,4,0,29,0,27,14,1,0,42,0,0,0,0,0,0,71
6907,CHHATTISGARH,2010,7,MENTAL HEALTH,3,61,75,48,19,206,3,21,22,7,5,58,0,0,0,0,0,0,264
7453,CHHATTISGARH,2010,7,OTHERS,51,375,417,276,81,1200,23,171,132,65,26,417,0,0,0,0,0,0,1617
8037,CHHATTISGARH,2010,7,"PHYSICAL ABUSE (RAPE,INCEST ETC.)",1,3,9,3,0,16,2,20,11,15,2,50,0,0,0,0,0,0,66
8544,CHHATTISGARH,2010,7,SOCIETAL ISSUES,0,5,11,7,0,23,0,2,6,1,1,10,0,0,0,0,0,0,33
397,CHHATTISGARH,2011,7,CAUSES NOT KNOWN,32,356,414,334,111,1247,22,261,198,108,44,633,0,0,0,0,0,0,1880
943,CHHATTISGARH,2011,7,DEATH OF DEAR PERSON,0,2,4,7,2,15,0,9,4,3,1,17,0,0,0,0,0,0,32
1489,CHHATTISGARH,2011,7,DOWRY DISPUTE,0,0,0,0,0,0,0,44,12,0,0,56,0,0,0,0,0,0,56
2035,CHHATTISGARH,2011,7,DRUG ABUSE,1,57,95,77,11,241,0,3,7,12,2,24,0,0,0,0,0,0,265
2581,CHHATTISGARH,2011,7,ECONOMIC ISSUES,0,32,28,20,4,84,0,2,1,3,0,6,0,0,0,0,0,0,90
3127,CHHATTISGARH,2011,7,EXAM FAILURE,3,30,5,3,0,41,3,36,4,0,0,43,0,0,0,0,0,0,84
3673,CHHATTISGARH,2011,7,FAMILY PROBLEMS,4,149,180,104,26,463,4,148,86,53,10,301,0,0,0,0,0,0,764
4219,CHHATTISGARH,2011,7,HEALTH ISSUES,6,94,128,119,91,438,3,56,64,57,30,210,0,0,0,0,0,0,648
4764,CHHATTISGARH,2011,7,HERO WORSHIP,0,0,0,0,0,0,0,0,0,0,0,0,0,0,0,0,0,0,0
5309,CHHATTISGARH,2011,7,ILLEGITIMATE PREGNANCY,0,0,0,0,0,0,0,2,1,0,0,3,0,0,0,0,0,0,3
5854,CHHATTISGARH,2011,7,LOVE AFFAIRS,0,56,23,3,0,82,1,54,8,0,0,63,0,0,0,0,0,0,145
6400,CHHATTISGARH,2011,7,MARITAL ISSUES,0,20,23,3,1,47,0,30,12,3,0,45,0,0,0,0,0,0,92
6946,CHHATTISGARH,2011,7,MENTAL HEALTH,0,61,89,40,19,209,2,37,26,8,8,81,0,0,0,0,0,0,290
7492,CHHATTISGARH,2011,7,OTHERS,56,557,505,364,150,1632,50,289,201,127,46,713,0,0,0,0,0,0,2345
8076,CHHATTISGARH,2011,7,"PHYSICAL ABUSE (RAPE,INCEST ETC.)",0,6,0,1,0,7,0,13,8,0,0,21,0,0,0,0,0,0,28
8583,CHHATTISGARH,2011,7,SOCIETAL ISSUES,0,8,7,6,0,21,1,4,6,2,0,13,0,0,0,0,0,0,34
436,CHHATTISGARH,2012,7,CAUSES NOT KNOWN,23,412,432,310,88,1265,27,199,150,74,38,488,0,0,0,0,0,0,1753
982,CHHATTISGARH,2012,7,DEATH OF DEAR PERSON,0,5,3,3,1,12,0,4,1,2,0,7,0,0,0,0,0,0,19
1528,CHHATTISGARH,2012,7,DOWRY DISPUTE,0,0,0,0,0,0,0,37,1,0,0,38,0,0,0,0,0,0,38
2074,CHHATTISGARH,2012,7,DRUG ABUSE,0,54,90,43,17,204,0,6,16,12,2,36,0,0,0,0,0,0,240
2620,CHHATTISGARH,2012,7,ECONOMIC ISSUES,0,20,24,17,4,65,0,3,0,0,0,3,0,0,0,0,0,0,68
3166,CHHATTISGARH,2012,7,EXAM FAILURE,0,26,0,0,0,26,4,24,2,0,0,30,0,0,0,0,0,0,56
3712,CHHATTISGARH,2012,7,FAMILY PROBLEMS,8,157,214,110,32,521,8,119,82,36,12,257,0,0,0,0,0,0,778
4258,CHHATTISGARH,2012,7,HEALTH ISSUES,1,60,121,119,55,356,3,61,60,33,21,178,0,0,0,0,0,0,534
4803,CHHATTISGARH,2012,7,HERO WORSHIP,0,2,0,0,0,2,0,0,0,0,0,0,0,0,0,0,0,0,2
5348,CHHATTISGARH,2012,7,ILLEGITIMATE PREGNANCY,0,0,0,0,0,0,0,0,0,0,0,0,0,0,0,0,0,0,0
5893,CHHATTISGARH,2012,7,LOVE AFFAIRS,0,46,6,1,0,53,1,37,3,0,0,41,0,0,0,0,0,0,94
6439,CHHATTISGARH,2012,7,MARITAL ISSUES,0,13,4,3,0,20,0,13,9,0,0,22,0,0,0,0,0,0,42
6985,CHHATTISGARH,2012,7,MENTAL HEALTH,1,53,60,39,11,164,2,32,21,15,7,77,0,0,0,0,0,0,241
7531,CHHATTISGARH,2012,7,OTHERS,50,451,437,272,105,1315,33,221,94,59,40,447,0,0,0,0,0,0,1762
8115,CHHATTISGARH,2012,7,"PHYSICAL ABUSE (RAPE,INCEST ETC.)",0,2,1,0,0,3,0,10,3,1,1,15,0,0,0,0,0,0,18
8622,CHHATTISGARH,2012,7,SOCIETAL ISSUES,0,3,2,2,1,8,0,0,1,0,0,1,0,0,0,0,0,0,9
475,CHHATTISGARH,2013,7,CAUSES NOT KNOWN,52,505,489,236,101,1383,42,319,179,78,41,659,0,0,0,0,0,0,2042
1021,CHHATTISGARH,2013,7,DEATH OF DEAR PERSON,0,4,2,2,1,9,0,1,4,1,0,6,0,0,0,0,0,0,15
1567,CHHATTISGARH,2013,7,DOWRY DISPUTE,0,2,0,0,0,2,0,44,1,0,0,45,0,0,0,0,0,0,47
2113,CHHATTISGARH,2013,7,DRUG ABUSE,2,73,80,39,11,205,1,3,4,4,0,12,0,0,0,0,0,0,217
2659,CHHATTISGARH,2013,7,ECONOMIC ISSUES,0,13,31,10,0,54,0,4,0,5,1,10,0,0,0,0,0,0,64
3205,CHHATTISGARH,2013,7,EXAM FAILURE,6,17,2,0,0,25,2,29,0,0,0,31,0,0,0,0,0,0,56
3751,CHHATTISGARH,2013,7,FAMILY PROBLEMS,3,128,186,81,26,424,9,139,89,51,15,303,0,0,0,0,0,0,727
4297,CHHATTISGARH,2013,7,HEALTH ISSUES,3,89,108,89,54,343,18,44,44,34,27,167,0,0,0,0,0,0,510
4842,CHHATTISGARH,2013,7,HERO WORSHIP,2,7,11,4,2,26,0,10,1,1,0,12,0,0,0,0,0,0,38
5387,CHHATTISGARH,2013,7,ILLEGITIMATE PREGNANCY,0,0,0,0,0,0,0,1,0,0,0,1,0,0,0,0,0,0,1
5932,CHHATTISGARH,2013,7,LOVE AFFAIRS,1,44,5,12,0,62,3,30,2,4,0,39,0,0,0,0,0,0,101
6478,CHHATTISGARH,2013,7,MARITAL ISSUES,0,12,7,2,1,22,1,14,8,2,0,25,0,0,0,0,0,0,47
7024,CHHATTISGARH,2013,7,MENTAL HEALTH,2,71,57,33,16,179,0,27,20,10,12,69,0,0,0,0,0,0,248
7570,CHHATTISGARH,2013,7,OTHERS,11,330,294,183,77,895,15,186,101,58,26,386,0,0,0,0,0,0,1281
8154,CHHATTISGARH,2013,7,"PHYSICAL ABUSE (RAPE,INCEST ETC.)",0,1,2,0,0,3,1,9,4,0,0,14,0,0,0,0,0,0,17
8661,CHHATTISGARH,2013,7,SOCIETAL ISSUES,0,5,3,6,2,16,0,5,2,2,0,9,0,0,0,0,0,0,25
514,CHHATTISGARH,2014,7,CAUSES NOT KNOWN,13,362,315,160,52,902,12,255,109,45,12,433,0,0,0,0,0,0,1335
1060,CHHATTISGARH,2014,7,DEATH OF DEAR PERSON,0,3,3,13,0,19,0,2,2,1,2,7,0,0,0,0,0,0,26
1606,CHHATTISGARH,2014,7,DOWRY DISPUTE,0,2,2,4,1,9,0,88,18,10,11,127,0,0,0,0,0,0,136
2152,CHHATTISGARH,2014,7,DRUG ABUSE,0,43,32,18,4,97,0,2,0,0,0,2,0,0,0,0,0,0,99
2698,CHHATTISGARH,2014,7,ECONOMIC ISSUES,0,18,11,7,0,36,0,3,4,0,0,7,0,0,0,0,0,0,43
3244,CHHATTISGARH,2014,7,EXAM FAILURE,11,38,0,0,0,49,7,37,0,0,0,44,0,0,0,0,0,0,93
3790,CHHATTISGARH,2014,7,FAMILY PROBLEMS,3,173,210,137,21,544,3,160,93,33,18,307,0,0,0,0,0,0,851
4336,CHHATTISGARH,2014,7,HEALTH ISSUES,0,265,306,325,116,1012,5,167,139,135,56,502,0,0,0,0,0,0,1514
4881,CHHATTISGARH,2014,7,HERO WORSHIP,0,0,0,0,0,0,0,0,0,0,0,0,0,0,0,0,0,0,0
5426,CHHATTISGARH,2014,7,ILLEGITIMATE PREGNANCY,0,0,0,0,0,0,0,1,0,0,0,1,0,0,0,0,0,0,1
5971,CHHATTISGARH,2014,7,LOVE AFFAIRS,0,92,26,1,0,119,2,40,3,1,0,46,0,0,0,0,0,0,165
6517,CHHATTISGARH,2014,7,MARITAL ISSUES,6,66,41,20,8,141,1,194,72,21,14,302,0,0,0,0,0,0,443
7063,CHHATTISGARH,2014,7,MENTAL HEALTH,0,89,68,65,18,240,3,35,25,29,10,102,0,0,0,0,0,0,342
7609,CHHATTISGARH,2014,7,OTHERS,26,525,419,220,102,1292,15,287,134,67,36,539,0,0,0,0,0,0,1831
7648,CHHATTISGARH,2014,7,PHYSICAL ABUSE,0,0,0,0,0,0,0,1,0,0,0,1,0,0,0,0,0,0,1
8700,CHHATTISGARH,2014,7,SOCIETAL ISSUES,0,1,1,3,0,5,0,1,0,0,0,1,0,0,0,0,0,0,6
8,D & N HAVELI,2001,8,CAUSES NOT KNOWN,0,2,0,2,2,6,0,1,0,0,0,1,0,0,0,0,0,0,7
554,D & N HAVELI,2001,8,DEATH OF DEAR PERSON,0,0,0,0,0,0,0,0,0,0,0,0,0,0,0,0,0,0,0
1100,D & N HAVELI,2001,8,DOWRY DISPUTE,0,0,0,0,0,0,0,0,0,0,0,0,0,0,0,0,0,0,0
1646,D & N HAVELI,2001,8,DRUG ABUSE,0,0,0,0,0,0,0,0,0,0,0,0,0,0,0,0,0,0,0
2192,D & N HAVELI,2001,8,ECONOMIC ISSUES,0,2,2,1,0,5,0,0,0,0,0,0,0,0,0,0,0,0,5
2738,D & N HAVELI,2001,8,EXAM FAILURE,0,0,0,0,0,0,0,0,0,0,0,0,0,0,0,0,0,0,0
3284,D & N HAVELI,2001,8,FAMILY PROBLEMS,0,3,6,2,4,15,1,6,2,1,0,10,0,0,0,0,0,0,25
3830,D & N HAVELI,2001,8,HEALTH ISSUES,0,1,1,1,2,5,0,1,1,0,0,2,0,0,0,0,0,0,7
4376,D & N HAVELI,2001,8,HERO WORSHIP,0,0,0,0,0,0,0,0,0,0,0,0,0,0,0,0,0,0,0
4921,D & N HAVELI,2001,8,ILLEGITIMATE PREGNANCY,0,0,0,0,0,0,0,0,0,0,0,0,0,0,0,0,0,0,0
5466,D & N HAVELI,2001,8,LOVE AFFAIRS,0,2,0,0,0,2,0,0,0,0,0,0,0,0,0,0,0,0,2
6011,D & N HAVELI,2001,8,MARITAL ISSUES,0,0,0,0,0,0,0,1,0,0,0,1,0,0,0,0,0,0,1
6557,D & N HAVELI,2001,8,MENTAL HEALTH,0,0,0,0,0,0,0,0,0,0,0,0,0,0,0,0,0,0,0
7103,D & N HAVELI,2001,8,OTHERS,0,0,0,1,0,1,0,0,1,0,0,1,0,0,0,0,0,0,2
7688,D & N HAVELI,2001,8,"PHYSICAL ABUSE (RAPE,INCEST ETC.)",0,0,0,0,0,0,0,0,0,0,0,0,0,0,0,0,0,0,0
8194,D & N HAVELI,2001,8,SOCIETAL ISSUES,0,0,1,0,0,1,0,0,0,0,0,0,0,0,0,0,0,0,1
47,D & N HAVELI,2002,8,CAUSES NOT KNOWN,0,1,0,2,0,3,0,2,0,0,0,2,0,0,0,0,0,0,5
593,D & N HAVELI,2002,8,DEATH OF DEAR PERSON,0,0,0,0,0,0,0,1,0,0,0,1,0,0,0,0,0,0,1
1139,D & N HAVELI,2002,8,DOWRY DISPUTE,0,0,0,0,0,0,0,0,0,0,0,0,0,0,0,0,0,0,0
1685,D & N HAVELI,2002,8,DRUG ABUSE,0,0,0,0,0,0,0,0,0,0,0,0,0,0,0,0,0,0,0
2231,D & N HAVELI,2002,8,ECONOMIC ISSUES,0,0,0,0,0,0,0,0,0,0,0,0,0,0,0,0,0,0,0
2777,D & N HAVELI,2002,8,EXAM FAILURE,1,0,0,0,0,1,0,0,0,0,0,0,0,0,0,0,0,0,1
3323,D & N HAVELI,2002,8,FAMILY PROBLEMS,0,0,0,0,0,0,0,3,1,1,0,5,0,0,0,0,0,0,5
3869,D & N HAVELI,2002,8,HEALTH ISSUES,0,0,0,3,2,5,0,1,1,0,0,2,0,0,0,0,0,0,7
4415,D & N HAVELI,2002,8,HERO WORSHIP,0,0,0,0,0,0,0,0,0,0,0,0,0,0,0,0,0,0,0
4960,D & N HAVELI,2002,8,ILLEGITIMATE PREGNANCY,0,0,0,0,0,0,0,0,0,0,0,0,0,0,0,0,0,0,0
5505,D & N HAVELI,2002,8,LOVE AFFAIRS,0,1,0,0,0,1,0,1,0,0,0,1,0,0,0,0,0,0,2
6050,D & N HAVELI,2002,8,MARITAL ISSUES,0,0,0,0,0,0,0,1,0,0,0,1,0,0,0,0,0,0,1
6596,D & N HAVELI,2002,8,MENTAL HEALTH,0,1,2,1,1,5,0,0,1,0,0,1,0,0,0,0,0,0,6
7142,D & N HAVELI,2002,8,OTHERS,0,4,5,3,2,14,0,2,0,1,2,5,0,0,0,0,0,0,19
7727,D & N HAVELI,2002,8,"PHYSICAL ABUSE (RAPE,INCEST ETC.)",0,0,0,0,0,0,0,0,0,0,0,0,0,0,0,0,0,0,0
8233,D & N HAVELI,2002,8,SOCIETAL ISSUES,0,2,1,0,0,3,0,0,0,0,0,0,0,0,0,0,0,0,3
86,D & N HAVELI,2003,8,CAUSES NOT KNOWN,0,1,2,2,0,5,0,0,0,2,0,2,0,0,0,0,0,0,7
632,D & N HAVELI,2003,8,DEATH OF DEAR PERSON,0,0,0,0,0,0,0,0,0,0,0,0,0,0,0,0,0,0,0
1178,D & N HAVELI,2003,8,DOWRY DISPUTE,0,0,0,0,0,0,0,0,0,0,0,0,0,0,0,0,0,0,0
1724,D & N HAVELI,2003,8,DRUG ABUSE,0,0,0,0,0,0,0,0,0,0,0,0,0,0,0,0,0,0,0
2270,D & N HAVELI,2003,8,ECONOMIC ISSUES,0,0,0,0,0,0,0,0,0,0,0,0,0,0,0,0,0,0,0
2816,D & N HAVELI,2003,8,EXAM FAILURE,1,0,0,0,0,1,0,0,0,0,0,0,0,0,0,0,0,0,1
3362,D & N HAVELI,2003,8,FAMILY PROBLEMS,0,4,3,1,4,12,0,2,4,6,0,12,0,0,0,0,0,0,24
3908,D & N HAVELI,2003,8,HEALTH ISSUES,0,0,0,0,0,0,0,0,0,1,0,1,0,0,0,0,0,0,1
4454,D & N HAVELI,2003,8,HERO WORSHIP,0,0,0,0,0,0,0,0,0,0,0,0,0,0,0,0,0,0,0
4999,D & N HAVELI,2003,8,ILLEGITIMATE PREGNANCY,0,0,0,0,0,0,0,1,0,0,0,1,0,0,0,0,0,0,1
5544,D & N HAVELI,2003,8,LOVE AFFAIRS,0,0,0,0,0,0,0,0,0,0,0,0,0,0,0,0,0,0,0
6089,D & N HAVELI,2003,8,MARITAL ISSUES,0,0,0,0,0,0,0,0,2,0,0,2,0,0,0,0,0,0,2
6635,D & N HAVELI,2003,8,MENTAL HEALTH,0,0,0,0,0,0,0,0,0,0,0,0,0,0,0,0,0,0,0
7181,D & N HAVELI,2003,8,OTHERS,1,2,3,4,1,11,0,3,1,0,0,4,0,0,0,0,0,0,15
7766,D & N HAVELI,2003,8,"PHYSICAL ABUSE (RAPE,INCEST ETC.)",0,0,0,0,0,0,0,0,0,0,0,0,0,0,0,0,0,0,0
8272,D & N HAVELI,2003,8,SOCIETAL ISSUES,0,1,0,0,0,1,0,0,0,0,0,0,0,0,0,0,0,0,1
125,D & N HAVELI,2004,8,CAUSES NOT KNOWN,0,0,0,0,0,0,0,0,0,0,0,0,0,0,0,0,0,0,0
671,D & N HAVELI,2004,8,DEATH OF DEAR PERSON,0,0,0,0,0,0,0,0,0,0,0,0,0,0,0,0,0,0,0
1217,D & N HAVELI,2004,8,DOWRY DISPUTE,0,0,0,0,0,0,0,0,0,0,0,0,0,0,0,0,0,0,0
1763,D & N HAVELI,2004,8,DRUG ABUSE,0,0,1,1,0,2,0,0,1,0,1,2,0,0,0,0,0,0,4
2309,D & N HAVELI,2004,8,ECONOMIC ISSUES,0,0,2,0,0,2,0,0,0,0,0,0,0,0,0,0,0,0,2
2855,D & N HAVELI,2004,8,EXAM FAILURE,0,0,0,0,0,0,0,0,0,0,0,0,0,0,0,0,0,0,0
3401,D & N HAVELI,2004,8,FAMILY PROBLEMS,0,1,0,0,0,1,0,2,1,0,0,3,0,0,0,0,0,0,4
3947,D & N HAVELI,2004,8,HEALTH ISSUES,0,2,0,1,1,4,0,1,1,0,0,2,0,0,0,0,0,0,6
4493,D & N HAVELI,2004,8,HERO WORSHIP,0,0,0,0,0,0,0,0,0,0,0,0,0,0,0,0,0,0,0
5038,D & N HAVELI,2004,8,ILLEGITIMATE PREGNANCY,0,0,0,0,0,0,0,0,0,0,0,0,0,0,0,0,0,0,0
5583,D & N HAVELI,2004,8,LOVE AFFAIRS,0,0,0,0,0,0,0,0,0,0,0,0,0,0,0,0,0,0,0
6128,D & N HAVELI,2004,8,MARITAL ISSUES,0,1,0,0,0,1,0,2,1,0,0,3,0,0,0,0,0,0,4
6674,D & N HAVELI,2004,8,MENTAL HEALTH,0,2,1,1,1,5,0,2,1,0,0,3,0,0,0,0,0,0,8
7220,D & N HAVELI,2004,8,OTHERS,0,1,2,1,1,5,0,5,0,1,0,6,0,0,0,0,0,0,11
7805,D & N HAVELI,2004,8,"PHYSICAL ABUSE (RAPE,INCEST ETC.)",0,0,0,0,0,0,0,0,0,0,0,0,0,0,0,0,0,0,0
8311,D & N HAVELI,2004,8,SOCIETAL ISSUES,0,0,0,0,0,0,0,0,0,0,0,0,0,0,0,0,0,0,0
164,D & N HAVELI,2005,8,CAUSES NOT KNOWN,0,0,0,0,0,0,0,0,0,0,0,0,0,0,0,0,0,0,0
710,D & N HAVELI,2005,8,DEATH OF DEAR PERSON,0,0,0,0,0,0,0,0,1,0,1,2,0,0,0,0,0,0,2
1256,D & N HAVELI,2005,8,DOWRY DISPUTE,0,0,0,0,0,0,0,0,0,0,0,0,0,0,0,0,0,0,0
1802,D & N HAVELI,2005,8,DRUG ABUSE,0,0,0,3,0,3,0,0,0,0,0,0,0,0,0,0,0,0,3
2348,D & N HAVELI,2005,8,ECONOMIC ISSUES,0,2,1,0,0,3,0,0,0,0,0,0,0,0,0,0,0,0,3
2894,D & N HAVELI,2005,8,EXAM FAILURE,0,0,0,0,0,0,0,0,0,0,0,0,0,0,0,0,0,0,0
3440,D & N HAVELI,2005,8,FAMILY PROBLEMS,0,3,2,0,0,5,0,3,2,2,0,7,0,0,0,0,0,0,12
3986,D & N HAVELI,2005,8,HEALTH ISSUES,0,1,3,1,2,7,0,0,3,0,0,3,0,0,0,0,0,0,10
4532,D & N HAVELI,2005,8,HERO WORSHIP,0,0,0,0,0,0,0,0,0,0,0,0,0,0,0,0,0,0,0
5077,D & N HAVELI,2005,8,ILLEGITIMATE PREGNANCY,0,0,0,0,0,0,0,0,0,0,0,0,0,0,0,0,0,0,0
5622,D & N HAVELI,2005,8,LOVE AFFAIRS,0,1,0,0,0,1,0,1,0,0,0,1,0,0,0,0,0,0,2
6167,D & N HAVELI,2005,8,MARITAL ISSUES,0,0,0,0,0,0,0,1,0,0,0,1,0,0,0,0,0,0,1
6713,D & N HAVELI,2005,8,MENTAL HEALTH,0,2,2,1,2,7,0,1,0,2,0,3,0,0,0,0,0,0,10
7259,D & N HAVELI,2005,8,OTHERS,0,7,5,1,2,15,0,6,2,3,0,11,0,0,0,0,0,0,26
7844,D & N HAVELI,2005,8,"PHYSICAL ABUSE (RAPE,INCEST ETC.)",0,0,0,0,0,0,0,0,0,0,0,0,0,0,0,0,0,0,0
8350,D & N HAVELI,2005,8,SOCIETAL ISSUES,0,0,0,0,0,0,0,0,0,0,0,0,0,0,0,0,0,0,0
203,D & N HAVELI,2006,8,CAUSES NOT KNOWN,0,0,0,0,0,0,0,0,0,0,0,0,0,0,0,0,0,0,0
749,D & N HAVELI,2006,8,DEATH OF DEAR PERSON,0,0,0,0,0,0,0,0,0,0,0,0,0,0,0,0,0,0,0
1295,D & N HAVELI,2006,8,DOWRY DISPUTE,0,0,0,0,0,0,0,0,0,0,0,0,0,0,0,0,0,0,0
1841,D & N HAVELI,2006,8,DRUG ABUSE,0,2,0,1,2,5,0,0,3,0,0,3,0,0,0,0,0,0,8
2387,D & N HAVELI,2006,8,ECONOMIC ISSUES,0,0,1,1,0,2,0,0,0,0,0,0,0,0,0,0,0,0,2
2933,D & N HAVELI,2006,8,EXAM FAILURE,0,0,0,0,0,0,0,0,0,0,0,0,0,0,0,0,0,0,0
3479,D & N HAVELI,2006,8,FAMILY PROBLEMS,0,3,0,1,0,4,0,4,2,1,0,7,0,0,0,0,0,0,11
4025,D & N HAVELI,2006,8,HEALTH ISSUES,0,0,0,0,1,1,1,0,0,0,0,1,0,0,0,0,0,0,2
4571,D & N HAVELI,2006,8,HERO WORSHIP,0,0,0,0,0,0,0,0,0,0,0,0,0,0,0,0,0,0,0
5116,D & N HAVELI,2006,8,ILLEGITIMATE PREGNANCY,0,0,0,0,0,0,0,0,0,0,0,0,0,0,0,0,0,0,0
5661,D & N HAVELI,2006,8,LOVE AFFAIRS,0,1,0,0,0,1,0,1,0,0,0,1,0,0,0,0,0,0,2
6206,D & N HAVELI,2006,8,MARITAL ISSUES,0,0,0,0,0,0,0,0,0,0,0,0,0,0,0,0,0,0,0
6752,D & N HAVELI,2006,8,MENTAL HEALTH,0,0,2,0,0,2,0,0,0,0,0,0,0,0,0,0,0,0,2
7298,D & N HAVELI,2006,8,OTHERS,0,2,2,0,4,8,0,3,1,1,2,7,0,0,0,0,0,0,15
7883,D & N HAVELI,2006,8,"PHYSICAL ABUSE (RAPE,INCEST ETC.)",0,0,0,0,0,0,0,0,0,0,0,0,0,0,0,0,0,0,0
8389,D & N HAVELI,2006,8,SOCIETAL ISSUES,0,0,0,0,0,0,0,0,0,0,0,0,0,0,0,0,0,0,0
242,D & N HAVELI,2007,8,CAUSES NOT KNOWN,0,1,1,2,5,9,0,2,0,1,0,3,0,0,0,0,0,0,12
788,D & N HAVELI,2007,8,DEATH OF DEAR PERSON,0,0,0,0,0,0,0,0,0,0,0,0,0,0,0,0,0,0,0
1334,D & N HAVELI,2007,8,DOWRY DISPUTE,0,0,0,0,0,0,0,0,0,0,0,0,0,0,0,0,0,0,0
1880,D & N HAVELI,2007,8,DRUG ABUSE,0,0,2,1,1,4,0,0,0,1,0,1,0,0,0,0,0,0,5
2426,D & N HAVELI,2007,8,ECONOMIC ISSUES,0,0,1,0,0,1,0,0,0,0,0,0,0,0,0,0,0,0,1
2972,D & N HAVELI,2007,8,EXAM FAILURE,0,0,0,0,0,0,0,0,0,0,0,0,0,0,0,0,0,0,0
3518,D & N HAVELI,2007,8,FAMILY PROBLEMS,0,3,7,2,0,12,0,12,7,1,0,20,0,0,0,0,0,0,32
4064,D & N HAVELI,2007,8,HEALTH ISSUES,0,1,1,1,2,5,0,0,0,1,1,2,0,0,0,0,0,0,7
4609,D & N HAVELI,2007,8,HERO WORSHIP,0,0,0,0,0,0,0,0,0,0,0,0,0,0,0,0,0,0,0
5154,D & N HAVELI,2007,8,ILLEGITIMATE PREGNANCY,0,0,0,0,0,0,0,0,0,0,0,0,0,0,0,0,0,0,0
5699,D & N HAVELI,2007,8,LOVE AFFAIRS,0,3,0,0,0,3,0,4,0,0,0,4,0,0,0,0,0,0,7
6245,D & N HAVELI,2007,8,MARITAL ISSUES,0,1,0,0,0,1,0,1,0,0,0,1,0,0,0,0,0,0,2
6791,D & N HAVELI,2007,8,MENTAL HEALTH,0,0,0,0,0,0,0,0,0,0,0,0,0,0,0,0,0,0,0
7337,D & N HAVELI,2007,8,OTHERS,0,0,0,0,0,0,0,0,0,0,0,0,0,0,0,0,0,0,0
7921,D & N HAVELI,2007,8,"PHYSICAL ABUSE (RAPE,INCEST ETC.)",0,6,2,1,0,9,0,0,0,0,0,0,0,0,0,0,0,0,9
8428,D & N HAVELI,2007,8,SOCIETAL ISSUES,0,0,0,0,0,0,0,0,1,0,0,1,0,0,0,0,0,0,1
281,D & N HAVELI,2008,8,CAUSES NOT KNOWN,0,1,0,0,0,1,0,0,0,0,0,0,0,0,0,0,0,0,1
827,D & N HAVELI,2008,8,DEATH OF DEAR PERSON,0,0,1,0,1,2,0,0,0,0,0,0,0,0,0,0,0,0,2
1373,D & N HAVELI,2008,8,DOWRY DISPUTE,0,0,0,0,0,0,0,0,0,0,0,0,0,0,0,0,0,0,0
1919,D & N HAVELI,2008,8,DRUG ABUSE,0,0,3,0,0,3,0,0,0,1,0,1,0,0,0,0,0,0,4
2465,D & N HAVELI,2008,8,ECONOMIC ISSUES,0,1,2,0,0,3,0,1,0,0,0,1,0,0,0,0,0,0,4
3011,D & N HAVELI,2008,8,EXAM FAILURE,0,0,0,0,0,0,0,0,0,0,0,0,0,0,0,0,0,0,0
3557,D & N HAVELI,2008,8,FAMILY PROBLEMS,1,2,0,1,0,4,0,7,5,2,1,15,0,0,0,0,0,0,19
4103,D & N HAVELI,2008,8,HEALTH ISSUES,0,1,0,1,0,2,0,0,0,0,0,0,0,0,0,0,0,0,2
4648,D & N HAVELI,2008,8,HERO WORSHIP,0,0,0,0,0,0,0,0,0,0,0,0,0,0,0,0,0,0,0
5193,D & N HAVELI,2008,8,ILLEGITIMATE PREGNANCY,0,0,0,0,0,0,0,0,0,0,0,0,0,0,0,0,0,0,0
5738,D & N HAVELI,2008,8,LOVE AFFAIRS,0,1,0,0,0,1,0,0,0,0,0,0,0,0,0,0,0,0,1
6284,D & N HAVELI,2008,8,MARITAL ISSUES,0,0,0,0,0,0,0,5,1,2,0,8,0,0,0,0,0,0,8
6830,D & N HAVELI,2008,8,MENTAL HEALTH,0,2,4,5,0,11,0,2,0,0,0,2,0,0,0,0,0,0,13
7376,D & N HAVELI,2008,8,OTHERS,0,3,1,1,0,5,0,0,0,1,0,1,0,0,0,0,0,0,6
7960,D & N HAVELI,2008,8,"PHYSICAL ABUSE (RAPE,INCEST ETC.)",0,0,0,0,0,0,0,0,0,0,0,0,0,0,0,0,0,0,0
8467,D & N HAVELI,2008,8,SOCIETAL ISSUES,0,0,0,0,0,0,0,0,0,0,0,0,0,0,0,0,0,0,0
320,D & N HAVELI,2009,8,CAUSES NOT KNOWN,0,2,1,1,1,5,0,1,0,0,1,2,0,0,0,0,0,0,7
866,D & N HAVELI,2009,8,DEATH OF DEAR PERSON,0,0,0,0,0,0,0,0,0,0,0,0,0,0,0,0,0,0,0
1412,D & N HAVELI,2009,8,DOWRY DISPUTE,0,0,0,0,0,0,0,0,0,0,0,0,0,0,0,0,0,0,0
1958,D & N HAVELI,2009,8,DRUG ABUSE,0,0,0,0,0,0,0,0,0,0,0,0,0,0,0,0,0,0,0
2504,D & N HAVELI,2009,8,ECONOMIC ISSUES,0,0,1,2,0,3,0,0,0,0,0,0,0,0,0,0,0,0,3
3050,D & N HAVELI,2009,8,EXAM FAILURE,0,0,0,0,0,0,0,0,0,0,0,0,0,0,0,0,0,0,0
3596,D & N HAVELI,2009,8,FAMILY PROBLEMS,0,3,1,0,0,4,0,5,0,0,3,8,0,0,0,0,0,0,12
4142,D & N HAVELI,2009,8,HEALTH ISSUES,0,0,2,0,1,3,0,0,0,0,2,2,0,0,0,0,0,0,5
4687,D & N HAVELI,2009,8,HERO WORSHIP,0,0,0,0,0,0,0,0,0,0,0,0,0,0,0,0,0,0,0
5232,D & N HAVELI,2009,8,ILLEGITIMATE PREGNANCY,0,0,0,0,0,0,0,0,0,0,0,0,0,0,0,0,0,0,0
5777,D & N HAVELI,2009,8,LOVE AFFAIRS,0,4,0,0,0,4,0,3,0,0,0,3,0,0,0,0,0,0,7
6323,D & N HAVELI,2009,8,MARITAL ISSUES,0,1,1,1,0,3,0,3,3,0,0,6,0,0,0,0,0,0,9
6869,D & N HAVELI,2009,8,MENTAL HEALTH,0,0,2,0,0,2,0,0,1,0,0,1,0,0,0,0,0,0,3
7415,D & N HAVELI,2009,8,OTHERS,0,0,2,4,0,6,0,2,0,1,1,4,0,0,0,0,0,0,10
7999,D & N HAVELI,2009,8,"PHYSICAL ABUSE (RAPE,INCEST ETC.)",0,0,0,0,0,0,0,0,0,0,0,0,0,0,0,0,0,0,0
8506,D & N HAVELI,2009,8,SOCIETAL ISSUES,0,0,0,0,0,0,0,0,0,0,0,0,0,0,0,0,0,0,0
359,D & N HAVELI,2010,8,CAUSES NOT KNOWN,0,0,3,0,1,4,0,3,2,2,0,7,0,0,0,0,0,0,11
905,D & N HAVELI,2010,8,DEATH OF DEAR PERSON,0,3,0,0,0,3,0,0,0,0,0,0,0,0,0,0,0,0,3
1451,D & N HAVELI,2010,8,DOWRY DISPUTE,0,0,0,0,0,0,0,0,0,0,0,0,0,0,0,0,0,0,0
1997,D & N HAVELI,2010,8,DRUG ABUSE,0,0,2,3,0,5,0,0,0,1,0,1,0,0,0,0,0,0,6
2543,D & N HAVELI,2010,8,ECONOMIC ISSUES,0,0,0,0,0,0,0,0,0,0,0,0,0,0,0,0,0,0,0
3089,D & N HAVELI,2010,8,EXAM FAILURE,0,0,0,0,0,0,0,0,0,0,0,0,0,0,0,0,0,0,0
3635,D & N HAVELI,2010,8,FAMILY PROBLEMS,0,2,4,1,0,7,0,7,0,0,0,7,0,0,0,0,0,0,14
4181,D & N HAVELI,2010,8,HEALTH ISSUES,0,1,0,0,2,3,0,1,0,0,0,1,0,0,0,0,0,0,4
4726,D & N HAVELI,2010,8,HERO WORSHIP,0,0,0,0,0,0,0,0,0,0,0,0,0,0,0,0,0,0,0
5271,D & N HAVELI,2010,8,ILLEGITIMATE PREGNANCY,0,0,0,0,0,0,0,0,0,0,0,0,0,0,0,0,0,0,0
5816,D & N HAVELI,2010,8,LOVE AFFAIRS,0,1,0,0,0,1,0,2,0,0,0,2,0,0,0,0,0,0,3
6362,D & N HAVELI,2010,8,MARITAL ISSUES,0,1,0,0,0,1,0,2,0,1,0,3,0,0,0,0,0,0,4
6908,D & N HAVELI,2010,8,MENTAL HEALTH,0,4,2,2,2,10,0,0,2,0,0,2,0,0,0,0,0,0,12
7454,D & N HAVELI,2010,8,OTHERS,0,2,0,0,0,2,0,2,0,0,0,2,0,0,0,0,0,0,4
8038,D & N HAVELI,2010,8,"PHYSICAL ABUSE (RAPE,INCEST ETC.)",0,0,0,0,0,0,0,0,0,0,0,0,0,0,0,0,0,0,0
8545,D & N HAVELI,2010,8,SOCIETAL ISSUES,0,0,1,0,0,1,0,1,0,0,0,1,0,0,0,0,0,0,2
398,D & N HAVELI,2011,8,CAUSES NOT KNOWN,0,6,1,1,0,8,0,1,0,0,0,1,0,0,0,0,0,0,9
944,D & N HAVELI,2011,8,DEATH OF DEAR PERSON,0,0,0,0,0,0,0,1,0,0,0,1,0,0,0,0,0,0,1
1490,D & N HAVELI,2011,8,DOWRY DISPUTE,0,0,0,0,0,0,0,0,0,0,0,0,0,0,0,0,0,0,0
2036,D & N HAVELI,2011,8,DRUG ABUSE,0,1,2,3,1,7,0,0,2,2,0,4,0,0,0,0,0,0,11
2582,D & N HAVELI,2011,8,ECONOMIC ISSUES,0,1,0,0,0,1,0,0,0,0,0,0,0,0,0,0,0,0,1
3128,D & N HAVELI,2011,8,EXAM FAILURE,0,0,0,0,0,0,0,0,0,0,0,0,0,0,0,0,0,0,0
3674,D & N HAVELI,2011,8,FAMILY PROBLEMS,0,3,1,2,0,6,0,2,2,0,0,4,0,0,0,0,0,0,10
4220,D & N HAVELI,2011,8,HEALTH ISSUES,0,1,1,1,0,3,0,0,0,0,0,0,0,0,0,0,0,0,3
4765,D & N HAVELI,2011,8,HERO WORSHIP,0,0,0,0,0,0,0,0,0,0,0,0,0,0,0,0,0,0,0
5310,D & N HAVELI,2011,8,ILLEGITIMATE PREGNANCY,0,0,0,0,0,0,0,0,0,0,0,0,0,0,0,0,0,0,0
5855,D & N HAVELI,2011,8,LOVE AFFAIRS,0,4,1,0,0,5,0,3,0,0,0,3,0,0,0,0,0,0,8
6401,D & N HAVELI,2011,8,MARITAL ISSUES,0,2,0,0,0,2,0,1,0,0,0,1,0,0,0,0,0,0,3
6947,D & N HAVELI,2011,8,MENTAL HEALTH,0,1,1,0,0,2,0,1,0,0,1,2,0,0,0,0,0,0,4
7493,D & N HAVELI,2011,8,OTHERS,0,3,1,2,0,6,0,4,1,1,0,6,0,0,0,0,0,0,12
8077,D & N HAVELI,2011,8,"PHYSICAL ABUSE (RAPE,INCEST ETC.)",0,0,0,0,0,0,0,0,0,0,0,0,0,0,0,0,0,0,0
8584,D & N HAVELI,2011,8,SOCIETAL ISSUES,0,1,0,0,0,1,0,0,0,0,0,0,0,0,0,0,0,0,1
437,D & N HAVELI,2012,8,CAUSES NOT KNOWN,0,1,5,1,0,7,0,6,2,0,0,8,0,0,0,0,0,0,15
983,D & N HAVELI,2012,8,DEATH OF DEAR PERSON,0,0,0,0,0,0,0,0,0,0,0,0,0,0,0,0,0,0,0
1529,D & N HAVELI,2012,8,DOWRY DISPUTE,0,0,0,0,0,0,0,0,0,0,0,0,0,0,0,0,0,0,0
2075,D & N HAVELI,2012,8,DRUG ABUSE,0,0,0,0,0,0,0,0,0,0,0,0,0,0,0,0,0,0,0
2621,D & N HAVELI,2012,8,ECONOMIC ISSUES,0,0,0,0,0,0,0,0,0,0,0,0,0,0,0,0,0,0,0
3167,D & N HAVELI,2012,8,EXAM FAILURE,0,0,0,0,0,0,0,0,0,0,0,0,0,0,0,0,0,0,0
3713,D & N HAVELI,2012,8,FAMILY PROBLEMS,0,6,5,2,0,13,0,4,0,1,1,6,0,0,0,0,0,0,19
4259,D & N HAVELI,2012,8,HEALTH ISSUES,0,2,2,2,2,8,0,2,0,1,2,5,0,0,0,0,0,0,13
4804,D & N HAVELI,2012,8,HERO WORSHIP,0,0,0,0,0,0,0,0,0,0,0,0,0,0,0,0,0,0,0
5349,D & N HAVELI,2012,8,ILLEGITIMATE PREGNANCY,0,0,0,0,0,0,0,0,0,0,0,0,0,0,0,0,0,0,0
5894,D & N HAVELI,2012,8,LOVE AFFAIRS,0,2,0,0,0,2,0,6,0,0,0,6,0,0,0,0,0,0,8
6440,D & N HAVELI,2012,8,MARITAL ISSUES,0,0,0,0,0,0,0,0,0,0,0,0,0,0,0,0,0,0,0
6986,D & N HAVELI,2012,8,MENTAL HEALTH,0,1,2,0,0,3,0,0,0,0,0,0,0,0,0,0,0,0,3
7532,D & N HAVELI,2012,8,OTHERS,0,3,2,0,1,6,0,0,0,0,0,0,0,0,0,0,0,0,6
8116,D & N HAVELI,2012,8,"PHYSICAL ABUSE (RAPE,INCEST ETC.)",0,0,0,0,0,0,0,0,0,0,0,0,0,0,0,0,0,0,0
8623,D & N HAVELI,2012,8,SOCIETAL ISSUES,0,2,0,0,0,2,0,0,0,0,0,0,0,0,0,0,0,0,2
476,D & N HAVELI,2013,8,CAUSES NOT KNOWN,0,7,2,3,0,12,0,0,0,0,0,0,0,0,0,0,0,0,12
1022,D & N HAVELI,2013,8,DEATH OF DEAR PERSON,0,0,0,0,0,0,0,0,0,0,0,0,0,0,0,0,0,0,0
1568,D & N HAVELI,2013,8,DOWRY DISPUTE,0,0,0,0,0,0,0,0,0,0,0,0,0,0,0,0,0,0,0
2114,D & N HAVELI,2013,8,DRUG ABUSE,0,0,0,0,0,0,0,0,0,0,0,0,0,0,0,0,0,0,0
2660,D & N HAVELI,2013,8,ECONOMIC ISSUES,0,0,0,1,0,1,0,0,0,2,0,2,0,0,0,0,0,0,3
3206,D & N HAVELI,2013,8,EXAM FAILURE,0,0,0,0,0,0,0,0,0,0,0,0,0,0,0,0,0,0,0
3752,D & N HAVELI,2013,8,FAMILY PROBLEMS,0,1,4,9,2,16,0,3,0,1,0,4,0,0,0,0,0,0,20
4298,D & N HAVELI,2013,8,HEALTH ISSUES,0,3,3,1,0,7,0,1,0,0,3,4,0,0,0,0,0,0,11
4843,D & N HAVELI,2013,8,HERO WORSHIP,0,0,0,0,0,0,0,0,0,0,0,0,0,0,0,0,0,0,0
5388,D & N HAVELI,2013,8,ILLEGITIMATE PREGNANCY,0,0,0,0,0,0,0,0,0,0,0,0,0,0,0,0,0,0,0
5933,D & N HAVELI,2013,8,LOVE AFFAIRS,0,2,1,0,0,3,0,4,0,0,0,4,0,0,0,0,0,0,7
6479,D & N HAVELI,2013,8,MARITAL ISSUES,0,2,0,0,0,2,0,0,0,0,0,0,0,0,0,0,0,0,2
7025,D & N HAVELI,2013,8,MENTAL HEALTH,0,8,0,0,0,8,0,0,2,0,3,5,0,0,0,0,0,0,13
7571,D & N HAVELI,2013,8,OTHERS,0,1,1,3,0,5,0,4,3,2,0,9,0,0,0,0,0,0,14
8155,D & N HAVELI,2013,8,"PHYSICAL ABUSE (RAPE,INCEST ETC.)",0,0,0,0,0,0,0,0,0,0,0,0,0,0,0,0,0,0,0
8662,D & N HAVELI,2013,8,SOCIETAL ISSUES,0,0,1,0,0,1,0,1,0,0,0,1,0,0,0,0,0,0,2
515,D & N HAVELI,2014,8,CAUSES NOT KNOWN,0,1,2,0,0,3,0,2,0,0,0,2,0,0,0,0,0,0,5
1061,D & N HAVELI,2014,8,DEATH OF DEAR PERSON,0,0,1,0,1,2,0,0,0,0,0,0,0,0,0,0,0,0,2
1607,D & N HAVELI,2014,8,DOWRY DISPUTE,0,0,0,0,0,0,0,0,0,0,0,0,0,0,0,0,0,0,0
2153,D & N HAVELI,2014,8,DRUG ABUSE,0,0,0,0,0,0,0,0,0,0,0,0,0,0,0,0,0,0,0
2699,D & N HAVELI,2014,8,ECONOMIC ISSUES,0,0,1,0,0,1,0,0,0,0,0,0,0,0,0,0,0,0,1
3245,D & N HAVELI,2014,8,EXAM FAILURE,1,1,0,0,0,2,0,0,0,0,0,0,0,0,0,0,0,0,2
3791,D & N HAVELI,2014,8,FAMILY PROBLEMS,0,0,0,0,0,0,0,1,1,0,0,2,0,0,0,0,0,0,2
4337,D & N HAVELI,2014,8,HEALTH ISSUES,0,4,2,2,0,8,0,4,0,0,0,4,0,0,0,0,0,0,12
4882,D & N HAVELI,2014,8,HERO WORSHIP,0,0,0,0,0,0,0,0,0,0,0,0,0,0,0,0,0,0,0
5427,D & N HAVELI,2014,8,ILLEGITIMATE PREGNANCY,0,0,0,0,0,0,0,0,0,0,0,0,0,0,0,0,0,0,0
5972,D & N HAVELI,2014,8,LOVE AFFAIRS,0,3,0,0,0,3,0,2,0,0,0,2,0,0,0,0,0,0,5
6518,D & N HAVELI,2014,8,MARITAL ISSUES,0,2,0,0,0,2,0,4,0,0,0,4,0,0,0,0,0,0,6
7064,D & N HAVELI,2014,8,MENTAL HEALTH,0,0,0,0,0,0,0,0,0,0,0,0,0,0,0,0,0,0,0
7610,D & N HAVELI,2014,8,OTHERS,0,11,7,7,4,29,0,14,2,1,2,19,0,0,0,0,0,0,48
7649,D & N HAVELI,2014,8,PHYSICAL ABUSE,0,0,0,0,0,0,0,0,0,0,0,0,0,0,0,0,0,0,0
8701,D & N HAVELI,2014,8,SOCIETAL ISSUES,0,0,0,0,0,0,0,1,1,0,0,2,0,0,0,0,0,0,2
9,DAMAN & DIU,2001,9,CAUSES NOT KNOWN,0,0,0,0,0,0,0,0,0,0,0,0,0,0,0,0,0,0,0
555,DAMAN & DIU,2001,9,DEATH OF DEAR PERSON,0,0,0,0,0,0,0,0,0,0,0,0,0,0,0,0,0,0,0
1101,DAMAN & DIU,2001,9,DOWRY DISPUTE,0,0,0,0,0,0,0,0,0,0,0,0,0,0,0,0,0,0,0
1647,DAMAN & DIU,2001,9,DRUG ABUSE,0,0,0,0,0,0,0,0,0,0,0,0,0,0,0,0,0,0,0
2193,DAMAN & DIU,2001,9,ECONOMIC ISSUES,0,0,0,0,0,0,0,0,0,0,0,0,0,0,0,0,0,0,0
2739,DAMAN & DIU,2001,9,EXAM FAILURE,0,0,0,0,0,0,0,0,0,0,0,0,0,0,0,0,0,0,0
3285,DAMAN & DIU,2001,9,FAMILY PROBLEMS,0,0,0,0,0,0,0,0,0,0,0,0,0,0,0,0,0,0,0
3831,DAMAN & DIU,2001,9,HEALTH ISSUES,0,0,0,0,0,0,0,0,0,0,0,0,0,0,0,0,0,0,0
4377,DAMAN & DIU,2001,9,HERO WORSHIP,0,0,0,0,0,0,0,0,0,0,0,0,0,0,0,0,0,0,0
4922,DAMAN & DIU,2001,9,ILLEGITIMATE PREGNANCY,0,0,0,0,0,0,0,1,0,0,0,1,0,0,0,0,0,0,1
5467,DAMAN & DIU,2001,9,LOVE AFFAIRS,0,0,0,0,0,0,0,1,0,0,0,1,0,0,0,0,0,0,1
6012,DAMAN & DIU,2001,9,MARITAL ISSUES,0,0,0,0,0,0,0,1,0,0,0,1,0,0,0,0,0,0,1
6558,DAMAN & DIU,2001,9,MENTAL HEALTH,0,0,0,0,0,0,0,0,0,0,0,0,0,0,0,0,0,0,0
7104,DAMAN & DIU,2001,9,OTHERS,0,4,6,0,0,10,0,1,0,0,0,1,0,0,0,0,0,0,11
7689,DAMAN & DIU,2001,9,"PHYSICAL ABUSE (RAPE,INCEST ETC.)",0,0,0,0,0,0,0,0,0,0,0,0,0,0,0,0,0,0,0
8195,DAMAN & DIU,2001,9,SOCIETAL ISSUES,0,0,0,0,0,0,0,0,0,0,0,0,0,0,0,0,0,0,0
48,DAMAN & DIU,2002,9,CAUSES NOT KNOWN,0,3,7,0,1,11,0,0,1,0,0,1,0,0,0,0,0,0,12
594,DAMAN & DIU,2002,9,DEATH OF DEAR PERSON,0,0,0,0,0,0,0,0,0,0,0,0,0,0,0,0,0,0,0
1140,DAMAN & DIU,2002,9,DOWRY DISPUTE,0,0,0,0,0,0,0,0,0,0,0,0,0,0,0,0,0,0,0
1686,DAMAN & DIU,2002,9,DRUG ABUSE,0,0,0,0,0,0,0,0,0,0,0,0,0,0,0,0,0,0,0
2232,DAMAN & DIU,2002,9,ECONOMIC ISSUES,0,0,0,0,0,0,0,0,0,0,0,0,0,0,0,0,0,0,0
2778,DAMAN & DIU,2002,9,EXAM FAILURE,0,0,0,0,0,0,0,0,0,0,0,0,0,0,0,0,0,0,0
3324,DAMAN & DIU,2002,9,FAMILY PROBLEMS,0,0,0,0,0,0,0,0,0,0,0,0,0,0,0,0,0,0,0
3870,DAMAN & DIU,2002,9,HEALTH ISSUES,0,0,0,0,0,0,0,1,0,0,0,1,0,0,0,0,0,0,1
4416,DAMAN & DIU,2002,9,HERO WORSHIP,0,0,0,0,0,0,0,0,0,0,0,0,0,0,0,0,0,0,0
4961,DAMAN & DIU,2002,9,ILLEGITIMATE PREGNANCY,0,0,0,0,0,0,0,0,0,0,0,0,0,0,0,0,0,0,0
5506,DAMAN & DIU,2002,9,LOVE AFFAIRS,0,1,1,0,0,2,0,0,0,0,0,0,0,0,0,0,0,0,2
6051,DAMAN & DIU,2002,9,MARITAL ISSUES,0,0,0,0,0,0,0,0,0,0,0,0,0,0,0,0,0,0,0
6597,DAMAN & DIU,2002,9,MENTAL HEALTH,0,0,0,1,0,1,0,0,0,0,0,0,0,0,0,0,0,0,1
7143,DAMAN & DIU,2002,9,OTHERS,0,0,1,0,0,1,0,0,0,0,0,0,0,0,0,0,0,0,1
7728,DAMAN & DIU,2002,9,"PHYSICAL ABUSE (RAPE,INCEST ETC.)",0,0,0,0,0,0,0,0,0,0,0,0,0,0,0,0,0,0,0
8234,DAMAN & DIU,2002,9,SOCIETAL ISSUES,0,0,0,0,0,0,0,0,0,0,0,0,0,0,0,0,0,0,0
87,DAMAN & DIU,2003,9,CAUSES NOT KNOWN,0,6,4,2,0,12,0,1,1,1,0,3,0,0,0,0,0,0,15
633,DAMAN & DIU,2003,9,DEATH OF DEAR PERSON,0,0,0,0,0,0,0,0,0,0,0,0,0,0,0,0,0,0,0
1179,DAMAN & DIU,2003,9,DOWRY DISPUTE,0,0,0,0,0,0,0,0,0,0,0,0,0,0,0,0,0,0,0
1725,DAMAN & DIU,2003,9,DRUG ABUSE,0,0,0,0,0,0,0,0,0,0,0,0,0,0,0,0,0,0,0
2271,DAMAN & DIU,2003,9,ECONOMIC ISSUES,0,0,1,0,0,1,0,0,0,0,0,0,0,0,0,0,0,0,1
2817,DAMAN & DIU,2003,9,EXAM FAILURE,0,0,0,0,0,0,0,0,0,0,0,0,0,0,0,0,0,0,0
3363,DAMAN & DIU,2003,9,FAMILY PROBLEMS,1,0,2,0,0,3,0,1,0,0,0,1,0,0,0,0,0,0,4
3909,DAMAN & DIU,2003,9,HEALTH ISSUES,0,0,0,0,0,0,0,0,0,0,0,0,0,0,0,0,0,0,0
4455,DAMAN & DIU,2003,9,HERO WORSHIP,0,0,0,0,0,0,0,0,0,0,0,0,0,0,0,0,0,0,0
5000,DAMAN & DIU,2003,9,ILLEGITIMATE PREGNANCY,0,0,0,0,0,0,0,0,0,0,0,0,0,0,0,0,0,0,0
5545,DAMAN & DIU,2003,9,LOVE AFFAIRS,0,0,0,0,0,0,0,0,0,0,0,0,0,0,0,0,0,0,0
6090,DAMAN & DIU,2003,9,MARITAL ISSUES,0,0,0,0,0,0,0,0,0,0,0,0,0,0,0,0,0,0,0
6636,DAMAN & DIU,2003,9,MENTAL HEALTH,0,1,0,0,0,1,0,0,1,0,0,1,0,0,0,0,0,0,2
7182,DAMAN & DIU,2003,9,OTHERS,0,0,1,0,0,1,0,1,0,0,0,1,0,0,0,0,0,0,2
7767,DAMAN & DIU,2003,9,"PHYSICAL ABUSE (RAPE,INCEST ETC.)",0,0,0,0,0,0,0,0,0,0,0,0,0,0,0,0,0,0,0
8273,DAMAN & DIU,2003,9,SOCIETAL ISSUES,0,0,0,0,0,0,0,0,0,0,0,0,0,0,0,0,0,0,0
126,DAMAN & DIU,2004,9,CAUSES NOT KNOWN,0,0,3,1,0,4,0,4,0,0,0,4,0,0,0,0,0,0,8
672,DAMAN & DIU,2004,9,DEATH OF DEAR PERSON,0,0,0,0,0,0,0,0,0,0,0,0,0,0,0,0,0,0,0
1218,DAMAN & DIU,2004,9,DOWRY DISPUTE,0,0,0,0,0,0,0,0,0,0,0,0,0,0,0,0,0,0,0
1764,DAMAN & DIU,2004,9,DRUG ABUSE,0,0,0,0,0,0,0,0,0,0,0,0,0,0,0,0,0,0,0
2310,DAMAN & DIU,2004,9,ECONOMIC ISSUES,0,0,0,0,0,0,0,1,0,0,0,1,0,0,0,0,0,0,1
2856,DAMAN & DIU,2004,9,EXAM FAILURE,0,0,0,0,0,0,0,0,0,0,0,0,0,0,0,0,0,0,0
3402,DAMAN & DIU,2004,9,FAMILY PROBLEMS,0,0,0,0,0,0,0,2,0,0,0,2,0,0,0,0,0,0,2
3948,DAMAN & DIU,2004,9,HEALTH ISSUES,0,0,0,0,0,0,0,0,0,0,0,0,0,0,0,0,0,0,0
4494,DAMAN & DIU,2004,9,HERO WORSHIP,0,0,0,0,0,0,0,0,0,0,0,0,0,0,0,0,0,0,0
5039,DAMAN & DIU,2004,9,ILLEGITIMATE PREGNANCY,0,0,0,0,0,0,0,0,0,0,0,0,0,0,0,0,0,0,0
5584,DAMAN & DIU,2004,9,LOVE AFFAIRS,0,0,0,0,0,0,0,0,0,0,0,0,0,0,0,0,0,0,0
6129,DAMAN & DIU,2004,9,MARITAL ISSUES,0,0,0,0,0,0,0,0,0,0,0,0,0,0,0,0,0,0,0
6675,DAMAN & DIU,2004,9,MENTAL HEALTH,0,0,0,0,0,0,0,1,0,0,0,1,0,0,0,0,0,0,1
7221,DAMAN & DIU,2004,9,OTHERS,0,1,0,0,0,1,0,0,0,0,0,0,0,0,0,0,0,0,1
7806,DAMAN & DIU,2004,9,"PHYSICAL ABUSE (RAPE,INCEST ETC.)",0,0,0,0,0,0,0,0,0,0,0,0,0,0,0,0,0,0,0
8312,DAMAN & DIU,2004,9,SOCIETAL ISSUES,0,0,0,0,0,0,0,0,0,0,0,0,0,0,0,0,0,0,0
165,DAMAN & DIU,2005,9,CAUSES NOT KNOWN,0,5,1,0,0,6,0,4,1,0,0,5,0,0,0,0,0,0,11
711,DAMAN & DIU,2005,9,DEATH OF DEAR PERSON,0,0,0,0,0,0,0,0,0,0,0,0,0,0,0,0,0,0,0
1257,DAMAN & DIU,2005,9,DOWRY DISPUTE,0,0,0,0,0,0,0,0,0,0,0,0,0,0,0,0,0,0,0
1803,DAMAN & DIU,2005,9,DRUG ABUSE,0,0,0,0,0,0,0,0,0,0,0,0,0,0,0,0,0,0,0
2349,DAMAN & DIU,2005,9,ECONOMIC ISSUES,0,0,0,0,0,0,0,0,0,0,0,0,0,0,0,0,0,0,0
2895,DAMAN & DIU,2005,9,EXAM FAILURE,0,0,0,0,0,0,0,0,0,0,0,0,0,0,0,0,0,0,0
3441,DAMAN & DIU,2005,9,FAMILY PROBLEMS,0,0,1,0,0,1,0,1,1,0,0,2,0,0,0,0,0,0,3
3987,DAMAN & DIU,2005,9,HEALTH ISSUES,0,0,0,6,0,6,0,0,0,0,0,0,0,0,0,0,0,0,6
4533,DAMAN & DIU,2005,9,HERO WORSHIP,0,0,0,0,0,0,0,0,0,0,0,0,0,0,0,0,0,0,0
5078,DAMAN & DIU,2005,9,ILLEGITIMATE PREGNANCY,0,0,0,0,0,0,0,0,0,0,0,0,0,0,0,0,0,0,0
5623,DAMAN & DIU,2005,9,LOVE AFFAIRS,0,0,0,0,0,0,0,0,0,0,0,0,0,0,0,0,0,0,0
6168,DAMAN & DIU,2005,9,MARITAL ISSUES,0,0,0,0,0,0,0,0,0,0,0,0,0,0,0,0,0,0,0
6714,DAMAN & DIU,2005,9,MENTAL HEALTH,0,0,0,0,0,0,0,0,0,0,0,0,0,0,0,0,0,0,0
7260,DAMAN & DIU,2005,9,OTHERS,1,5,2,4,0,12,0,0,0,0,0,0,0,0,0,0,0,0,12
7845,DAMAN & DIU,2005,9,"PHYSICAL ABUSE (RAPE,INCEST ETC.)",0,0,0,0,0,0,0,0,0,0,0,0,0,0,0,0,0,0,0
8351,DAMAN & DIU,2005,9,SOCIETAL ISSUES,0,0,0,0,0,0,0,0,0,0,0,0,0,0,0,0,0,0,0
204,DAMAN & DIU,2006,9,CAUSES NOT KNOWN,0,5,4,0,0,9,2,4,1,0,0,7,0,0,0,0,0,0,16
750,DAMAN & DIU,2006,9,DEATH OF DEAR PERSON,0,0,0,0,0,0,0,0,0,0,0,0,0,0,0,0,0,0,0
1296,DAMAN & DIU,2006,9,DOWRY DISPUTE,0,0,0,0,0,0,0,0,0,0,0,0,0,0,0,0,0,0,0
1842,DAMAN & DIU,2006,9,DRUG ABUSE,0,0,0,0,0,0,0,0,0,0,0,0,0,0,0,0,0,0,0
2388,DAMAN & DIU,2006,9,ECONOMIC ISSUES,0,0,0,0,0,0,0,0,0,0,0,0,0,0,0,0,0,0,0
2934,DAMAN & DIU,2006,9,EXAM FAILURE,0,0,0,0,0,0,0,0,0,0,0,0,0,0,0,0,0,0,0
3480,DAMAN & DIU,2006,9,FAMILY PROBLEMS,0,0,0,0,1,1,0,0,0,0,0,0,0,0,0,0,0,0,1
4026,DAMAN & DIU,2006,9,HEALTH ISSUES,0,0,1,1,0,2,0,0,0,0,0,0,0,0,0,0,0,0,2
4572,DAMAN & DIU,2006,9,HERO WORSHIP,0,0,0,0,0,0,0,0,0,0,0,0,0,0,0,0,0,0,0
5117,DAMAN & DIU,2006,9,ILLEGITIMATE PREGNANCY,0,0,0,0,0,0,0,0,0,0,0,0,0,0,0,0,0,0,0
5662,DAMAN & DIU,2006,9,LOVE AFFAIRS,0,1,0,0,0,1,1,0,0,0,0,1,0,0,0,0,0,0,2
6207,DAMAN & DIU,2006,9,MARITAL ISSUES,0,0,0,0,0,0,0,0,0,0,0,0,0,0,0,0,0,0,0
6753,DAMAN & DIU,2006,9,MENTAL HEALTH,0,1,0,0,0,1,0,0,0,0,0,0,0,0,0,0,0,0,1
7299,DAMAN & DIU,2006,9,OTHERS,0,0,0,0,0,0,0,0,0,0,0,0,0,0,0,0,0,0,0
7884,DAMAN & DIU,2006,9,"PHYSICAL ABUSE (RAPE,INCEST ETC.)",0,0,0,0,0,0,0,0,0,0,0,0,0,0,0,0,0,0,0
8390,DAMAN & DIU,2006,9,SOCIETAL ISSUES,0,0,0,0,0,0,0,0,0,0,0,0,0,0,0,0,0,0,0
243,DAMAN & DIU,2007,9,CAUSES NOT KNOWN,0,3,1,2,0,6,0,6,2,0,0,8,0,0,0,0,0,0,14
789,DAMAN & DIU,2007,9,DEATH OF DEAR PERSON,0,0,0,0,0,0,0,0,0,0,0,0,0,0,0,0,0,0,0
1335,DAMAN & DIU,2007,9,DOWRY DISPUTE,0,0,0,0,0,0,0,0,0,0,0,0,0,0,0,0,0,0,0
1881,DAMAN & DIU,2007,9,DRUG ABUSE,0,0,0,0,0,0,0,0,0,0,0,0,0,0,0,0,0,0,0
2427,DAMAN & DIU,2007,9,ECONOMIC ISSUES,0,0,0,0,0,0,0,0,0,0,0,0,0,0,0,0,0,0,0
2973,DAMAN & DIU,2007,9,EXAM FAILURE,0,0,0,0,0,0,0,0,0,0,0,0,0,0,0,0,0,0,0
3519,DAMAN & DIU,2007,9,FAMILY PROBLEMS,0,0,0,0,0,0,0,0,0,0,0,0,0,0,0,0,0,0,0
4065,DAMAN & DIU,2007,9,HEALTH ISSUES,0,0,0,0,0,0,0,0,0,0,0,0,0,0,0,0,0,0,0
4610,DAMAN & DIU,2007,9,HERO WORSHIP,0,0,0,0,0,0,0,0,0,0,0,0,0,0,0,0,0,0,0
5155,DAMAN & DIU,2007,9,ILLEGITIMATE PREGNANCY,0,0,0,0,0,0,0,0,0,0,0,0,0,0,0,0,0,0,0
5700,DAMAN & DIU,2007,9,LOVE AFFAIRS,0,0,0,0,0,0,0,1,0,0,0,1,0,0,0,0,0,0,1
6246,DAMAN & DIU,2007,9,MARITAL ISSUES,0,0,0,0,0,0,0,0,0,0,0,0,0,0,0,0,0,0,0
6792,DAMAN & DIU,2007,9,MENTAL HEALTH,0,0,0,0,0,0,0,0,0,0,0,0,0,0,0,0,0,0,0
7338,DAMAN & DIU,2007,9,OTHERS,0,0,0,0,0,0,0,0,0,0,0,0,0,0,0,0,0,0,0
7922,DAMAN & DIU,2007,9,"PHYSICAL ABUSE (RAPE,INCEST ETC.)",0,0,0,0,0,0,0,0,0,0,0,0,0,0,0,0,0,0,0
8429,DAMAN & DIU,2007,9,SOCIETAL ISSUES,0,0,0,0,0,0,0,0,0,0,0,0,0,0,0,0,0,0,0
282,DAMAN & DIU,2008,9,CAUSES NOT KNOWN,0,4,4,1,0,9,0,1,0,0,2,3,0,0,0,0,0,0,12
828,DAMAN & DIU,2008,9,DEATH OF DEAR PERSON,0,0,0,0,0,0,0,0,0,0,0,0,0,0,0,0,0,0,0
1374,DAMAN & DIU,2008,9,DOWRY DISPUTE,0,0,0,0,0,0,0,0,0,0,0,0,0,0,0,0,0,0,0
1920,DAMAN & DIU,2008,9,DRUG ABUSE,0,0,0,0,0,0,0,0,0,0,0,0,0,0,0,0,0,0,0
2466,DAMAN & DIU,2008,9,ECONOMIC ISSUES,0,0,0,1,0,1,0,0,0,0,0,0,0,0,0,0,0,0,1
3012,DAMAN & DIU,2008,9,EXAM FAILURE,0,0,0,0,0,0,0,0,0,0,0,0,0,0,0,0,0,0,0
3558,DAMAN & DIU,2008,9,FAMILY PROBLEMS,0,0,0,0,0,0,0,0,0,1,0,1,0,0,0,0,0,0,1
4104,DAMAN & DIU,2008,9,HEALTH ISSUES,0,0,0,1,0,1,0,0,0,0,0,0,0,0,0,0,0,0,1
4649,DAMAN & DIU,2008,9,HERO WORSHIP,0,0,0,0,0,0,0,0,0,0,0,0,0,0,0,0,0,0,0
5194,DAMAN & DIU,2008,9,ILLEGITIMATE PREGNANCY,0,0,0,0,0,0,0,0,0,0,0,0,0,0,0,0,0,0,0
5739,DAMAN & DIU,2008,9,LOVE AFFAIRS,0,0,0,0,0,0,0,0,0,0,0,0,0,0,0,0,0,0,0
6285,DAMAN & DIU,2008,9,MARITAL ISSUES,0,0,0,1,0,1,0,0,0,0,0,0,0,0,0,0,0,0,1
6831,DAMAN & DIU,2008,9,MENTAL HEALTH,0,0,0,2,0,2,0,0,0,0,1,1,0,0,0,0,0,0,3
7377,DAMAN & DIU,2008,9,OTHERS,0,0,0,0,0,0,0,0,0,0,0,0,0,0,0,0,0,0,0
7961,DAMAN & DIU,2008,9,"PHYSICAL ABUSE (RAPE,INCEST ETC.)",0,0,0,0,0,0,0,0,0,0,0,0,0,0,0,0,0,0,0
8468,DAMAN & DIU,2008,9,SOCIETAL ISSUES,0,0,0,0,0,0,0,0,0,0,0,0,0,0,0,0,0,0,0
321,DAMAN & DIU,2009,9,CAUSES NOT KNOWN,0,6,0,1,2,9,0,0,5,1,0,6,0,0,0,0,0,0,15
867,DAMAN & DIU,2009,9,DEATH OF DEAR PERSON,0,0,0,0,0,0,0,0,0,0,0,0,0,0,0,0,0,0,0
1413,DAMAN & DIU,2009,9,DOWRY DISPUTE,0,0,0,0,0,0,0,0,0,0,0,0,0,0,0,0,0,0,0
1959,DAMAN & DIU,2009,9,DRUG ABUSE,0,0,0,0,0,0,0,0,0,0,0,0,0,0,0,0,0,0,0
2505,DAMAN & DIU,2009,9,ECONOMIC ISSUES,0,0,0,0,0,0,0,0,0,0,0,0,0,0,0,0,0,0,0
3051,DAMAN & DIU,2009,9,EXAM FAILURE,0,0,0,0,0,0,0,0,0,0,0,0,0,0,0,0,0,0,0
3597,DAMAN & DIU,2009,9,FAMILY PROBLEMS,0,0,0,1,0,1,0,0,0,0,0,0,0,0,0,0,0,0,1
4143,DAMAN & DIU,2009,9,HEALTH ISSUES,0,0,0,0,0,0,0,0,0,0,0,0,0,0,0,0,0,0,0
4688,DAMAN & DIU,2009,9,HERO WORSHIP,0,0,0,0,0,0,0,0,0,0,0,0,0,0,0,0,0,0,0
5233,DAMAN & DIU,2009,9,ILLEGITIMATE PREGNANCY,0,0,0,0,0,0,0,0,0,0,0,0,0,0,0,0,0,0,0
5778,DAMAN & DIU,2009,9,LOVE AFFAIRS,0,0,0,0,0,0,1,1,0,0,0,2,0,0,0,0,0,0,2
6324,DAMAN & DIU,2009,9,MARITAL ISSUES,0,0,0,0,0,0,0,0,0,0,0,0,0,0,0,0,0,0,0
6870,DAMAN & DIU,2009,9,MENTAL HEALTH,0,1,0,1,0,2,0,0,0,0,0,0,0,0,0,0,0,0,2
7416,DAMAN & DIU,2009,9,OTHERS,0,1,2,0,0,3,0,0,0,0,0,0,0,0,0,0,0,0,3
8000,DAMAN & DIU,2009,9,"PHYSICAL ABUSE (RAPE,INCEST ETC.)",0,0,0,0,0,0,0,0,0,0,0,0,0,0,0,0,0,0,0
8507,DAMAN & DIU,2009,9,SOCIETAL ISSUES,0,0,0,0,0,0,0,0,0,0,0,0,0,0,0,0,0,0,0
360,DAMAN & DIU,2010,9,CAUSES NOT KNOWN,1,5,5,2,0,13,0,6,1,0,0,7,0,0,0,0,0,0,20
906,DAMAN & DIU,2010,9,DEATH OF DEAR PERSON,0,0,0,0,0,0,0,0,0,0,0,0,0,0,0,0,0,0,0
1452,DAMAN & DIU,2010,9,DOWRY DISPUTE,0,0,0,0,0,0,0,0,0,0,0,0,0,0,0,0,0,0,0
1998,DAMAN & DIU,2010,9,DRUG ABUSE,0,0,0,0,0,0,0,0,0,0,0,0,0,0,0,0,0,0,0
2544,DAMAN & DIU,2010,9,ECONOMIC ISSUES,0,0,0,0,0,0,0,0,0,0,0,0,0,0,0,0,0,0,0
3090,DAMAN & DIU,2010,9,EXAM FAILURE,0,1,0,0,0,1,0,0,0,0,0,0,0,0,0,0,0,0,1
3636,DAMAN & DIU,2010,9,FAMILY PROBLEMS,0,0,1,0,0,1,0,0,0,0,0,0,0,0,0,0,0,0,1
4182,DAMAN & DIU,2010,9,HEALTH ISSUES,0,0,0,0,0,0,0,0,0,0,0,0,0,0,0,0,0,0,0
4727,DAMAN & DIU,2010,9,HERO WORSHIP,0,0,0,0,0,0,0,0,0,0,0,0,0,0,0,0,0,0,0
5272,DAMAN & DIU,2010,9,ILLEGITIMATE PREGNANCY,0,0,0,0,0,0,0,0,0,0,0,0,0,0,0,0,0,0,0
5817,DAMAN & DIU,2010,9,LOVE AFFAIRS,0,1,0,0,0,1,0,1,0,0,0,1,0,0,0,0,0,0,2
6363,DAMAN & DIU,2010,9,MARITAL ISSUES,0,0,0,0,0,0,0,0,0,0,0,0,0,0,0,0,0,0,0
6909,DAMAN & DIU,2010,9,MENTAL HEALTH,2,1,0,0,0,3,0,2,0,0,0,2,0,0,0,0,0,0,5
7455,DAMAN & DIU,2010,9,OTHERS,0,0,0,0,0,0,0,1,1,0,0,2,0,0,0,0,0,0,2
8039,DAMAN & DIU,2010,9,"PHYSICAL ABUSE (RAPE,INCEST ETC.)",0,0,0,0,0,0,0,0,0,0,0,0,0,0,0,0,0,0,0
8546,DAMAN & DIU,2010,9,SOCIETAL ISSUES,0,0,0,0,0,0,0,0,0,0,0,0,0,0,0,0,0,0,0
399,DAMAN & DIU,2011,9,CAUSES NOT KNOWN,0,3,5,4,0,12,0,10,1,1,0,12,0,0,0,0,0,0,24
945,DAMAN & DIU,2011,9,DEATH OF DEAR PERSON,0,0,0,0,0,0,0,0,0,0,0,0,0,0,0,0,0,0,0
1491,DAMAN & DIU,2011,9,DOWRY DISPUTE,0,0,0,0,0,0,0,0,0,0,0,0,0,0,0,0,0,0,0
2037,DAMAN & DIU,2011,9,DRUG ABUSE,0,0,0,0,0,0,0,0,0,0,0,0,0,0,0,0,0,0,0
2583,DAMAN & DIU,2011,9,ECONOMIC ISSUES,0,0,0,0,0,0,0,0,0,0,0,0,0,0,0,0,0,0,0
3129,DAMAN & DIU,2011,9,EXAM FAILURE,0,0,0,0,0,0,0,0,0,0,0,0,0,0,0,0,0,0,0
3675,DAMAN & DIU,2011,9,FAMILY PROBLEMS,0,2,0,0,0,2,0,0,0,0,0,0,0,0,0,0,0,0,2
4221,DAMAN & DIU,2011,9,HEALTH ISSUES,0,0,0,0,0,0,0,0,0,0,0,0,0,0,0,0,0,0,0
4766,DAMAN & DIU,2011,9,HERO WORSHIP,0,0,0,0,0,0,0,0,0,0,0,0,0,0,0,0,0,0,0
5311,DAMAN & DIU,2011,9,ILLEGITIMATE PREGNANCY,0,0,0,0,0,0,0,0,0,0,0,0,0,0,0,0,0,0,0
5856,DAMAN & DIU,2011,9,LOVE AFFAIRS,0,0,0,0,0,0,0,2,0,0,0,2,0,0,0,0,0,0,2
6402,DAMAN & DIU,2011,9,MARITAL ISSUES,0,0,0,0,0,0,0,0,0,0,0,0,0,0,0,0,0,0,0
6948,DAMAN & DIU,2011,9,MENTAL HEALTH,0,0,0,0,0,0,0,0,0,0,0,0,0,0,0,0,0,0,0
7494,DAMAN & DIU,2011,9,OTHERS,1,2,1,0,0,4,0,1,0,0,0,1,0,0,0,0,0,0,5
8078,DAMAN & DIU,2011,9,"PHYSICAL ABUSE (RAPE,INCEST ETC.)",0,0,0,0,0,0,0,0,0,0,0,0,0,0,0,0,0,0,0
8585,DAMAN & DIU,2011,9,SOCIETAL ISSUES,0,0,0,0,0,0,0,0,0,0,0,0,0,0,0,0,0,0,0
438,DAMAN & DIU,2012,9,CAUSES NOT KNOWN,0,3,2,1,0,6,1,5,1,0,0,7,0,0,0,0,0,0,13
984,DAMAN & DIU,2012,9,DEATH OF DEAR PERSON,0,0,0,0,0,0,0,0,0,0,0,0,0,0,0,0,0,0,0
1530,DAMAN & DIU,2012,9,DOWRY DISPUTE,0,0,0,0,0,0,0,0,0,0,0,0,0,0,0,0,0,0,0
2076,DAMAN & DIU,2012,9,DRUG ABUSE,0,0,0,0,0,0,0,0,0,0,0,0,0,0,0,0,0,0,0
2622,DAMAN & DIU,2012,9,ECONOMIC ISSUES,0,0,0,0,0,0,0,0,0,0,0,0,0,0,0,0,0,0,0
3168,DAMAN & DIU,2012,9,EXAM FAILURE,0,0,0,0,0,0,0,0,0,0,0,0,0,0,0,0,0,0,0
3714,DAMAN & DIU,2012,9,FAMILY PROBLEMS,0,0,0,0,0,0,0,0,1,0,0,1,0,0,0,0,0,0,1
4260,DAMAN & DIU,2012,9,HEALTH ISSUES,0,0,0,0,0,0,0,0,0,0,0,0,0,0,0,0,0,0,0
4805,DAMAN & DIU,2012,9,HERO WORSHIP,0,0,0,0,0,0,0,0,0,0,0,0,0,0,0,0,0,0,0
5350,DAMAN & DIU,2012,9,ILLEGITIMATE PREGNANCY,0,0,0,0,0,0,0,0,0,0,0,0,0,0,0,0,0,0,0
5895,DAMAN & DIU,2012,9,LOVE AFFAIRS,0,0,0,0,0,0,0,0,0,0,0,0,0,0,0,0,0,0,0
6441,DAMAN & DIU,2012,9,MARITAL ISSUES,0,0,0,0,0,0,0,0,0,0,0,0,0,0,0,0,0,0,0
6987,DAMAN & DIU,2012,9,MENTAL HEALTH,0,0,2,0,0,2,0,0,0,0,0,0,0,0,0,0,0,0,2
7533,DAMAN & DIU,2012,9,OTHERS,0,3,8,5,0,16,0,0,3,0,0,3,0,0,0,0,0,0,19
8117,DAMAN & DIU,2012,9,"PHYSICAL ABUSE (RAPE,INCEST ETC.)",0,0,0,0,0,0,0,0,0,0,0,0,0,0,0,0,0,0,0
8624,DAMAN & DIU,2012,9,SOCIETAL ISSUES,0,0,1,0,0,1,0,0,0,0,0,0,0,0,0,0,0,0,1
477,DAMAN & DIU,2013,9,CAUSES NOT KNOWN,0,6,1,2,0,9,0,4,3,2,0,9,0,0,0,0,0,0,18
1023,DAMAN & DIU,2013,9,DEATH OF DEAR PERSON,0,0,0,0,0,0,0,0,0,0,0,0,0,0,0,0,0,0,0
1569,DAMAN & DIU,2013,9,DOWRY DISPUTE,0,0,0,0,0,0,0,0,0,0,0,0,0,0,0,0,0,0,0
2115,DAMAN & DIU,2013,9,DRUG ABUSE,0,0,0,0,0,0,0,0,0,0,0,0,0,0,0,0,0,0,0
2661,DAMAN & DIU,2013,9,ECONOMIC ISSUES,0,0,0,0,0,0,0,0,0,0,0,0,0,0,0,0,0,0,0
3207,DAMAN & DIU,2013,9,EXAM FAILURE,0,0,0,0,0,0,0,0,0,0,0,0,0,0,0,0,0,0,0
3753,DAMAN & DIU,2013,9,FAMILY PROBLEMS,0,1,1,1,0,3,0,1,1,0,0,2,0,0,0,0,0,0,5
4299,DAMAN & DIU,2013,9,HEALTH ISSUES,0,0,0,0,0,0,0,1,1,0,0,2,0,0,0,0,0,0,2
4844,DAMAN & DIU,2013,9,HERO WORSHIP,0,0,0,0,0,0,0,0,0,0,0,0,0,0,0,0,0,0,0
5389,DAMAN & DIU,2013,9,ILLEGITIMATE PREGNANCY,0,0,0,0,0,0,0,0,0,0,0,0,0,0,0,0,0,0,0
5934,DAMAN & DIU,2013,9,LOVE AFFAIRS,0,0,0,0,0,0,0,0,0,0,0,0,0,0,0,0,0,0,0
6480,DAMAN & DIU,2013,9,MARITAL ISSUES,0,0,0,0,0,0,0,0,0,0,0,0,0,0,0,0,0,0,0
7026,DAMAN & DIU,2013,9,MENTAL HEALTH,0,0,0,0,0,0,0,0,0,0,0,0,0,0,0,0,0,0,0
7572,DAMAN & DIU,2013,9,OTHERS,0,1,0,0,0,1,0,2,0,1,0,3,0,0,0,0,0,0,4
8156,DAMAN & DIU,2013,9,"PHYSICAL ABUSE (RAPE,INCEST ETC.)",0,0,0,0,0,0,0,0,0,0,0,0,0,0,0,0,0,0,0
8663,DAMAN & DIU,2013,9,SOCIETAL ISSUES,0,0,0,0,0,0,0,0,0,0,0,0,0,0,0,0,0,0,0
516,DAMAN & DIU,2014,9,CAUSES NOT KNOWN,0,10,7,1,1,19,0,2,2,0,0,4,0,0,0,0,0,0,23
1062,DAMAN & DIU,2014,9,DEATH OF DEAR PERSON,0,0,0,0,0,0,0,0,0,0,0,0,0,0,0,0,0,0,0
1608,DAMAN & DIU,2014,9,DOWRY DISPUTE,0,0,0,0,0,0,0,0,0,0,0,0,0,0,0,0,0,0,0
2154,DAMAN & DIU,2014,9,DRUG ABUSE,0,0,0,0,0,0,0,0,0,0,0,0,0,0,0,0,0,0,0
2700,DAMAN & DIU,2014,9,ECONOMIC ISSUES,0,0,0,0,0,0,0,0,0,0,0,0,0,0,0,0,0,0,0
3246,DAMAN & DIU,2014,9,EXAM FAILURE,0,0,0,0,0,0,0,0,0,0,0,0,0,0,0,0,0,0,0
3792,DAMAN & DIU,2014,9,FAMILY PROBLEMS,0,0,0,0,0,0,0,0,0,0,0,0,0,0,0,0,0,0,0
4338,DAMAN & DIU,2014,9,HEALTH ISSUES,0,0,0,0,0,0,0,1,0,0,0,1,0,0,0,0,0,0,1
4883,DAMAN & DIU,2014,9,HERO WORSHIP,0,0,0,0,0,0,0,0,0,0,0,0,0,0,0,0,0,0,0
5428,DAMAN & DIU,2014,9,ILLEGITIMATE PREGNANCY,0,0,0,0,0,0,0,0,0,0,0,0,0,0,0,0,0,0,0
5973,DAMAN & DIU,2014,9,LOVE AFFAIRS,0,0,0,0,0,0,0,0,0,0,0,0,0,0,0,0,0,0,0
6519,DAMAN & DIU,2014,9,MARITAL ISSUES,0,0,0,0,0,0,0,0,0,0,0,0,0,0,0,0,0,0,0
7065,DAMAN & DIU,2014,9,MENTAL HEALTH,0,0,0,0,0,0,0,1,0,0,0,1,0,0,0,0,0,0,1
7611,DAMAN & DIU,2014,9,OTHERS,0,1,1,1,0,3,0,0,0,0,0,0,0,0,0,0,0,0,3
7650,DAMAN & DIU,2014,9,PHYSICAL ABUSE,0,0,0,0,0,0,0,0,0,0,0,0,0,0,0,0,0,0,0
8702,DAMAN & DIU,2014,9,SOCIETAL ISSUES,0,0,0,0,0,0,0,0,0,0,0,0,0,0,0,0,0,0,0
10,DELHI (UT),2001,10,CAUSES NOT KNOWN,5,110,98,53,9,275,7,96,63,11,6,183,0,0,0,0,0,0,458
556,DELHI (UT),2001,10,DEATH OF DEAR PERSON,0,3,1,2,0,6,0,3,2,0,0,5,0,0,0,0,0,0,11
1102,DELHI (UT),2001,10,DOWRY DISPUTE,0,1,0,0,0,1,0,23,6,0,0,29,0,0,0,0,0,0,30
1648,DELHI (UT),2001,10,DRUG ABUSE,0,2,10,4,1,17,0,1,0,0,0,1,0,0,0,0,0,0,18
2194,DELHI (UT),2001,10,ECONOMIC ISSUES,3,54,51,13,1,122,2,15,23,2,0,42,0,0,0,0,0,0,164
2740,DELHI (UT),2001,10,EXAM FAILURE,0,13,0,0,0,13,2,8,0,0,0,10,0,0,0,0,0,0,23
3286,DELHI (UT),2001,10,FAMILY PROBLEMS,5,82,67,13,4,171,11,79,49,14,2,155,0,0,0,0,0,0,326
3832,DELHI (UT),2001,10,HEALTH ISSUES,0,11,16,19,8,54,5,12,2,2,2,23,0,0,0,0,0,0,77
4378,DELHI (UT),2001,10,HERO WORSHIP,0,0,0,1,0,1,0,0,1,0,0,1,0,0,0,0,0,0,2
4923,DELHI (UT),2001,10,ILLEGITIMATE PREGNANCY,0,0,0,0,0,0,0,2,0,0,0,2,0,0,0,0,0,0,2
5468,DELHI (UT),2001,10,LOVE AFFAIRS,0,13,1,0,0,14,1,13,0,0,0,14,0,0,0,0,0,0,28
6013,DELHI (UT),2001,10,MARITAL ISSUES,0,2,1,3,0,6,0,12,3,0,0,15,0,0,0,0,0,0,21
6559,DELHI (UT),2001,10,MENTAL HEALTH,0,2,3,2,0,7,0,5,4,0,1,10,0,0,0,0,0,0,17
7105,DELHI (UT),2001,10,OTHERS,2,17,12,5,2,38,0,8,4,2,0,14,0,0,0,0,0,0,52
7690,DELHI (UT),2001,10,"PHYSICAL ABUSE (RAPE,INCEST ETC.)",0,0,0,0,0,0,0,4,0,0,0,4,0,0,0,0,0,0,4
8196,DELHI (UT),2001,10,SOCIETAL ISSUES,0,5,0,0,0,5,0,1,0,0,0,1,0,0,0,0,0,0,6
49,DELHI (UT),2002,10,CAUSES NOT KNOWN,8,88,61,32,5,194,4,56,26,9,2,97,0,0,0,0,0,0,291
595,DELHI (UT),2002,10,DEATH OF DEAR PERSON,0,2,0,1,0,3,0,1,0,0,0,1,0,0,0,0,0,0,4
1141,DELHI (UT),2002,10,DOWRY DISPUTE,0,1,0,0,0,1,0,34,15,1,0,50,0,0,0,0,0,0,51
1687,DELHI (UT),2002,10,DRUG ABUSE,0,17,4,2,0,23,0,0,1,0,0,1,0,0,0,0,0,0,24
2233,DELHI (UT),2002,10,ECONOMIC ISSUES,0,26,33,15,0,74,1,4,2,3,0,10,0,0,0,0,0,0,84
2779,DELHI (UT),2002,10,EXAM FAILURE,5,13,0,0,0,18,6,11,0,0,0,17,0,0,0,0,0,0,35
3325,DELHI (UT),2002,10,FAMILY PROBLEMS,2,100,85,23,3,213,4,69,54,7,1,135,0,0,0,0,0,0,348
3871,DELHI (UT),2002,10,HEALTH ISSUES,0,15,13,13,5,46,0,6,12,3,1,22,0,0,0,0,0,0,68
4417,DELHI (UT),2002,10,HERO WORSHIP,0,0,0,0,0,0,0,0,0,0,0,0,0,0,0,0,0,0,0
4962,DELHI (UT),2002,10,ILLEGITIMATE PREGNANCY,0,0,0,0,0,0,0,2,2,0,0,4,0,0,0,0,0,0,4
5507,DELHI (UT),2002,10,LOVE AFFAIRS,0,13,2,0,0,15,0,21,1,0,0,22,0,0,0,0,0,0,37
6052,DELHI (UT),2002,10,MARITAL ISSUES,0,5,4,1,0,10,0,11,5,0,0,16,0,0,0,0,0,0,26
6598,DELHI (UT),2002,10,MENTAL HEALTH,0,7,5,3,3,18,0,2,4,0,0,6,0,0,0,0,0,0,24
7144,DELHI (UT),2002,10,OTHERS,0,11,10,3,0,24,1,18,2,0,0,21,0,0,0,0,0,0,45
7729,DELHI (UT),2002,10,"PHYSICAL ABUSE (RAPE,INCEST ETC.)",0,0,0,0,0,0,0,4,0,0,0,4,0,0,0,0,0,0,4
8235,DELHI (UT),2002,10,SOCIETAL ISSUES,0,3,1,0,0,4,0,2,2,0,0,4,0,0,0,0,0,0,8
88,DELHI (UT),2003,10,CAUSES NOT KNOWN,9,98,73,30,3,213,7,61,36,12,2,118,0,0,0,0,0,0,331
634,DELHI (UT),2003,10,DEATH OF DEAR PERSON,0,2,0,0,0,2,0,1,0,0,0,1,0,0,0,0,0,0,3
1180,DELHI (UT),2003,10,DOWRY DISPUTE,0,1,0,0,0,1,1,29,5,7,0,42,0,0,0,0,0,0,43
1726,DELHI (UT),2003,10,DRUG ABUSE,0,9,8,1,0,18,0,0,0,0,0,0,0,0,0,0,0,0,18
2272,DELHI (UT),2003,10,ECONOMIC ISSUES,0,31,25,3,1,60,0,7,3,0,0,10,0,0,0,0,0,0,70
2818,DELHI (UT),2003,10,EXAM FAILURE,2,14,1,0,0,17,6,14,0,0,0,20,0,0,0,0,0,0,37
3364,DELHI (UT),2003,10,FAMILY PROBLEMS,3,89,92,25,0,209,3,71,35,9,0,118,0,0,0,0,0,0,327
3910,DELHI (UT),2003,10,HEALTH ISSUES,0,11,30,19,9,69,0,5,10,7,2,24,0,0,0,0,0,0,93
4456,DELHI (UT),2003,10,HERO WORSHIP,0,0,0,0,0,0,0,0,0,0,0,0,0,0,0,0,0,0,0
5001,DELHI (UT),2003,10,ILLEGITIMATE PREGNANCY,0,0,0,0,0,0,0,0,0,0,0,0,0,0,0,0,0,0,0
5546,DELHI (UT),2003,10,LOVE AFFAIRS,0,13,1,0,0,14,0,13,0,0,0,13,0,0,0,0,0,0,27
6091,DELHI (UT),2003,10,MARITAL ISSUES,0,8,3,0,0,11,1,6,6,0,0,13,0,0,0,0,0,0,24
6637,DELHI (UT),2003,10,MENTAL HEALTH,0,6,5,0,0,11,0,3,4,2,0,9,0,0,0,0,0,0,20
7183,DELHI (UT),2003,10,OTHERS,4,45,38,12,14,113,1,22,13,4,1,41,0,0,0,0,0,0,154
7768,DELHI (UT),2003,10,"PHYSICAL ABUSE (RAPE,INCEST ETC.)",0,1,0,0,0,1,0,3,0,0,0,3,0,0,0,0,0,0,4
8274,DELHI (UT),2003,10,SOCIETAL ISSUES,0,0,2,0,0,2,0,0,0,0,0,0,0,0,0,0,0,0,2
127,DELHI (UT),2004,10,CAUSES NOT KNOWN,6,125,102,28,3,264,4,71,24,6,4,109,0,0,0,0,0,0,373
673,DELHI (UT),2004,10,DEATH OF DEAR PERSON,0,0,0,0,0,0,0,2,0,0,0,2,0,0,0,0,0,0,2
1219,DELHI (UT),2004,10,DOWRY DISPUTE,0,0,0,0,0,0,0,46,6,0,0,52,0,0,0,0,0,0,52
1765,DELHI (UT),2004,10,DRUG ABUSE,0,8,7,3,0,18,0,1,1,0,0,2,0,0,0,0,0,0,20
2311,DELHI (UT),2004,10,ECONOMIC ISSUES,3,37,33,8,1,82,0,11,2,1,1,15,0,0,0,0,0,0,97
2857,DELHI (UT),2004,10,EXAM FAILURE,4,23,0,0,0,27,4,14,0,0,0,18,0,0,0,0,0,0,45
3403,DELHI (UT),2004,10,FAMILY PROBLEMS,1,69,83,24,6,183,0,55,43,8,9,115,0,0,0,0,0,0,298
3949,DELHI (UT),2004,10,HEALTH ISSUES,1,20,15,23,5,64,2,20,13,4,2,41,0,0,0,0,0,0,105
4495,DELHI (UT),2004,10,HERO WORSHIP,0,1,0,0,0,1,0,1,1,0,0,2,0,0,0,0,0,0,3
5040,DELHI (UT),2004,10,ILLEGITIMATE PREGNANCY,0,0,0,0,0,0,0,0,0,0,0,0,0,0,0,0,0,0,0
5585,DELHI (UT),2004,10,LOVE AFFAIRS,0,8,0,1,0,9,1,15,0,0,0,16,0,0,0,0,0,0,25
6130,DELHI (UT),2004,10,MARITAL ISSUES,0,4,2,0,0,6,0,22,1,0,0,23,0,0,0,0,0,0,29
6676,DELHI (UT),2004,10,MENTAL HEALTH,0,6,5,5,2,18,2,5,2,0,0,9,0,0,0,0,0,0,27
7222,DELHI (UT),2004,10,OTHERS,4,38,48,26,3,119,4,17,22,5,0,48,0,0,0,0,0,0,167
7807,DELHI (UT),2004,10,"PHYSICAL ABUSE (RAPE,INCEST ETC.)",0,0,0,0,0,0,0,1,1,0,0,2,0,0,0,0,0,0,2
8313,DELHI (UT),2004,10,SOCIETAL ISSUES,0,3,3,2,0,8,0,2,1,0,0,3,0,0,0,0,0,0,11
166,DELHI (UT),2005,10,CAUSES NOT KNOWN,3,137,85,33,2,260,6,79,44,7,1,137,0,0,0,0,0,0,397
712,DELHI (UT),2005,10,DEATH OF DEAR PERSON,0,3,1,0,0,4,0,1,1,0,0,2,0,0,0,0,0,0,6
1258,DELHI (UT),2005,10,DOWRY DISPUTE,0,4,0,0,0,4,0,44,6,1,0,51,0,0,0,0,0,0,55
1804,DELHI (UT),2005,10,DRUG ABUSE,0,6,10,2,0,18,0,0,1,0,0,1,0,0,0,0,0,0,19
2350,DELHI (UT),2005,10,ECONOMIC ISSUES,0,31,37,1,2,71,0,9,6,1,0,16,0,0,0,0,0,0,87
2896,DELHI (UT),2005,10,EXAM FAILURE,3,12,2,0,0,17,2,8,0,0,0,10,0,0,0,0,0,0,27
3442,DELHI (UT),2005,10,FAMILY PROBLEMS,0,88,76,40,13,217,0,75,45,6,3,129,0,0,0,0,0,0,346
3988,DELHI (UT),2005,10,HEALTH ISSUES,0,21,13,13,5,52,0,15,10,6,2,33,0,0,0,0,0,0,85
4534,DELHI (UT),2005,10,HERO WORSHIP,0,0,0,0,0,0,0,1,0,0,0,1,0,0,0,0,0,0,1
5079,DELHI (UT),2005,10,ILLEGITIMATE PREGNANCY,0,0,0,0,0,0,0,0,0,0,0,0,0,0,0,0,0,0,0
5624,DELHI (UT),2005,10,LOVE AFFAIRS,0,23,5,0,0,28,1,17,2,0,0,20,0,0,0,0,0,0,48
6169,DELHI (UT),2005,10,MARITAL ISSUES,0,1,2,0,0,3,0,3,3,0,0,6,0,0,0,0,0,0,9
6715,DELHI (UT),2005,10,MENTAL HEALTH,0,5,3,3,0,11,1,6,0,1,0,8,0,0,0,0,0,0,19
7261,DELHI (UT),2005,10,OTHERS,2,25,25,15,2,69,3,19,16,3,2,43,0,0,0,0,0,0,112
7846,DELHI (UT),2005,10,"PHYSICAL ABUSE (RAPE,INCEST ETC.)",0,0,0,0,0,0,0,0,0,0,0,0,0,0,0,0,0,0,0
8352,DELHI (UT),2005,10,SOCIETAL ISSUES,0,14,5,4,0,23,0,4,6,1,0,11,0,0,0,0,0,0,34
205,DELHI (UT),2006,10,CAUSES NOT KNOWN,5,183,148,62,11,409,9,118,64,9,2,202,0,0,0,0,0,0,611
751,DELHI (UT),2006,10,DEATH OF DEAR PERSON,0,1,0,1,0,2,0,1,1,1,1,4,0,0,0,0,0,0,6
1297,DELHI (UT),2006,10,DOWRY DISPUTE,0,0,0,0,0,0,0,62,7,0,0,69,0,0,0,0,0,0,69
1843,DELHI (UT),2006,10,DRUG ABUSE,0,7,11,2,0,20,0,1,1,0,0,2,0,0,0,0,0,0,22
2389,DELHI (UT),2006,10,ECONOMIC ISSUES,0,51,29,15,0,95,0,8,2,1,0,11,0,0,0,0,0,0,106
2935,DELHI (UT),2006,10,EXAM FAILURE,1,8,0,0,0,9,4,9,0,0,0,13,0,0,0,0,0,0,22
3481,DELHI (UT),2006,10,FAMILY PROBLEMS,0,110,89,20,4,223,0,75,54,6,0,135,0,0,0,0,0,0,358
4027,DELHI (UT),2006,10,HEALTH ISSUES,0,18,28,19,5,70,0,16,3,6,0,25,0,0,0,0,0,0,95
4573,DELHI (UT),2006,10,HERO WORSHIP,0,0,0,0,0,0,0,0,0,0,0,0,0,0,0,0,0,0,0
5118,DELHI (UT),2006,10,ILLEGITIMATE PREGNANCY,0,0,0,0,0,0,0,1,0,0,0,1,0,0,0,0,0,0,1
5663,DELHI (UT),2006,10,LOVE AFFAIRS,1,32,1,0,0,34,2,15,3,0,0,20,0,0,0,0,0,0,54
6208,DELHI (UT),2006,10,MARITAL ISSUES,0,1,2,1,0,4,0,6,3,1,0,10,0,0,0,0,0,0,14
6754,DELHI (UT),2006,10,MENTAL HEALTH,0,13,6,4,2,25,0,8,1,1,1,11,0,0,0,0,0,0,36
7300,DELHI (UT),2006,10,OTHERS,2,25,19,11,1,58,1,14,6,2,1,24,0,0,0,0,0,0,82
7885,DELHI (UT),2006,10,"PHYSICAL ABUSE (RAPE,INCEST ETC.)",0,0,0,0,0,0,0,0,0,0,0,0,0,0,0,0,0,0,0
8391,DELHI (UT),2006,10,SOCIETAL ISSUES,0,0,7,4,0,11,0,1,3,1,0,5,0,0,0,0,0,0,16
244,DELHI (UT),2007,10,CAUSES NOT KNOWN,3,192,163,54,7,419,7,105,44,4,2,162,0,0,0,0,0,0,581
790,DELHI (UT),2007,10,DEATH OF DEAR PERSON,0,1,1,0,1,3,0,1,0,0,0,1,0,0,0,0,0,0,4
1336,DELHI (UT),2007,10,DOWRY DISPUTE,0,2,0,0,0,2,0,64,5,0,0,69,0,0,0,0,0,0,71
1882,DELHI (UT),2007,10,DRUG ABUSE,0,10,6,0,0,16,0,1,0,0,1,2,0,0,0,0,0,0,18
2428,DELHI (UT),2007,10,ECONOMIC ISSUES,0,46,24,8,1,79,0,14,2,0,0,16,0,0,0,0,0,0,95
2974,DELHI (UT),2007,10,EXAM FAILURE,4,19,1,0,0,24,2,17,0,0,0,19,0,0,0,0,0,0,43
3520,DELHI (UT),2007,10,FAMILY PROBLEMS,1,72,97,21,4,195,0,64,56,6,2,128,0,0,0,0,0,0,323
4066,DELHI (UT),2007,10,HEALTH ISSUES,1,17,21,7,9,55,2,7,3,2,1,15,0,0,0,0,0,0,70
4611,DELHI (UT),2007,10,HERO WORSHIP,0,0,0,0,0,0,0,3,2,2,0,7,0,0,0,0,0,0,7
5156,DELHI (UT),2007,10,ILLEGITIMATE PREGNANCY,0,0,0,0,0,0,0,0,0,0,0,0,0,0,0,0,0,0,0
5701,DELHI (UT),2007,10,LOVE AFFAIRS,0,17,2,0,0,19,0,28,2,0,0,30,0,0,0,0,0,0,49
6247,DELHI (UT),2007,10,MARITAL ISSUES,0,6,1,0,0,7,1,10,3,0,0,14,0,0,0,0,0,0,21
6793,DELHI (UT),2007,10,MENTAL HEALTH,0,3,3,6,1,13,0,1,4,2,1,8,0,0,0,0,0,0,21
7339,DELHI (UT),2007,10,OTHERS,4,44,55,18,8,129,3,29,7,2,1,42,0,0,0,0,0,0,171
7923,DELHI (UT),2007,10,"PHYSICAL ABUSE (RAPE,INCEST ETC.)",0,0,0,0,0,0,0,0,0,0,0,0,0,0,0,0,0,0,0
8430,DELHI (UT),2007,10,SOCIETAL ISSUES,0,2,1,1,1,5,0,2,0,0,0,2,0,0,0,0,0,0,7
283,DELHI (UT),2008,10,CAUSES NOT KNOWN,3,134,119,28,7,291,3,100,36,10,1,150,0,0,0,0,0,0,441
829,DELHI (UT),2008,10,DEATH OF DEAR PERSON,0,1,2,1,0,4,0,4,1,1,0,6,0,0,0,0,0,0,10
1375,DELHI (UT),2008,10,DOWRY DISPUTE,0,0,0,0,0,0,0,37,10,0,0,47,0,0,0,0,0,0,47
1921,DELHI (UT),2008,10,DRUG ABUSE,0,11,6,1,0,18,0,2,1,0,0,3,0,0,0,0,0,0,21
2467,DELHI (UT),2008,10,ECONOMIC ISSUES,0,55,44,13,1,113,1,13,5,2,0,21,0,0,0,0,0,0,134
3013,DELHI (UT),2008,10,EXAM FAILURE,9,26,0,0,1,36,4,17,4,0,0,25,0,0,0,0,0,0,61
3559,DELHI (UT),2008,10,FAMILY PROBLEMS,3,52,55,30,7,147,0,81,39,7,0,127,0,0,0,0,0,0,274
4105,DELHI (UT),2008,10,HEALTH ISSUES,1,10,26,9,9,55,1,13,7,2,2,25,0,0,0,0,0,0,80
4650,DELHI (UT),2008,10,HERO WORSHIP,0,0,1,0,0,1,0,0,0,0,0,0,0,0,0,0,0,0,1
5195,DELHI (UT),2008,10,ILLEGITIMATE PREGNANCY,0,0,0,0,0,0,2,1,0,0,0,3,0,0,0,0,0,0,3
5740,DELHI (UT),2008,10,LOVE AFFAIRS,0,26,0,0,0,26,1,35,1,0,0,37,0,0,0,0,0,0,63
6286,DELHI (UT),2008,10,MARITAL ISSUES,0,7,2,0,0,9,1,15,3,0,0,19,0,0,0,0,0,0,28
6832,DELHI (UT),2008,10,MENTAL HEALTH,0,3,6,6,0,15,1,3,2,2,0,8,0,0,0,0,0,0,23
7378,DELHI (UT),2008,10,OTHERS,0,44,21,7,0,72,4,25,6,1,0,36,0,0,0,0,0,0,108
7962,DELHI (UT),2008,10,"PHYSICAL ABUSE (RAPE,INCEST ETC.)",0,0,0,0,0,0,0,1,0,0,0,1,0,0,0,0,0,0,1
8469,DELHI (UT),2008,10,SOCIETAL ISSUES,0,2,4,2,0,8,0,0,0,0,0,0,0,0,0,0,0,0,8
322,DELHI (UT),2009,10,CAUSES NOT KNOWN,6,135,89,28,12,270,4,98,37,9,1,149,0,0,0,0,0,0,419
868,DELHI (UT),2009,10,DEATH OF DEAR PERSON,0,1,1,0,1,3,0,1,2,0,0,3,0,0,0,0,0,0,6
1414,DELHI (UT),2009,10,DOWRY DISPUTE,0,0,0,0,0,0,0,41,7,0,0,48,0,0,0,0,0,0,48
1960,DELHI (UT),2009,10,DRUG ABUSE,0,15,17,5,0,37,0,0,0,0,0,0,0,0,0,0,0,0,37
2506,DELHI (UT),2009,10,ECONOMIC ISSUES,0,64,36,15,2,117,1,18,3,2,1,25,0,0,0,0,0,0,142
3052,DELHI (UT),2009,10,EXAM FAILURE,4,21,0,0,0,25,1,21,1,0,0,23,0,0,0,0,0,0,48
3598,DELHI (UT),2009,10,FAMILY PROBLEMS,1,84,75,32,4,196,5,83,41,7,0,136,0,0,0,0,0,0,332
4144,DELHI (UT),2009,10,HEALTH ISSUES,1,16,19,14,6,56,0,9,5,7,3,24,0,0,0,0,0,0,80
4689,DELHI (UT),2009,10,HERO WORSHIP,0,0,0,0,0,0,0,0,0,0,0,0,0,0,0,0,0,0,0
5234,DELHI (UT),2009,10,ILLEGITIMATE PREGNANCY,0,0,0,0,0,0,0,0,0,0,0,0,0,0,0,0,0,0,0
5779,DELHI (UT),2009,10,LOVE AFFAIRS,0,24,0,0,0,24,2,34,0,0,0,36,0,0,0,0,0,0,60
6325,DELHI (UT),2009,10,MARITAL ISSUES,0,10,11,0,0,21,2,15,6,0,0,23,0,0,0,0,0,0,44
6871,DELHI (UT),2009,10,MENTAL HEALTH,0,12,3,1,1,17,1,1,1,0,0,3,0,0,0,0,0,0,20
7417,DELHI (UT),2009,10,OTHERS,3,74,74,13,2,166,3,37,22,8,2,72,0,0,0,0,0,0,238
8001,DELHI (UT),2009,10,"PHYSICAL ABUSE (RAPE,INCEST ETC.)",0,0,0,0,0,0,0,0,0,0,0,0,0,0,0,0,0,0,0
8508,DELHI (UT),2009,10,SOCIETAL ISSUES,0,1,0,0,0,1,0,2,0,0,0,2,0,0,0,0,0,0,3
361,DELHI (UT),2010,10,CAUSES NOT KNOWN,6,184,136,48,27,401,12,127,47,12,4,202,0,0,0,0,0,0,603
907,DELHI (UT),2010,10,DEATH OF DEAR PERSON,0,0,3,1,0,4,1,9,2,0,0,12,0,0,0,0,0,0,16
1453,DELHI (UT),2010,10,DOWRY DISPUTE,0,0,0,0,0,0,0,29,5,0,0,34,0,0,0,0,0,0,34
1999,DELHI (UT),2010,10,DRUG ABUSE,1,10,8,2,2,23,0,0,1,0,0,1,0,0,0,0,0,0,24
2545,DELHI (UT),2010,10,ECONOMIC ISSUES,0,41,38,14,2,95,0,10,2,2,0,14,0,0,0,0,0,0,109
3091,DELHI (UT),2010,10,EXAM FAILURE,2,19,2,0,0,23,3,15,1,0,0,19,0,0,0,0,0,0,42
3637,DELHI (UT),2010,10,FAMILY PROBLEMS,1,69,79,35,5,189,3,76,54,12,5,150,0,0,0,0,0,0,339
4183,DELHI (UT),2010,10,HEALTH ISSUES,0,12,13,12,5,42,1,3,4,4,0,12,0,0,0,0,0,0,54
4728,DELHI (UT),2010,10,HERO WORSHIP,0,0,0,0,0,0,0,0,0,0,0,0,0,0,0,0,0,0,0
5273,DELHI (UT),2010,10,ILLEGITIMATE PREGNANCY,0,0,0,0,0,0,0,0,0,0,0,0,0,0,0,0,0,0,0
5818,DELHI (UT),2010,10,LOVE AFFAIRS,1,27,3,0,0,31,0,24,2,1,0,27,0,0,0,0,0,0,58
6364,DELHI (UT),2010,10,MARITAL ISSUES,0,6,4,0,0,10,0,11,8,0,0,19,0,0,0,0,0,0,29
6910,DELHI (UT),2010,10,MENTAL HEALTH,0,5,7,2,1,15,0,2,1,0,0,3,0,0,0,0,0,0,18
7456,DELHI (UT),2010,10,OTHERS,5,45,42,13,4,109,2,46,19,3,0,70,0,0,0,0,0,0,179
8040,DELHI (UT),2010,10,"PHYSICAL ABUSE (RAPE,INCEST ETC.)",0,1,0,0,0,1,1,2,0,0,0,3,0,0,0,0,0,0,4
8547,DELHI (UT),2010,10,SOCIETAL ISSUES,0,10,4,3,1,18,1,9,4,2,0,16,0,0,0,0,0,0,34
400,DELHI (UT),2011,10,CAUSES NOT KNOWN,11,214,101,38,9,373,9,99,47,17,2,174,0,0,0,0,0,0,547
946,DELHI (UT),2011,10,DEATH OF DEAR PERSON,0,2,0,1,1,4,0,0,0,0,0,0,0,0,0,0,0,0,4
1492,DELHI (UT),2011,10,DOWRY DISPUTE,0,2,1,0,0,3,0,19,6,0,0,25,0,0,0,0,0,0,28
2038,DELHI (UT),2011,10,DRUG ABUSE,2,14,14,5,0,35,0,4,3,0,0,7,0,0,0,0,0,0,42
2584,DELHI (UT),2011,10,ECONOMIC ISSUES,0,64,60,10,1,135,0,19,0,2,0,21,0,0,0,0,0,0,156
3130,DELHI (UT),2011,10,EXAM FAILURE,3,22,0,0,0,25,2,13,0,0,0,15,0,0,0,0,0,0,40
3676,DELHI (UT),2011,10,FAMILY PROBLEMS,2,135,98,26,9,270,2,87,44,10,3,146,0,0,0,0,0,0,416
4222,DELHI (UT),2011,10,HEALTH ISSUES,0,22,29,12,5,68,2,9,11,2,4,28,0,0,0,0,0,0,96
4767,DELHI (UT),2011,10,HERO WORSHIP,0,1,0,0,0,1,0,0,0,0,0,0,0,0,0,0,0,0,1
5312,DELHI (UT),2011,10,ILLEGITIMATE PREGNANCY,0,0,0,0,0,0,0,3,0,0,0,3,0,0,0,0,0,0,3
5857,DELHI (UT),2011,10,LOVE AFFAIRS,0,24,2,0,0,26,1,19,1,0,0,21,0,0,0,0,0,0,47
6403,DELHI (UT),2011,10,MARITAL ISSUES,0,32,4,3,0,39,1,23,3,0,1,28,0,0,0,0,0,0,67
6949,DELHI (UT),2011,10,MENTAL HEALTH,0,12,11,5,4,32,1,10,6,2,0,19,0,0,0,0,0,0,51
7495,DELHI (UT),2011,10,OTHERS,0,76,45,26,3,150,1,35,14,5,3,58,0,0,0,0,0,0,208
8079,DELHI (UT),2011,10,"PHYSICAL ABUSE (RAPE,INCEST ETC.)",0,0,0,0,0,0,0,0,0,0,0,0,0,0,0,0,0,0,0
8586,DELHI (UT),2011,10,SOCIETAL ISSUES,0,2,2,1,2,7,0,3,0,0,0,3,0,0,0,0,0,0,10
439,DELHI (UT),2012,10,CAUSES NOT KNOWN,7,244,167,57,13,488,12,118,52,14,0,196,0,0,0,0,0,0,684
985,DELHI (UT),2012,10,DEATH OF DEAR PERSON,0,3,1,0,0,4,0,1,2,0,0,3,0,0,0,0,0,0,7
1531,DELHI (UT),2012,10,DOWRY DISPUTE,0,0,1,0,0,1,0,48,9,3,0,60,0,0,0,0,0,0,61
2077,DELHI (UT),2012,10,DRUG ABUSE,1,22,18,4,0,45,0,0,0,0,0,0,0,0,0,0,0,0,45
2623,DELHI (UT),2012,10,ECONOMIC ISSUES,0,79,56,13,0,148,1,17,4,1,1,24,0,0,0,0,0,0,172
3169,DELHI (UT),2012,10,EXAM FAILURE,9,40,0,0,0,49,10,27,1,0,0,38,0,0,0,0,0,0,87
3715,DELHI (UT),2012,10,FAMILY PROBLEMS,2,115,107,22,4,250,2,92,54,14,6,168,0,0,0,0,0,0,418
4261,DELHI (UT),2012,10,HEALTH ISSUES,2,14,32,17,6,71,1,17,14,3,1,36,0,0,0,0,0,0,107
4806,DELHI (UT),2012,10,HERO WORSHIP,0,0,0,0,0,0,0,0,0,0,0,0,0,0,0,0,0,0,0
5351,DELHI (UT),2012,10,ILLEGITIMATE PREGNANCY,0,0,0,0,0,0,0,0,0,0,0,0,0,0,0,0,0,0,0
5896,DELHI (UT),2012,10,LOVE AFFAIRS,0,39,2,0,0,41,4,41,2,0,0,47,0,0,0,0,0,0,88
6442,DELHI (UT),2012,10,MARITAL ISSUES,0,7,8,3,0,18,0,8,5,0,0,13,0,0,0,0,0,0,31
6988,DELHI (UT),2012,10,MENTAL HEALTH,2,6,5,4,4,21,1,5,2,1,2,11,0,0,0,0,0,0,32
7534,DELHI (UT),2012,10,OTHERS,3,45,25,16,7,96,0,33,11,3,3,50,0,0,0,0,0,0,146
8118,DELHI (UT),2012,10,"PHYSICAL ABUSE (RAPE,INCEST ETC.)",0,0,0,0,0,0,0,0,0,0,0,0,0,0,0,0,0,0,0
8625,DELHI (UT),2012,10,SOCIETAL ISSUES,0,7,4,1,2,14,0,2,3,2,0,7,0,0,0,0,0,0,21
478,DELHI (UT),2013,10,CAUSES NOT KNOWN,8,245,191,114,56,614,13,150,57,11,2,233,0,0,0,0,0,0,847
1024,DELHI (UT),2013,10,DEATH OF DEAR PERSON,0,2,0,0,0,2,0,1,1,1,0,3,0,0,0,0,0,0,5
1570,DELHI (UT),2013,10,DOWRY DISPUTE,0,1,0,0,0,1,0,43,5,0,0,48,0,0,0,0,0,0,49
2116,DELHI (UT),2013,10,DRUG ABUSE,0,9,11,2,0,22,0,0,0,0,0,0,0,0,0,0,0,0,22
2662,DELHI (UT),2013,10,ECONOMIC ISSUES,0,42,53,6,0,101,0,4,0,0,0,4,0,0,0,0,0,0,105
3208,DELHI (UT),2013,10,EXAM FAILURE,1,26,0,0,0,27,2,27,0,0,0,29,0,0,0,0,0,0,56
3754,DELHI (UT),2013,10,FAMILY PROBLEMS,1,93,133,28,4,259,4,84,53,10,3,154,0,0,0,0,0,0,413
4300,DELHI (UT),2013,10,HEALTH ISSUES,0,15,13,9,4,41,0,9,5,3,1,18,0,0,0,0,0,0,59
4845,DELHI (UT),2013,10,HERO WORSHIP,0,0,0,0,0,0,0,0,0,0,0,0,0,0,0,0,0,0,0
5390,DELHI (UT),2013,10,ILLEGITIMATE PREGNANCY,0,0,0,0,0,0,0,1,0,0,0,1,0,0,0,0,0,0,1
5935,DELHI (UT),2013,10,LOVE AFFAIRS,1,33,8,0,0,42,1,26,4,0,0,31,0,0,0,0,0,0,73
6481,DELHI (UT),2013,10,MARITAL ISSUES,0,4,2,0,0,6,0,11,4,0,0,15,0,0,0,0,0,0,21
7027,DELHI (UT),2013,10,MENTAL HEALTH,0,4,5,0,4,13,0,6,0,1,1,8,0,0,0,0,0,0,21
7573,DELHI (UT),2013,10,OTHERS,10,109,90,38,32,279,4,53,24,10,2,93,0,0,0,0,0,0,372
8157,DELHI (UT),2013,10,"PHYSICAL ABUSE (RAPE,INCEST ETC.)",0,0,0,0,0,0,0,1,0,0,0,1,0,0,0,0,0,0,1
8664,DELHI (UT),2013,10,SOCIETAL ISSUES,0,5,4,1,0,10,0,4,0,0,0,4,0,0,0,0,0,0,14
517,DELHI (UT),2014,10,CAUSES NOT KNOWN,5,197,134,58,14,408,4,95,31,3,4,137,0,0,0,0,0,0,545
1063,DELHI (UT),2014,10,DEATH OF DEAR PERSON,0,0,1,1,0,2,0,1,1,0,0,2,0,0,0,0,0,0,4
1609,DELHI (UT),2014,10,DOWRY DISPUTE,0,0,0,0,0,0,0,67,6,0,0,73,0,0,0,0,0,0,73
2155,DELHI (UT),2014,10,DRUG ABUSE,0,17,15,1,0,33,0,0,1,0,0,1,0,0,0,0,0,0,34
2701,DELHI (UT),2014,10,ECONOMIC ISSUES,0,17,11,12,0,40,0,3,0,1,0,4,0,0,0,0,0,0,44
3247,DELHI (UT),2014,10,EXAM FAILURE,0,33,2,0,0,35,6,8,0,0,0,14,0,0,0,0,0,0,49
3793,DELHI (UT),2014,10,FAMILY PROBLEMS,2,107,77,31,6,223,5,67,28,7,3,110,0,0,0,0,0,0,333
4339,DELHI (UT),2014,10,HEALTH ISSUES,4,71,49,20,41,185,0,31,41,3,28,103,0,0,0,0,0,0,288
4884,DELHI (UT),2014,10,HERO WORSHIP,0,0,0,0,0,0,0,0,0,0,0,0,0,0,0,0,0,0,0
5429,DELHI (UT),2014,10,ILLEGITIMATE PREGNANCY,0,0,0,0,0,0,0,0,0,0,0,0,0,0,0,0,0,0,0
5974,DELHI (UT),2014,10,LOVE AFFAIRS,0,36,3,0,0,39,1,25,0,0,0,26,0,0,0,0,0,0,65
6520,DELHI (UT),2014,10,MARITAL ISSUES,0,50,24,1,2,77,1,153,26,4,0,184,0,0,0,0,0,0,261
7066,DELHI (UT),2014,10,MENTAL HEALTH,0,3,3,4,3,13,0,3,1,1,4,9,0,0,0,0,0,0,22
7612,DELHI (UT),2014,10,OTHERS,9,275,136,90,12,522,7,133,55,15,1,211,0,0,0,0,0,0,733
7651,DELHI (UT),2014,10,PHYSICAL ABUSE,0,0,0,0,0,0,0,1,1,0,0,2,0,0,0,0,0,0,2
8703,DELHI (UT),2014,10,SOCIETAL ISSUES,0,0,2,0,0,2,0,0,0,0,0,0,0,0,0,0,0,0,2
11,GOA,2001,11,CAUSES NOT KNOWN,0,6,17,10,4,37,2,9,4,1,3,19,0,0,0,0,0,0,56
557,GOA,2001,11,DEATH OF DEAR PERSON,0,0,0,0,0,0,0,0,0,0,1,1,0,0,0,0,0,0,1
1103,GOA,2001,11,DOWRY DISPUTE,0,0,0,0,0,0,0,3,0,0,0,3,0,0,0,0,0,0,3
1649,GOA,2001,11,DRUG ABUSE,0,0,0,0,0,0,0,0,0,0,0,0,0,0,0,0,0,0,0
2195,GOA,2001,11,ECONOMIC ISSUES,0,2,5,3,2,12,0,1,0,1,0,2,0,0,0,0,0,0,14
2741,GOA,2001,11,EXAM FAILURE,0,1,0,0,0,1,0,1,0,0,0,1,0,0,0,0,0,0,2
3287,GOA,2001,11,FAMILY PROBLEMS,0,6,16,4,3,29,1,2,8,1,0,12,0,0,0,0,0,0,41
3833,GOA,2001,11,HEALTH ISSUES,0,0,5,4,2,11,0,1,2,1,5,9,0,0,0,0,0,0,20
4379,GOA,2001,11,HERO WORSHIP,0,0,0,0,0,0,0,0,0,0,0,0,0,0,0,0,0,0,0
4924,GOA,2001,11,ILLEGITIMATE PREGNANCY,0,0,0,0,0,0,0,1,0,0,0,1,0,0,0,0,0,0,1
5469,GOA,2001,11,LOVE AFFAIRS,0,4,0,0,0,4,0,5,1,0,0,6,0,0,0,0,0,0,10
6014,GOA,2001,11,MARITAL ISSUES,0,0,1,0,0,1,0,0,1,0,0,1,0,0,0,0,0,0,2
6560,GOA,2001,11,MENTAL HEALTH,0,9,18,7,4,38,0,2,13,1,8,24,0,0,0,0,0,0,62
7106,GOA,2001,11,OTHERS,0,15,11,7,1,34,0,5,3,1,1,10,0,0,0,0,0,0,44
7691,GOA,2001,11,"PHYSICAL ABUSE (RAPE,INCEST ETC.)",0,0,0,0,0,0,0,0,0,0,0,0,0,0,0,0,0,0,0
8197,GOA,2001,11,SOCIETAL ISSUES,0,0,0,0,0,0,0,0,0,0,0,0,0,0,0,0,0,0,0
50,GOA,2002,11,CAUSES NOT KNOWN,0,16,27,7,4,54,2,8,6,1,0,17,0,0,0,0,0,0,71
596,GOA,2002,11,DEATH OF DEAR PERSON,0,0,0,0,0,0,0,0,0,0,0,0,0,0,0,0,0,0,0
1142,GOA,2002,11,DOWRY DISPUTE,0,0,0,0,0,0,0,1,0,0,0,1,0,0,0,0,0,0,1
1688,GOA,2002,11,DRUG ABUSE,0,0,0,0,0,0,0,0,0,0,0,0,0,0,0,0,0,0,0
2234,GOA,2002,11,ECONOMIC ISSUES,0,17,18,5,2,42,0,1,0,0,0,1,0,0,0,0,0,0,43
2780,GOA,2002,11,EXAM FAILURE,0,2,0,0,0,2,0,1,0,1,0,2,0,0,0,0,0,0,4
3326,GOA,2002,11,FAMILY PROBLEMS,0,7,7,8,3,25,0,9,8,1,0,18,0,0,0,0,0,0,43
3872,GOA,2002,11,HEALTH ISSUES,0,7,9,3,3,22,0,3,3,1,4,11,0,0,0,0,0,0,33
4418,GOA,2002,11,HERO WORSHIP,0,0,0,0,0,0,0,0,0,0,0,0,0,0,0,0,0,0,0
4963,GOA,2002,11,ILLEGITIMATE PREGNANCY,0,0,0,0,0,0,0,0,0,0,0,0,0,0,0,0,0,0,0
5508,GOA,2002,11,LOVE AFFAIRS,0,5,2,0,0,7,0,9,1,0,0,10,0,0,0,0,0,0,17
6053,GOA,2002,11,MARITAL ISSUES,0,0,1,0,0,1,0,4,5,0,0,9,0,0,0,0,0,0,10
6599,GOA,2002,11,MENTAL HEALTH,0,6,12,9,5,32,0,2,2,5,2,11,0,0,0,0,0,0,43
7145,GOA,2002,11,OTHERS,0,13,14,12,0,39,0,2,1,0,0,3,0,0,0,0,0,0,42
7730,GOA,2002,11,"PHYSICAL ABUSE (RAPE,INCEST ETC.)",0,0,0,0,0,0,0,0,0,0,0,0,0,0,0,0,0,0,0
8236,GOA,2002,11,SOCIETAL ISSUES,0,0,0,2,0,2,0,0,0,0,0,0,0,0,0,0,0,0,2
89,GOA,2003,11,CAUSES NOT KNOWN,0,14,23,11,2,50,2,16,5,1,0,24,0,0,0,0,0,0,74
635,GOA,2003,11,DEATH OF DEAR PERSON,0,0,0,0,0,0,0,1,0,0,0,1,0,0,0,0,0,0,1
1181,GOA,2003,11,DOWRY DISPUTE,0,0,0,0,0,0,0,1,0,0,0,1,0,0,0,0,0,0,1
1727,GOA,2003,11,DRUG ABUSE,0,0,2,0,0,2,0,0,0,0,0,0,0,0,0,0,0,0,2
2273,GOA,2003,11,ECONOMIC ISSUES,0,12,12,4,0,28,0,2,0,1,0,3,0,0,0,0,0,0,31
2819,GOA,2003,11,EXAM FAILURE,0,3,0,0,0,3,1,1,0,0,0,2,0,0,0,0,0,0,5
3365,GOA,2003,11,FAMILY PROBLEMS,0,6,12,6,3,27,1,11,4,0,0,16,0,0,0,0,0,0,43
3911,GOA,2003,11,HEALTH ISSUES,0,2,11,8,6,27,0,2,1,2,1,6,0,0,0,0,0,0,33
4457,GOA,2003,11,HERO WORSHIP,0,0,0,0,0,0,0,0,0,0,0,0,0,0,0,0,0,0,0
5002,GOA,2003,11,ILLEGITIMATE PREGNANCY,0,0,0,0,0,0,0,0,0,0,0,0,0,0,0,0,0,0,0
5547,GOA,2003,11,LOVE AFFAIRS,0,11,0,0,0,11,0,6,2,0,0,8,0,0,0,0,0,0,19
6092,GOA,2003,11,MARITAL ISSUES,0,0,1,0,0,1,0,0,0,0,0,0,0,0,0,0,0,0,1
6638,GOA,2003,11,MENTAL HEALTH,0,8,22,11,2,43,0,4,6,7,2,19,0,0,0,0,0,0,62
7184,GOA,2003,11,OTHERS,0,5,13,2,1,21,0,7,0,0,0,7,0,0,0,0,0,0,28
7769,GOA,2003,11,"PHYSICAL ABUSE (RAPE,INCEST ETC.)",0,0,0,0,0,0,0,0,0,0,0,0,0,0,0,0,0,0,0
8275,GOA,2003,11,SOCIETAL ISSUES,0,0,0,0,0,0,0,0,0,0,0,0,0,0,0,0,0,0,0
128,GOA,2004,11,CAUSES NOT KNOWN,0,24,30,14,1,69,1,14,4,2,0,21,0,0,0,0,0,0,90
674,GOA,2004,11,DEATH OF DEAR PERSON,0,0,0,0,0,0,0,0,0,0,0,0,0,0,0,0,0,0,0
1220,GOA,2004,11,DOWRY DISPUTE,0,0,0,0,0,0,0,0,0,0,0,0,0,0,0,0,0,0,0
1766,GOA,2004,11,DRUG ABUSE,0,1,0,0,0,1,0,0,0,0,0,0,0,0,0,0,0,0,1
2312,GOA,2004,11,ECONOMIC ISSUES,0,5,5,4,1,15,1,1,1,2,0,5,0,0,0,0,0,0,20
2858,GOA,2004,11,EXAM FAILURE,0,6,0,0,0,6,0,0,0,0,0,0,0,0,0,0,0,0,6
3404,GOA,2004,11,FAMILY PROBLEMS,0,7,10,5,0,22,0,3,10,2,2,17,0,0,0,0,0,0,39
3950,GOA,2004,11,HEALTH ISSUES,0,0,7,5,1,13,0,4,1,3,1,9,0,0,0,0,0,0,22
4496,GOA,2004,11,HERO WORSHIP,0,0,0,0,0,0,0,0,0,0,0,0,0,0,0,0,0,0,0
5041,GOA,2004,11,ILLEGITIMATE PREGNANCY,0,0,0,0,0,0,0,0,0,0,0,0,0,0,0,0,0,0,0
5586,GOA,2004,11,LOVE AFFAIRS,3,12,1,0,0,16,2,6,0,0,0,8,0,0,0,0,0,0,24
6131,GOA,2004,11,MARITAL ISSUES,0,1,1,0,0,2,0,2,3,0,0,5,0,0,0,0,0,0,7
6677,GOA,2004,11,MENTAL HEALTH,1,10,12,8,1,32,0,6,9,3,2,20,0,0,0,0,0,0,52
7223,GOA,2004,11,OTHERS,2,7,16,8,3,36,1,10,3,2,1,17,0,0,0,0,0,0,53
7808,GOA,2004,11,"PHYSICAL ABUSE (RAPE,INCEST ETC.)",0,0,0,0,0,0,0,0,0,0,0,0,0,0,0,0,0,0,0
8314,GOA,2004,11,SOCIETAL ISSUES,0,0,0,0,0,0,0,0,0,0,0,0,0,0,0,0,0,0,0
167,GOA,2005,11,CAUSES NOT KNOWN,0,14,31,10,5,60,0,13,2,2,3,20,0,0,0,0,0,0,80
713,GOA,2005,11,DEATH OF DEAR PERSON,0,1,0,0,0,1,0,0,1,0,0,1,0,0,0,0,0,0,2
1259,GOA,2005,11,DOWRY DISPUTE,0,0,0,0,0,0,0,1,0,0,0,1,0,0,0,0,0,0,1
1805,GOA,2005,11,DRUG ABUSE,0,0,2,0,1,3,0,0,0,0,0,0,0,0,0,0,0,0,3
2351,GOA,2005,11,ECONOMIC ISSUES,0,7,10,1,0,18,1,1,0,0,0,2,0,0,0,0,0,0,20
2897,GOA,2005,11,EXAM FAILURE,0,0,0,0,0,0,1,2,0,0,0,3,0,0,0,0,0,0,3
3443,GOA,2005,11,FAMILY PROBLEMS,0,4,8,3,2,17,0,7,3,1,2,13,0,0,0,0,0,0,30
3989,GOA,2005,11,HEALTH ISSUES,0,6,6,5,2,19,0,3,1,0,2,6,0,0,0,0,0,0,25
4535,GOA,2005,11,HERO WORSHIP,0,0,0,0,0,0,0,0,0,0,0,0,0,0,0,0,0,0,0
5080,GOA,2005,11,ILLEGITIMATE PREGNANCY,0,0,0,0,0,0,0,0,0,0,0,0,0,0,0,0,0,0,0
5625,GOA,2005,11,LOVE AFFAIRS,0,8,1,0,0,9,0,5,2,0,0,7,0,0,0,0,0,0,16
6170,GOA,2005,11,MARITAL ISSUES,0,0,0,2,0,2,0,0,0,0,0,0,0,0,0,0,0,0,2
6716,GOA,2005,11,MENTAL HEALTH,0,5,17,10,4,36,0,5,3,9,3,20,0,0,0,0,0,0,56
7262,GOA,2005,11,OTHERS,2,9,10,9,2,32,0,5,3,3,1,12,0,0,0,0,0,0,44
7847,GOA,2005,11,"PHYSICAL ABUSE (RAPE,INCEST ETC.)",0,0,0,0,0,0,0,0,0,0,0,0,0,0,0,0,0,0,0
8353,GOA,2005,11,SOCIETAL ISSUES,0,0,0,0,0,0,0,0,0,0,0,0,0,0,0,0,0,0,0
206,GOA,2006,11,CAUSES NOT KNOWN,1,20,12,9,5,47,3,10,7,1,4,25,0,0,0,0,0,0,72
752,GOA,2006,11,DEATH OF DEAR PERSON,0,0,0,0,1,1,0,1,0,0,0,1,0,0,0,0,0,0,2
1298,GOA,2006,11,DOWRY DISPUTE,0,0,0,0,0,0,0,1,0,0,0,1,0,0,0,0,0,0,1
1844,GOA,2006,11,DRUG ABUSE,0,1,1,1,0,3,0,0,0,0,0,0,0,0,0,0,0,0,3
2390,GOA,2006,11,ECONOMIC ISSUES,0,6,6,6,0,18,0,0,0,0,0,0,0,0,0,0,0,0,18
2936,GOA,2006,11,EXAM FAILURE,0,2,0,0,0,2,1,2,0,0,0,3,0,0,0,0,0,0,5
3482,GOA,2006,11,FAMILY PROBLEMS,0,0,0,0,0,0,0,1,0,0,0,1,0,0,0,0,0,0,1
4028,GOA,2006,11,HEALTH ISSUES,0,2,8,4,3,17,0,2,0,2,2,6,0,0,0,0,0,0,23
4574,GOA,2006,11,HERO WORSHIP,0,0,0,0,0,0,0,0,0,0,0,0,0,0,0,0,0,0,0
5119,GOA,2006,11,ILLEGITIMATE PREGNANCY,0,0,0,0,0,0,0,0,0,0,0,0,0,0,0,0,0,0,0
5664,GOA,2006,11,LOVE AFFAIRS,0,4,1,0,0,5,0,5,1,0,0,6,0,0,0,0,0,0,11
6209,GOA,2006,11,MARITAL ISSUES,0,3,0,1,0,4,0,1,1,2,0,4,0,0,0,0,0,0,8
6755,GOA,2006,11,MENTAL HEALTH,0,8,16,8,3,35,0,4,7,6,0,17,0,0,0,0,0,0,52
7301,GOA,2006,11,OTHERS,0,7,12,8,1,28,0,2,1,1,1,5,0,0,0,0,0,0,33
7886,GOA,2006,11,"PHYSICAL ABUSE (RAPE,INCEST ETC.)",0,0,0,0,0,0,1,0,0,0,0,1,0,0,0,0,0,0,1
8392,GOA,2006,11,SOCIETAL ISSUES,0,7,13,3,0,23,1,11,5,1,4,22,0,0,0,0,0,0,45
245,GOA,2007,11,CAUSES NOT KNOWN,0,20,24,9,3,56,0,17,4,2,0,23,0,0,0,0,0,0,79
791,GOA,2007,11,DEATH OF DEAR PERSON,0,0,0,0,0,0,0,0,0,0,0,0,0,0,0,0,0,0,0
1337,GOA,2007,11,DOWRY DISPUTE,0,0,0,0,0,0,0,2,0,0,0,2,0,0,0,0,0,0,2
1883,GOA,2007,11,DRUG ABUSE,0,1,2,2,0,5,0,0,0,0,0,0,0,0,0,0,0,0,5
2429,GOA,2007,11,ECONOMIC ISSUES,0,5,9,6,0,20,1,2,2,0,0,5,0,0,0,0,0,0,25
2975,GOA,2007,11,EXAM FAILURE,0,2,0,0,0,2,0,2,1,0,0,3,0,0,0,0,0,0,5
3521,GOA,2007,11,FAMILY PROBLEMS,0,11,10,5,2,28,0,8,5,3,0,16,0,0,0,0,0,0,44
4067,GOA,2007,11,HEALTH ISSUES,0,1,4,2,7,14,1,4,7,4,1,17,0,0,0,0,0,0,31
4612,GOA,2007,11,HERO WORSHIP,0,0,0,0,0,0,0,0,0,0,0,0,0,0,0,0,0,0,0
5157,GOA,2007,11,ILLEGITIMATE PREGNANCY,0,0,0,0,0,0,0,0,0,0,0,0,0,0,0,0,0,0,0
5702,GOA,2007,11,LOVE AFFAIRS,0,6,1,0,0,7,0,6,1,0,0,7,0,0,0,0,0,0,14
6248,GOA,2007,11,MARITAL ISSUES,0,1,0,0,0,1,0,1,1,0,0,2,0,0,0,0,0,0,3
6794,GOA,2007,11,MENTAL HEALTH,1,5,15,5,5,31,0,5,3,5,2,15,0,0,0,0,0,0,46
7340,GOA,2007,11,OTHERS,0,2,4,7,1,14,0,0,1,0,1,2,0,0,0,0,0,0,16
7924,GOA,2007,11,"PHYSICAL ABUSE (RAPE,INCEST ETC.)",0,0,0,0,0,0,0,0,0,0,0,0,0,0,0,0,0,0,0
8431,GOA,2007,11,SOCIETAL ISSUES,0,0,0,0,0,0,0,0,0,0,0,0,0,0,0,0,0,0,0
284,GOA,2008,11,CAUSES NOT KNOWN,0,13,20,8,5,46,1,18,6,3,3,31,0,0,0,0,0,0,77
830,GOA,2008,11,DEATH OF DEAR PERSON,0,1,0,0,0,1,0,0,1,0,0,1,0,0,0,0,0,0,2
1376,GOA,2008,11,DOWRY DISPUTE,0,0,0,0,0,0,0,0,0,0,0,0,0,0,0,0,0,0,0
1922,GOA,2008,11,DRUG ABUSE,0,1,3,0,0,4,0,0,0,1,0,1,0,0,0,0,0,0,5
2468,GOA,2008,11,ECONOMIC ISSUES,0,9,9,3,1,22,0,2,0,0,0,2,0,0,0,0,0,0,24
3014,GOA,2008,11,EXAM FAILURE,0,1,0,0,0,1,0,0,0,0,0,0,0,0,0,0,0,0,1
3560,GOA,2008,11,FAMILY PROBLEMS,0,3,10,2,0,15,0,13,3,2,2,20,0,0,0,0,0,0,35
4106,GOA,2008,11,HEALTH ISSUES,0,1,8,4,5,18,0,2,1,1,2,6,0,0,0,0,0,0,24
4651,GOA,2008,11,HERO WORSHIP,0,0,0,0,0,0,0,0,0,0,0,0,0,0,0,0,0,0,0
5196,GOA,2008,11,ILLEGITIMATE PREGNANCY,0,0,0,0,0,0,0,1,0,0,0,1,0,0,0,0,0,0,1
5741,GOA,2008,11,LOVE AFFAIRS,0,8,1,0,0,9,0,6,0,0,0,6,0,0,0,0,0,0,15
6287,GOA,2008,11,MARITAL ISSUES,0,1,1,0,0,2,0,0,2,0,0,2,0,0,0,0,0,0,4
6833,GOA,2008,11,MENTAL HEALTH,0,3,14,5,3,25,1,5,9,2,2,19,0,0,0,0,0,0,44
7379,GOA,2008,11,OTHERS,0,14,18,7,1,40,1,7,4,1,2,15,0,0,0,0,0,0,55
7963,GOA,2008,11,"PHYSICAL ABUSE (RAPE,INCEST ETC.)",0,0,0,0,0,0,0,0,0,0,0,0,0,0,0,0,0,0,0
8470,GOA,2008,11,SOCIETAL ISSUES,0,0,0,0,0,0,0,0,0,0,0,0,0,0,0,0,0,0,0
323,GOA,2009,11,CAUSES NOT KNOWN,0,10,16,3,3,32,0,12,4,1,0,17,0,0,0,0,0,0,49
869,GOA,2009,11,DEATH OF DEAR PERSON,0,0,2,0,1,3,0,0,0,0,0,0,0,0,0,0,0,0,3
1415,GOA,2009,11,DOWRY DISPUTE,0,0,0,0,0,0,0,0,2,0,0,2,0,0,0,0,0,0,2
1961,GOA,2009,11,DRUG ABUSE,0,1,3,5,2,11,0,0,0,0,0,0,0,0,0,0,0,0,11
2507,GOA,2009,11,ECONOMIC ISSUES,0,8,7,5,0,20,0,3,1,0,1,5,0,0,0,0,0,0,25
3053,GOA,2009,11,EXAM FAILURE,0,0,0,0,0,0,0,0,0,0,0,0,0,0,0,0,0,0,0
3599,GOA,2009,11,FAMILY PROBLEMS,0,5,9,7,1,22,0,18,7,3,0,28,0,0,0,0,0,0,50
4145,GOA,2009,11,HEALTH ISSUES,0,1,7,7,4,19,0,2,0,2,4,8,0,0,0,0,0,0,27
4690,GOA,2009,11,HERO WORSHIP,0,0,0,0,0,0,0,0,0,0,0,0,0,0,0,0,0,0,0
5235,GOA,2009,11,ILLEGITIMATE PREGNANCY,0,0,0,0,0,0,0,0,0,0,0,0,0,0,0,0,0,0,0
5780,GOA,2009,11,LOVE AFFAIRS,0,6,0,0,0,6,0,4,0,0,0,4,0,0,0,0,0,0,10
6326,GOA,2009,11,MARITAL ISSUES,0,1,0,0,1,2,0,1,0,0,0,1,0,0,0,0,0,0,3
6872,GOA,2009,11,MENTAL HEALTH,1,8,10,7,3,29,0,5,8,8,2,23,0,0,0,0,0,0,52
7418,GOA,2009,11,OTHERS,0,10,18,10,2,40,2,3,0,0,1,6,0,0,0,0,0,0,46
8002,GOA,2009,11,"PHYSICAL ABUSE (RAPE,INCEST ETC.)",0,0,0,0,0,0,0,0,0,0,0,0,0,0,0,0,0,0,0
8509,GOA,2009,11,SOCIETAL ISSUES,0,0,0,0,0,0,0,0,0,0,0,0,0,0,0,0,0,0,0
362,GOA,2010,11,CAUSES NOT KNOWN,1,20,15,12,1,49,2,12,2,1,3,20,0,0,0,0,0,0,69
908,GOA,2010,11,DEATH OF DEAR PERSON,0,0,0,0,0,0,0,1,0,0,0,1,0,0,0,0,0,0,1
1454,GOA,2010,11,DOWRY DISPUTE,0,0,0,0,0,0,0,0,1,0,0,1,0,0,0,0,0,0,1
2000,GOA,2010,11,DRUG ABUSE,0,1,2,2,1,6,0,0,0,0,0,0,0,0,0,0,0,0,6
2546,GOA,2010,11,ECONOMIC ISSUES,0,10,12,2,1,25,0,1,0,0,0,1,0,0,0,0,0,0,26
3092,GOA,2010,11,EXAM FAILURE,0,5,0,0,0,5,0,0,0,0,0,0,0,0,0,0,0,0,5
3638,GOA,2010,11,FAMILY PROBLEMS,1,11,12,9,0,33,0,7,9,1,3,20,0,0,0,0,0,0,53
4184,GOA,2010,11,HEALTH ISSUES,0,1,8,9,5,23,0,0,2,2,5,9,0,0,0,0,0,0,32
4729,GOA,2010,11,HERO WORSHIP,0,0,0,0,0,0,0,0,0,0,0,0,0,0,0,0,0,0,0
5274,GOA,2010,11,ILLEGITIMATE PREGNANCY,0,0,0,0,0,0,0,0,0,0,0,0,0,0,0,0,0,0,0
5819,GOA,2010,11,LOVE AFFAIRS,0,8,2,1,0,11,0,7,0,0,0,7,0,0,0,0,0,0,18
6365,GOA,2010,11,MARITAL ISSUES,0,0,3,0,0,3,0,0,0,1,0,1,0,0,0,0,0,0,4
6911,GOA,2010,11,MENTAL HEALTH,0,4,10,12,5,31,1,6,5,4,5,21,0,0,0,0,0,0,52
7457,GOA,2010,11,OTHERS,0,9,16,16,8,49,0,3,2,0,0,5,0,0,0,0,0,0,54
8041,GOA,2010,11,"PHYSICAL ABUSE (RAPE,INCEST ETC.)",0,0,0,0,0,0,0,0,0,0,0,0,0,0,0,0,0,0,0
8548,GOA,2010,11,SOCIETAL ISSUES,0,0,1,0,0,1,0,0,0,0,0,0,0,0,0,0,0,0,1
401,GOA,2011,11,CAUSES NOT KNOWN,2,18,24,7,3,54,1,17,3,1,0,22,0,0,0,0,0,0,76
947,GOA,2011,11,DEATH OF DEAR PERSON,0,0,0,0,0,0,0,0,0,1,0,1,0,0,0,0,0,0,1
1493,GOA,2011,11,DOWRY DISPUTE,0,0,0,0,0,0,0,1,0,0,0,1,0,0,0,0,0,0,1
2039,GOA,2011,11,DRUG ABUSE,0,1,3,3,1,8,0,0,0,0,0,0,0,0,0,0,0,0,8
2585,GOA,2011,11,ECONOMIC ISSUES,0,5,11,3,0,19,0,0,0,0,0,0,0,0,0,0,0,0,19
3131,GOA,2011,11,EXAM FAILURE,0,0,0,0,0,0,0,5,0,0,0,5,0,0,0,0,0,0,5
3677,GOA,2011,11,FAMILY PROBLEMS,1,9,8,3,5,26,1,9,9,1,0,20,0,0,0,0,0,0,46
4223,GOA,2011,11,HEALTH ISSUES,1,3,5,9,3,21,0,3,3,1,6,13,0,0,0,0,0,0,34
4768,GOA,2011,11,HERO WORSHIP,0,0,0,0,0,0,0,0,0,0,0,0,0,0,0,0,0,0,0
5313,GOA,2011,11,ILLEGITIMATE PREGNANCY,0,0,0,0,0,0,0,0,0,0,0,0,0,0,0,0,0,0,0
5858,GOA,2011,11,LOVE AFFAIRS,0,3,1,1,0,5,1,5,0,0,0,6,0,0,0,0,0,0,11
6404,GOA,2011,11,MARITAL ISSUES,0,0,0,0,0,0,0,0,2,0,0,2,0,0,0,0,0,0,2
6950,GOA,2011,11,MENTAL HEALTH,0,6,16,4,2,28,0,4,9,3,2,18,0,0,0,0,0,0,46
7496,GOA,2011,11,OTHERS,1,7,13,9,4,34,0,7,0,2,1,10,0,0,0,0,0,0,44
8080,GOA,2011,11,"PHYSICAL ABUSE (RAPE,INCEST ETC.)",0,0,0,0,0,0,0,0,0,0,0,0,0,0,0,0,0,0,0
8587,GOA,2011,11,SOCIETAL ISSUES,0,0,0,0,0,0,0,0,0,0,0,0,0,0,0,0,0,0,0
440,GOA,2012,11,CAUSES NOT KNOWN,1,18,20,8,1,48,1,7,9,1,3,21,0,0,0,0,0,0,69
986,GOA,2012,11,DEATH OF DEAR PERSON,0,0,0,0,0,0,0,1,0,0,0,1,0,0,0,0,0,0,1
1532,GOA,2012,11,DOWRY DISPUTE,0,0,0,0,0,0,0,0,0,0,0,0,0,0,0,0,0,0,0
2078,GOA,2012,11,DRUG ABUSE,0,1,2,2,0,5,0,0,0,0,0,0,0,0,0,0,0,0,5
2624,GOA,2012,11,ECONOMIC ISSUES,0,3,2,3,0,8,0,0,0,0,0,0,0,0,0,0,0,0,8
3170,GOA,2012,11,EXAM FAILURE,1,2,0,0,0,3,0,0,0,0,0,0,0,0,0,0,0,0,3
3716,GOA,2012,11,FAMILY PROBLEMS,0,6,16,6,2,30,2,6,6,1,0,15,0,0,0,0,0,0,45
4262,GOA,2012,11,HEALTH ISSUES,0,2,6,5,8,21,0,0,6,2,4,12,0,0,0,0,0,0,33
4807,GOA,2012,11,HERO WORSHIP,0,0,0,0,0,0,0,0,0,0,0,0,0,0,0,0,0,0,0
5352,GOA,2012,11,ILLEGITIMATE PREGNANCY,0,0,0,0,0,0,0,0,0,0,0,0,0,0,0,0,0,0,0
5897,GOA,2012,11,LOVE AFFAIRS,0,7,4,0,0,11,0,12,6,0,0,18,0,0,0,0,0,0,29
6443,GOA,2012,11,MARITAL ISSUES,0,1,0,2,0,3,0,0,0,0,0,0,0,0,0,0,0,0,3
6989,GOA,2012,11,MENTAL HEALTH,0,2,8,6,3,19,0,4,1,5,6,16,0,0,0,0,0,0,35
7535,GOA,2012,11,OTHERS,3,7,17,11,1,39,0,7,1,0,1,9,0,0,0,0,0,0,48
8119,GOA,2012,11,"PHYSICAL ABUSE (RAPE,INCEST ETC.)",0,0,0,0,0,0,0,0,0,0,0,0,0,0,0,0,0,0,0
8626,GOA,2012,11,SOCIETAL ISSUES,0,4,3,1,1,9,0,0,1,0,0,1,0,0,0,0,0,0,10
479,GOA,2013,11,CAUSES NOT KNOWN,0,23,23,10,5,61,2,25,10,2,0,39,0,0,0,0,0,0,100
1025,GOA,2013,11,DEATH OF DEAR PERSON,0,0,1,0,0,1,0,1,1,0,0,2,0,0,0,0,0,0,3
1571,GOA,2013,11,DOWRY DISPUTE,0,0,0,0,0,0,0,1,0,0,0,1,0,0,0,0,0,0,1
2117,GOA,2013,11,DRUG ABUSE,0,0,0,0,0,0,0,0,0,0,0,0,0,0,0,0,0,0,0
2663,GOA,2013,11,ECONOMIC ISSUES,0,12,8,5,0,25,0,2,0,0,0,2,0,0,0,0,0,0,27
3209,GOA,2013,11,EXAM FAILURE,0,0,0,0,0,0,1,0,0,0,0,1,0,0,0,0,0,0,1
3755,GOA,2013,11,FAMILY PROBLEMS,0,9,11,12,5,37,1,8,11,0,1,21,0,0,0,0,0,0,58
4301,GOA,2013,11,HEALTH ISSUES,0,0,9,7,8,24,0,0,0,1,2,3,0,0,0,0,0,0,27
4846,GOA,2013,11,HERO WORSHIP,0,0,0,0,0,0,0,0,0,0,0,0,0,0,0,0,0,0,0
5391,GOA,2013,11,ILLEGITIMATE PREGNANCY,0,0,0,0,0,0,0,0,0,0,0,0,0,0,0,0,0,0,0
5936,GOA,2013,11,LOVE AFFAIRS,0,17,2,0,0,19,1,6,1,0,0,8,0,0,0,0,0,0,27
6482,GOA,2013,11,MARITAL ISSUES,0,2,4,0,0,6,0,1,0,1,0,2,0,0,0,0,0,0,8
7028,GOA,2013,11,MENTAL HEALTH,0,8,10,7,2,27,0,1,8,1,3,13,0,0,0,0,0,0,40
7574,GOA,2013,11,OTHERS,0,11,12,7,0,30,0,0,0,2,2,4,0,0,0,0,0,0,34
8158,GOA,2013,11,"PHYSICAL ABUSE (RAPE,INCEST ETC.)",0,0,0,0,0,0,0,1,1,0,0,2,0,0,0,0,0,0,2
8665,GOA,2013,11,SOCIETAL ISSUES,0,0,0,0,0,0,0,0,0,0,0,0,0,0,0,0,0,0,0
518,GOA,2014,11,CAUSES NOT KNOWN,0,17,19,15,4,55,1,10,6,1,1,19,0,0,0,0,0,0,74
1064,GOA,2014,11,DEATH OF DEAR PERSON,0,0,0,1,0,1,1,0,0,2,0,3,0,0,0,0,0,0,4
1610,GOA,2014,11,DOWRY DISPUTE,0,0,0,0,0,0,0,0,0,0,0,0,0,0,0,0,0,0,0
2156,GOA,2014,11,DRUG ABUSE,0,0,0,0,0,0,0,0,0,0,0,0,0,0,0,0,0,0,0
2702,GOA,2014,11,ECONOMIC ISSUES,0,7,3,1,0,11,0,0,0,0,0,0,0,0,0,0,0,0,11
3248,GOA,2014,11,EXAM FAILURE,0,0,0,0,0,0,0,0,0,0,0,0,0,0,0,0,0,0,0
3794,GOA,2014,11,FAMILY PROBLEMS,0,7,5,8,4,24,0,9,5,1,0,15,0,0,0,0,0,0,39
4340,GOA,2014,11,HEALTH ISSUES,1,11,26,19,15,72,0,4,9,11,14,38,0,0,0,0,0,0,110
4885,GOA,2014,11,HERO WORSHIP,0,0,0,0,0,0,0,0,0,0,0,0,0,0,0,0,0,0,0
5430,GOA,2014,11,ILLEGITIMATE PREGNANCY,0,0,0,0,0,0,0,0,0,0,0,0,0,0,0,0,0,0,0
5975,GOA,2014,11,LOVE AFFAIRS,0,6,1,0,0,7,0,9,0,0,0,9,0,0,0,0,0,0,16
6521,GOA,2014,11,MARITAL ISSUES,0,0,3,0,0,3,0,1,0,0,0,1,0,0,0,0,0,0,4
7067,GOA,2014,11,MENTAL HEALTH,1,1,12,11,3,28,0,2,5,1,6,14,0,0,0,0,0,0,42
7613,GOA,2014,11,OTHERS,0,21,20,12,1,54,0,8,5,3,0,16,0,0,0,0,0,0,70
7652,GOA,2014,11,PHYSICAL ABUSE,0,0,0,0,0,0,0,0,0,0,0,0,0,0,0,0,0,0,0
8704,GOA,2014,11,SOCIETAL ISSUES,0,0,0,0,0,0,0,0,0,0,0,0,0,0,0,0,0,0,0
12,GUJARAT,2001,12,CAUSES NOT KNOWN,7,191,186,60,16,460,12,143,80,24,17,276,0,0,0,0,0,0,736
558,GUJARAT,2001,12,DEATH OF DEAR PERSON,0,9,10,6,0,25,2,20,16,3,3,44,0,0,0,0,0,0,69
1104,GUJARAT,2001,12,DOWRY DISPUTE,0,0,0,0,0,0,0,32,8,1,0,41,0,0,0,0,0,0,41
1650,GUJARAT,2001,12,DRUG ABUSE,0,4,5,2,1,12,0,1,0,1,0,2,0,0,0,0,0,0,14
2196,GUJARAT,2001,12,ECONOMIC ISSUES,3,213,225,106,16,563,3,51,85,41,6,186,0,0,0,0,0,0,749
2742,GUJARAT,2001,12,EXAM FAILURE,9,38,1,0,0,48,5,29,3,0,0,37,0,0,0,0,0,0,85
3288,GUJARAT,2001,12,FAMILY PROBLEMS,17,235,222,107,29,610,21,384,184,59,33,681,0,0,0,0,0,0,1291
3834,GUJARAT,2001,12,HEALTH ISSUES,1,91,146,111,57,406,5,100,112,60,55,332,0,0,0,0,0,0,738
4380,GUJARAT,2001,12,HERO WORSHIP,0,0,0,0,0,0,0,0,0,0,0,0,0,0,0,0,0,0,0
4925,GUJARAT,2001,12,ILLEGITIMATE PREGNANCY,0,0,0,0,0,0,0,2,0,0,0,2,0,0,0,0,0,0,2
5470,GUJARAT,2001,12,LOVE AFFAIRS,0,56,28,3,0,87,3,67,19,2,0,91,0,0,0,0,0,0,178
6015,GUJARAT,2001,12,MARITAL ISSUES,0,46,40,3,0,89,1,70,48,9,0,128,0,0,0,0,0,0,217
6561,GUJARAT,2001,12,MENTAL HEALTH,0,74,90,32,12,208,3,61,70,43,26,203,0,0,0,0,0,0,411
7107,GUJARAT,2001,12,OTHERS,1,32,48,10,4,95,2,41,19,7,0,69,0,0,0,0,0,0,164
7692,GUJARAT,2001,12,"PHYSICAL ABUSE (RAPE,INCEST ETC.)",0,1,0,0,0,1,0,12,3,0,0,15,0,0,0,0,0,0,16
8198,GUJARAT,2001,12,SOCIETAL ISSUES,2,12,18,12,1,45,1,17,10,7,0,35,0,0,0,0,0,0,80
51,GUJARAT,2002,12,CAUSES NOT KNOWN,4,243,214,67,29,557,5,174,78,40,12,309,0,0,0,0,0,0,866
597,GUJARAT,2002,12,DEATH OF DEAR PERSON,0,6,7,6,2,21,0,8,6,1,1,16,0,0,0,0,0,0,37
1143,GUJARAT,2002,12,DOWRY DISPUTE,0,0,1,0,0,1,0,21,9,0,1,31,0,0,0,0,0,0,32
1689,GUJARAT,2002,12,DRUG ABUSE,0,13,22,7,1,43,0,1,2,0,0,3,0,0,0,0,0,0,46
2235,GUJARAT,2002,12,ECONOMIC ISSUES,0,168,264,124,18,574,1,37,62,26,4,130,0,0,0,0,0,0,704
2781,GUJARAT,2002,12,EXAM FAILURE,3,36,3,0,0,42,4,33,1,0,0,38,0,0,0,0,0,0,80
3327,GUJARAT,2002,12,FAMILY PROBLEMS,7,198,144,76,24,449,16,291,130,56,16,509,0,0,0,0,0,0,958
3873,GUJARAT,2002,12,HEALTH ISSUES,2,66,143,124,43,378,0,98,100,69,38,305,0,0,0,0,0,0,683
4419,GUJARAT,2002,12,HERO WORSHIP,0,3,0,0,0,3,0,1,1,0,0,2,0,0,0,0,0,0,5
4964,GUJARAT,2002,12,ILLEGITIMATE PREGNANCY,0,1,0,0,0,1,0,3,0,0,0,3,0,0,0,0,0,0,4
5509,GUJARAT,2002,12,LOVE AFFAIRS,0,73,29,4,0,106,1,78,20,2,0,101,0,0,0,0,0,0,207
6054,GUJARAT,2002,12,MARITAL ISSUES,0,44,36,8,1,89,1,82,53,12,0,148,0,0,0,0,0,0,237
6600,GUJARAT,2002,12,MENTAL HEALTH,3,91,72,55,19,240,4,50,76,30,28,188,0,0,0,0,0,0,428
7146,GUJARAT,2002,12,OTHERS,5,66,44,27,7,149,7,44,30,17,5,103,0,0,0,0,0,0,252
7731,GUJARAT,2002,12,"PHYSICAL ABUSE (RAPE,INCEST ETC.)",0,1,0,1,0,2,0,2,5,1,0,8,0,0,0,0,0,0,10
8237,GUJARAT,2002,12,SOCIETAL ISSUES,1,13,17,19,1,51,0,23,17,4,0,44,0,0,0,0,0,0,95
90,GUJARAT,2003,12,CAUSES NOT KNOWN,5,226,211,94,19,555,11,167,96,23,11,308,0,0,0,0,0,0,863
636,GUJARAT,2003,12,DEATH OF DEAR PERSON,0,6,8,5,2,21,0,11,17,6,2,36,0,0,0,0,0,0,57
1182,GUJARAT,2003,12,DOWRY DISPUTE,0,0,0,0,0,0,0,8,5,0,0,13,0,0,0,0,0,0,13
1728,GUJARAT,2003,12,DRUG ABUSE,0,6,6,7,2,21,0,0,0,2,0,2,0,0,0,0,0,0,23
2274,GUJARAT,2003,12,ECONOMIC ISSUES,0,150,217,112,17,496,2,31,39,15,6,93,0,0,0,0,0,0,589
2820,GUJARAT,2003,12,EXAM FAILURE,4,24,1,0,0,29,1,28,0,0,0,29,0,0,0,0,0,0,58
3366,GUJARAT,2003,12,FAMILY PROBLEMS,5,158,146,60,9,378,11,219,124,53,20,427,0,0,0,0,0,0,805
3912,GUJARAT,2003,12,HEALTH ISSUES,1,71,137,110,60,379,4,96,103,69,62,334,0,0,0,0,0,0,713
4458,GUJARAT,2003,12,HERO WORSHIP,0,3,3,3,0,9,0,4,2,0,0,6,0,0,0,0,0,0,15
5003,GUJARAT,2003,12,ILLEGITIMATE PREGNANCY,0,0,0,0,0,0,0,1,0,0,0,1,0,0,0,0,0,0,1
5548,GUJARAT,2003,12,LOVE AFFAIRS,1,56,18,1,0,76,2,63,17,3,0,85,0,0,0,0,0,0,161
6093,GUJARAT,2003,12,MARITAL ISSUES,0,44,29,14,0,87,0,67,31,6,1,105,0,0,0,0,0,0,192
6639,GUJARAT,2003,12,MENTAL HEALTH,1,69,89,65,41,265,2,68,82,61,40,253,0,0,0,0,0,0,518
7185,GUJARAT,2003,12,OTHERS,4,97,98,36,20,255,9,90,48,14,12,173,0,0,0,0,0,0,428
7770,GUJARAT,2003,12,"PHYSICAL ABUSE (RAPE,INCEST ETC.)",0,3,9,7,3,22,1,9,6,7,4,27,0,0,0,0,0,0,49
8276,GUJARAT,2003,12,SOCIETAL ISSUES,1,18,24,9,5,57,0,11,11,1,1,24,0,0,0,0,0,0,81
129,GUJARAT,2004,12,CAUSES NOT KNOWN,7,219,203,106,23,558,15,140,79,24,12,270,0,0,0,0,0,0,828
675,GUJARAT,2004,12,DEATH OF DEAR PERSON,0,12,7,6,2,27,0,8,13,3,3,27,0,0,0,0,0,0,54
1221,GUJARAT,2004,12,DOWRY DISPUTE,0,0,0,0,0,0,0,37,19,1,0,57,0,0,0,0,0,0,57
1767,GUJARAT,2004,12,DRUG ABUSE,0,2,10,5,1,18,0,0,1,1,0,2,0,0,0,0,0,0,20
2313,GUJARAT,2004,12,ECONOMIC ISSUES,0,139,223,117,15,494,0,37,51,23,3,114,0,0,0,0,0,0,608
2859,GUJARAT,2004,12,EXAM FAILURE,9,31,1,0,0,41,2,33,1,0,0,36,0,0,0,0,0,0,77
3405,GUJARAT,2004,12,FAMILY PROBLEMS,6,179,115,66,20,386,3,250,145,39,14,451,0,0,0,0,0,0,837
3951,GUJARAT,2004,12,HEALTH ISSUES,1,56,125,125,68,375,0,66,85,75,41,267,0,0,0,0,0,0,642
4497,GUJARAT,2004,12,HERO WORSHIP,0,1,2,0,0,3,0,0,0,0,0,0,0,0,0,0,0,0,3
5042,GUJARAT,2004,12,ILLEGITIMATE PREGNANCY,0,0,0,0,0,0,0,8,0,0,0,8,0,0,0,0,0,0,8
5587,GUJARAT,2004,12,LOVE AFFAIRS,0,70,36,3,1,110,2,55,17,2,0,76,0,0,0,0,0,0,186
6132,GUJARAT,2004,12,MARITAL ISSUES,0,57,42,22,0,121,0,95,46,3,1,145,0,0,0,0,0,0,266
6678,GUJARAT,2004,12,MENTAL HEALTH,3,68,103,76,27,277,2,57,89,67,29,244,0,0,0,0,0,0,521
7224,GUJARAT,2004,12,OTHERS,8,123,142,68,17,358,5,102,45,13,5,170,0,0,0,0,0,0,528
7809,GUJARAT,2004,12,"PHYSICAL ABUSE (RAPE,INCEST ETC.)",0,6,3,0,0,9,0,15,5,2,0,22,0,0,0,0,0,0,31
8315,GUJARAT,2004,12,SOCIETAL ISSUES,0,25,25,17,6,73,0,24,8,4,1,37,0,0,0,0,0,0,110
168,GUJARAT,2005,12,CAUSES NOT KNOWN,7,224,203,93,30,557,10,145,85,24,14,278,0,0,0,0,0,0,835
714,GUJARAT,2005,12,DEATH OF DEAR PERSON,0,10,15,6,3,34,0,9,15,7,2,33,0,0,0,0,0,0,67
1260,GUJARAT,2005,12,DOWRY DISPUTE,0,0,0,0,0,0,0,22,7,0,0,29,0,0,0,0,0,0,29
1806,GUJARAT,2005,12,DRUG ABUSE,0,1,12,3,1,17,0,2,0,0,0,2,0,0,0,0,0,0,19
2352,GUJARAT,2005,12,ECONOMIC ISSUES,0,126,204,109,8,447,0,34,28,14,0,76,0,0,0,0,0,0,523
2898,GUJARAT,2005,12,EXAM FAILURE,2,36,2,0,0,40,6,30,0,0,0,36,0,0,0,0,0,0,76
3444,GUJARAT,2005,12,FAMILY PROBLEMS,5,170,189,89,22,475,3,207,118,51,15,394,0,0,0,0,0,0,869
3990,GUJARAT,2005,12,HEALTH ISSUES,0,93,142,121,74,430,3,86,91,83,47,310,0,0,0,0,0,0,740
4536,GUJARAT,2005,12,HERO WORSHIP,0,3,3,0,0,6,0,2,0,0,1,3,0,0,0,0,0,0,9
5081,GUJARAT,2005,12,ILLEGITIMATE PREGNANCY,0,0,0,0,0,0,0,5,0,0,0,5,0,0,0,0,0,0,5
5626,GUJARAT,2005,12,LOVE AFFAIRS,0,61,36,13,0,110,1,54,25,1,0,81,0,0,0,0,0,0,191
6171,GUJARAT,2005,12,MARITAL ISSUES,0,41,25,8,1,75,0,71,50,4,0,125,0,0,0,0,0,0,200
6717,GUJARAT,2005,12,MENTAL HEALTH,0,78,117,92,26,313,2,47,78,47,28,202,0,0,0,0,0,0,515
7263,GUJARAT,2005,12,OTHERS,11,109,106,72,20,318,5,112,79,22,12,230,0,0,0,0,0,0,548
7848,GUJARAT,2005,12,"PHYSICAL ABUSE (RAPE,INCEST ETC.)",0,6,6,3,0,15,0,10,2,1,0,13,0,0,0,0,0,0,28
8354,GUJARAT,2005,12,SOCIETAL ISSUES,0,22,22,14,7,65,3,15,23,5,0,46,0,0,0,0,0,0,111
207,GUJARAT,2006,12,CAUSES NOT KNOWN,11,239,265,151,55,721,8,205,123,39,21,396,0,0,0,0,0,0,1117
753,GUJARAT,2006,12,DEATH OF DEAR PERSON,0,4,14,15,5,38,1,6,12,16,6,41,0,0,0,0,0,0,79
1299,GUJARAT,2006,12,DOWRY DISPUTE,0,10,9,0,0,19,0,22,18,1,0,41,0,0,0,0,0,0,60
1845,GUJARAT,2006,12,DRUG ABUSE,0,3,10,3,0,16,0,0,3,0,0,3,0,0,0,0,0,0,19
2391,GUJARAT,2006,12,ECONOMIC ISSUES,1,157,228,113,15,514,0,21,37,19,0,77,0,0,0,0,0,0,591
2937,GUJARAT,2006,12,EXAM FAILURE,6,37,2,0,0,45,3,29,1,0,0,33,0,0,0,0,0,0,78
3483,GUJARAT,2006,12,FAMILY PROBLEMS,3,175,186,107,16,487,2,219,130,70,14,435,0,0,0,0,0,0,922
4029,GUJARAT,2006,12,HEALTH ISSUES,4,65,133,125,62,389,4,91,90,64,47,296,0,0,0,0,0,0,685
4575,GUJARAT,2006,12,HERO WORSHIP,0,1,4,1,0,6,0,0,0,0,0,0,0,0,0,0,0,0,6
5120,GUJARAT,2006,12,ILLEGITIMATE PREGNANCY,0,0,0,0,0,0,0,2,0,0,0,2,0,0,0,0,0,0,2
5665,GUJARAT,2006,12,LOVE AFFAIRS,0,64,26,0,0,90,1,68,14,4,0,87,0,0,0,0,0,0,177
6210,GUJARAT,2006,12,MARITAL ISSUES,0,55,27,10,1,93,1,76,43,7,0,127,0,0,0,0,0,0,220
6756,GUJARAT,2006,12,MENTAL HEALTH,0,67,105,89,31,292,1,65,75,53,29,223,0,0,0,0,0,0,515
7302,GUJARAT,2006,12,OTHERS,5,91,98,52,17,263,7,89,57,21,4,178,0,0,0,0,0,0,441
7887,GUJARAT,2006,12,"PHYSICAL ABUSE (RAPE,INCEST ETC.)",0,1,8,4,0,13,0,18,1,0,1,20,0,0,0,0,0,0,33
8393,GUJARAT,2006,12,SOCIETAL ISSUES,0,17,19,24,2,62,0,14,10,4,0,28,0,0,0,0,0,0,90
246,GUJARAT,2007,12,CAUSES NOT KNOWN,6,291,294,134,39,764,12,201,124,55,28,420,0,0,0,0,0,0,1184
792,GUJARAT,2007,12,DEATH OF DEAR PERSON,0,3,10,4,5,22,0,4,11,9,0,24,0,0,0,0,0,0,46
1338,GUJARAT,2007,12,DOWRY DISPUTE,0,0,0,0,0,0,0,39,8,0,0,47,0,0,0,0,0,0,47
1884,GUJARAT,2007,12,DRUG ABUSE,0,6,13,9,1,29,0,0,4,0,0,4,0,0,0,0,0,0,33
2430,GUJARAT,2007,12,ECONOMIC ISSUES,2,137,205,87,10,441,0,36,34,10,0,80,0,0,0,0,0,0,521
2976,GUJARAT,2007,12,EXAM FAILURE,7,24,2,1,0,34,7,28,0,0,0,35,0,0,0,0,0,0,69
3522,GUJARAT,2007,12,FAMILY PROBLEMS,4,195,214,88,19,520,2,251,167,62,14,496,0,0,0,0,0,0,1016
4068,GUJARAT,2007,12,HEALTH ISSUES,1,118,193,161,95,568,5,85,99,91,71,351,0,0,0,0,0,0,919
4613,GUJARAT,2007,12,HERO WORSHIP,0,2,5,2,1,10,0,4,3,1,0,8,0,0,0,0,0,0,18
5158,GUJARAT,2007,12,ILLEGITIMATE PREGNANCY,0,0,0,0,0,0,0,2,1,0,0,3,0,0,0,0,0,0,3
5703,GUJARAT,2007,12,LOVE AFFAIRS,0,59,21,1,0,81,3,54,11,1,0,69,0,0,0,0,0,0,150
6249,GUJARAT,2007,12,MARITAL ISSUES,0,58,29,9,0,96,0,86,52,6,1,145,0,0,0,0,0,0,241
6795,GUJARAT,2007,12,MENTAL HEALTH,1,107,137,103,28,376,1,79,100,47,29,256,0,0,0,0,0,0,632
7341,GUJARAT,2007,12,OTHERS,12,170,121,65,13,381,5,115,54,24,15,213,0,0,0,0,0,0,594
7925,GUJARAT,2007,12,"PHYSICAL ABUSE (RAPE,INCEST ETC.)",0,2,3,0,1,6,0,9,7,1,1,18,0,0,0,0,0,0,24
8432,GUJARAT,2007,12,SOCIETAL ISSUES,0,17,19,9,2,47,0,19,13,4,0,36,0,0,0,0,0,0,83
285,GUJARAT,2008,12,CAUSES NOT KNOWN,4,276,267,137,39,723,13,197,130,43,22,405,0,0,0,0,0,0,1128
831,GUJARAT,2008,12,DEATH OF DEAR PERSON,0,6,9,9,4,28,0,5,17,9,3,34,0,0,0,0,0,0,62
1377,GUJARAT,2008,12,DOWRY DISPUTE,0,0,0,0,0,0,0,34,13,0,0,47,0,0,0,0,0,0,47
1923,GUJARAT,2008,12,DRUG ABUSE,0,17,17,6,0,40,0,2,10,0,5,17,0,0,0,0,0,0,57
2469,GUJARAT,2008,12,ECONOMIC ISSUES,0,175,266,116,17,574,1,36,49,20,2,108,0,0,0,0,0,0,682
3015,GUJARAT,2008,12,EXAM FAILURE,3,54,2,0,0,59,3,40,3,0,0,46,0,0,0,0,0,0,105
3561,GUJARAT,2008,12,FAMILY PROBLEMS,2,207,296,127,35,667,6,264,179,80,24,553,0,0,0,0,0,0,1220
4107,GUJARAT,2008,12,HEALTH ISSUES,1,97,158,143,84,483,1,91,118,84,58,352,0,0,0,0,0,0,835
4652,GUJARAT,2008,12,HERO WORSHIP,0,5,2,0,0,7,0,4,0,0,0,4,0,0,0,0,0,0,11
5197,GUJARAT,2008,12,ILLEGITIMATE PREGNANCY,0,0,0,0,0,0,0,0,0,0,0,0,0,0,0,0,0,0,0
5742,GUJARAT,2008,12,LOVE AFFAIRS,0,56,34,11,0,101,4,60,19,0,0,83,0,0,0,0,0,0,184
6288,GUJARAT,2008,12,MARITAL ISSUES,0,75,45,17,2,139,0,101,63,11,0,175,0,0,0,0,0,0,314
6834,GUJARAT,2008,12,MENTAL HEALTH,0,98,124,108,39,369,3,83,93,66,35,280,0,0,0,0,0,0,649
7380,GUJARAT,2008,12,OTHERS,15,167,180,98,27,487,8,152,75,27,19,281,0,0,0,0,0,0,768
7964,GUJARAT,2008,12,"PHYSICAL ABUSE (RAPE,INCEST ETC.)",0,1,1,0,0,2,0,10,6,0,0,16,0,0,0,0,0,0,18
8471,GUJARAT,2008,12,SOCIETAL ISSUES,0,16,21,15,4,56,0,11,11,7,0,29,0,0,0,0,0,0,85
324,GUJARAT,2009,12,CAUSES NOT KNOWN,9,242,256,150,40,697,6,172,110,51,22,361,0,0,0,0,0,0,1058
870,GUJARAT,2009,12,DEATH OF DEAR PERSON,0,8,5,7,2,22,0,7,7,2,2,18,0,0,0,0,0,0,40
1416,GUJARAT,2009,12,DOWRY DISPUTE,0,0,0,0,0,0,0,41,8,1,0,50,0,0,0,0,0,0,50
1962,GUJARAT,2009,12,DRUG ABUSE,0,11,7,6,1,25,0,0,6,0,1,7,0,0,0,0,0,0,32
2508,GUJARAT,2009,12,ECONOMIC ISSUES,3,227,240,111,18,599,0,53,45,20,1,119,0,0,0,0,0,0,718
3054,GUJARAT,2009,12,EXAM FAILURE,3,43,0,0,0,46,8,45,0,0,0,53,0,0,0,0,0,0,99
3600,GUJARAT,2009,12,FAMILY PROBLEMS,6,235,321,120,33,715,7,297,206,97,39,646,0,0,0,0,0,0,1361
4146,GUJARAT,2009,12,HEALTH ISSUES,0,132,197,155,84,568,3,97,101,77,60,338,0,0,0,0,0,0,906
4691,GUJARAT,2009,12,HERO WORSHIP,0,0,2,1,0,3,0,0,0,0,0,0,0,0,0,0,0,0,3
5236,GUJARAT,2009,12,ILLEGITIMATE PREGNANCY,0,0,0,0,0,0,0,10,0,0,0,10,0,0,0,0,0,0,10
5781,GUJARAT,2009,12,LOVE AFFAIRS,0,67,19,3,0,89,0,81,29,1,0,111,0,0,0,0,0,0,200
6327,GUJARAT,2009,12,MARITAL ISSUES,0,65,53,15,1,134,0,112,63,8,4,187,0,0,0,0,0,0,321
6873,GUJARAT,2009,12,MENTAL HEALTH,3,87,135,78,39,342,0,94,112,65,33,304,0,0,0,0,0,0,646
7419,GUJARAT,2009,12,OTHERS,3,117,126,74,24,344,5,116,49,15,13,198,0,0,0,0,0,0,542
8003,GUJARAT,2009,12,"PHYSICAL ABUSE (RAPE,INCEST ETC.)",0,2,1,0,0,3,0,2,2,0,0,4,0,0,0,0,0,0,7
8510,GUJARAT,2009,12,SOCIETAL ISSUES,0,19,42,17,6,84,1,32,33,11,2,79,0,0,0,0,0,0,163
363,GUJARAT,2010,12,CAUSES NOT KNOWN,8,297,314,150,52,821,6,223,127,50,19,425,0,0,0,0,0,0,1246
909,GUJARAT,2010,12,DEATH OF DEAR PERSON,0,8,8,10,5,31,0,5,10,6,4,25,0,0,0,0,0,0,56
1455,GUJARAT,2010,12,DOWRY DISPUTE,0,1,5,0,0,6,0,31,6,0,0,37,0,0,0,0,0,0,43
2001,GUJARAT,2010,12,DRUG ABUSE,0,5,13,5,2,25,1,1,0,2,0,4,0,0,0,0,0,0,29
2547,GUJARAT,2010,12,ECONOMIC ISSUES,0,185,218,97,17,517,3,16,27,13,2,61,0,0,0,0,0,0,578
3093,GUJARAT,2010,12,EXAM FAILURE,2,41,0,0,0,43,1,40,1,0,0,42,0,0,0,0,0,0,85
3639,GUJARAT,2010,12,FAMILY PROBLEMS,7,221,195,115,20,558,10,284,175,84,16,569,0,0,0,0,0,0,1127
4185,GUJARAT,2010,12,HEALTH ISSUES,0,92,182,157,82,513,3,79,90,88,66,326,0,0,0,0,0,0,839
4730,GUJARAT,2010,12,HERO WORSHIP,0,1,1,0,0,2,0,2,1,1,0,4,0,0,0,0,0,0,6
5275,GUJARAT,2010,12,ILLEGITIMATE PREGNANCY,0,0,0,0,0,0,0,2,0,0,0,2,0,0,0,0,0,0,2
5820,GUJARAT,2010,12,LOVE AFFAIRS,0,66,18,4,0,88,1,73,17,1,0,92,0,0,0,0,0,0,180
6366,GUJARAT,2010,12,MARITAL ISSUES,0,49,59,19,0,127,0,100,61,16,0,177,0,0,0,0,0,0,304
6912,GUJARAT,2010,12,MENTAL HEALTH,3,105,134,72,41,355,5,86,78,53,31,253,0,0,0,0,0,0,608
7458,GUJARAT,2010,12,OTHERS,17,263,249,115,42,686,12,154,126,52,19,363,0,0,0,0,0,0,1049
8042,GUJARAT,2010,12,"PHYSICAL ABUSE (RAPE,INCEST ETC.)",0,0,2,0,0,2,0,5,2,0,0,7,0,0,0,0,0,0,9
8549,GUJARAT,2010,12,SOCIETAL ISSUES,0,9,14,14,2,39,0,4,1,1,1,7,0,0,0,0,0,0,46
402,GUJARAT,2011,12,CAUSES NOT KNOWN,17,306,284,165,47,819,13,217,122,71,21,444,0,0,0,0,0,0,1263
948,GUJARAT,2011,12,DEATH OF DEAR PERSON,1,18,12,7,2,40,1,9,10,5,3,28,0,0,0,0,0,0,68
1494,GUJARAT,2011,12,DOWRY DISPUTE,0,0,0,0,0,0,0,7,8,0,0,15,0,0,0,0,0,0,15
2040,GUJARAT,2011,12,DRUG ABUSE,0,6,6,5,0,17,0,0,1,1,0,2,0,0,0,0,0,0,19
2586,GUJARAT,2011,12,ECONOMIC ISSUES,0,181,188,90,10,469,0,23,30,16,4,73,0,0,0,0,0,0,542
3132,GUJARAT,2011,12,EXAM FAILURE,2,42,4,0,0,48,9,43,0,0,0,52,0,0,0,0,0,0,100
3678,GUJARAT,2011,12,FAMILY PROBLEMS,5,270,293,138,29,735,10,340,224,90,23,687,0,0,0,0,0,0,1422
4224,GUJARAT,2011,12,HEALTH ISSUES,1,113,202,170,97,583,4,88,123,85,64,364,0,0,0,0,0,0,947
4769,GUJARAT,2011,12,HERO WORSHIP,0,0,0,0,1,1,0,0,1,0,0,1,0,0,0,0,0,0,2
5314,GUJARAT,2011,12,ILLEGITIMATE PREGNANCY,0,0,0,0,0,0,0,2,1,0,0,3,0,0,0,0,0,0,3
5859,GUJARAT,2011,12,LOVE AFFAIRS,0,80,37,2,0,119,1,78,21,7,0,107,0,0,0,0,0,0,226
6405,GUJARAT,2011,12,MARITAL ISSUES,0,63,48,15,1,127,2,85,49,20,1,157,0,0,0,0,0,0,284
6951,GUJARAT,2011,12,MENTAL HEALTH,0,107,113,101,38,359,3,57,82,69,35,246,0,0,0,0,0,0,605
7497,GUJARAT,2011,12,OTHERS,9,224,191,95,29,548,10,128,73,31,15,257,0,0,0,0,0,0,805
8081,GUJARAT,2011,12,"PHYSICAL ABUSE (RAPE,INCEST ETC.)",0,1,3,2,1,7,0,5,4,0,0,9,0,0,0,0,0,0,16
8588,GUJARAT,2011,12,SOCIETAL ISSUES,0,13,17,10,0,40,0,11,6,4,4,25,0,0,0,0,0,0,65
441,GUJARAT,2012,12,CAUSES NOT KNOWN,16,435,409,200,59,1119,15,267,162,79,24,547,0,0,0,0,0,0,1666
987,GUJARAT,2012,12,DEATH OF DEAR PERSON,0,7,13,7,2,29,0,10,16,9,1,36,0,0,0,0,0,0,65
1533,GUJARAT,2012,12,DOWRY DISPUTE,0,0,0,0,0,0,0,9,4,6,0,19,0,0,0,0,0,0,19
2079,GUJARAT,2012,12,DRUG ABUSE,0,19,19,10,0,48,0,3,1,1,0,5,0,0,0,0,0,0,53
2625,GUJARAT,2012,12,ECONOMIC ISSUES,0,186,206,86,18,496,0,37,32,11,4,84,0,0,0,0,0,0,580
3171,GUJARAT,2012,12,EXAM FAILURE,7,59,2,0,0,68,6,53,10,0,0,69,0,0,0,0,0,0,137
3717,GUJARAT,2012,12,FAMILY PROBLEMS,5,216,285,129,19,654,9,277,181,87,21,575,0,0,0,0,0,0,1229
4263,GUJARAT,2012,12,HEALTH ISSUES,2,108,206,168,87,571,0,107,121,83,53,364,0,0,0,0,0,0,935
4808,GUJARAT,2012,12,HERO WORSHIP,0,1,0,1,0,2,0,0,1,0,0,1,0,0,0,0,0,0,3
5353,GUJARAT,2012,12,ILLEGITIMATE PREGNANCY,0,0,0,0,0,0,0,6,1,0,0,7,0,0,0,0,0,0,7
5898,GUJARAT,2012,12,LOVE AFFAIRS,0,119,22,0,0,141,0,92,41,4,0,137,0,0,0,0,0,0,278
6444,GUJARAT,2012,12,MARITAL ISSUES,0,57,68,22,1,148,0,88,61,19,3,171,0,0,0,0,0,0,319
6990,GUJARAT,2012,12,MENTAL HEALTH,1,115,164,116,38,434,5,87,82,76,29,279,0,0,0,0,0,0,713
7536,GUJARAT,2012,12,OTHERS,21,221,173,127,61,603,22,196,123,73,16,430,0,0,0,0,0,0,1033
8120,GUJARAT,2012,12,"PHYSICAL ABUSE (RAPE,INCEST ETC.)",0,2,3,0,0,5,0,5,4,0,0,9,0,0,0,0,0,0,14
8627,GUJARAT,2012,12,SOCIETAL ISSUES,0,9,18,16,1,44,0,9,4,1,1,15,0,0,0,0,0,0,59
480,GUJARAT,2013,12,CAUSES NOT KNOWN,13,410,452,278,72,1225,6,325,155,59,32,577,0,0,0,0,0,0,1802
1026,GUJARAT,2013,12,DEATH OF DEAR PERSON,2,14,31,13,6,66,0,14,20,11,4,49,0,0,0,0,0,0,115
1572,GUJARAT,2013,12,DOWRY DISPUTE,0,2,2,0,0,4,1,12,5,0,0,18,0,0,0,0,0,0,22
2118,GUJARAT,2013,12,DRUG ABUSE,1,12,20,18,4,55,0,2,4,0,0,6,0,0,0,0,0,0,61
2664,GUJARAT,2013,12,ECONOMIC ISSUES,0,184,255,100,15,554,0,35,30,12,5,82,0,0,0,0,0,0,636
3210,GUJARAT,2013,12,EXAM FAILURE,4,50,2,0,0,56,4,55,2,0,0,61,0,0,0,0,0,0,117
3756,GUJARAT,2013,12,FAMILY PROBLEMS,1,223,283,134,35,676,2,304,168,96,27,597,0,0,0,0,0,0,1273
4302,GUJARAT,2013,12,HEALTH ISSUES,3,105,222,212,114,656,6,76,115,79,63,339,0,0,0,0,0,0,995
4847,GUJARAT,2013,12,HERO WORSHIP,0,13,6,2,1,22,0,7,4,1,0,12,0,0,0,0,0,0,34
5392,GUJARAT,2013,12,ILLEGITIMATE PREGNANCY,0,0,0,0,0,0,0,4,0,0,0,4,0,0,0,0,0,0,4
5937,GUJARAT,2013,12,LOVE AFFAIRS,0,93,24,7,0,124,1,83,22,2,0,108,0,0,0,0,0,0,232
6483,GUJARAT,2013,12,MARITAL ISSUES,0,85,38,14,0,137,2,79,57,18,0,156,0,0,0,0,0,0,293
7029,GUJARAT,2013,12,MENTAL HEALTH,1,123,162,125,42,453,3,80,89,69,45,286,0,0,0,0,0,0,739
7575,GUJARAT,2013,12,OTHERS,19,173,154,92,32,470,14,162,79,37,15,307,0,0,0,0,0,0,777
8159,GUJARAT,2013,12,"PHYSICAL ABUSE (RAPE,INCEST ETC.)",0,1,3,2,1,7,1,3,1,0,0,5,0,0,0,0,0,0,12
8666,GUJARAT,2013,12,SOCIETAL ISSUES,1,7,9,10,0,27,0,16,5,5,1,27,0,0,0,0,0,0,54
519,GUJARAT,2014,12,CAUSES NOT KNOWN,8,320,275,162,42,807,4,239,144,70,24,481,0,0,0,0,0,0,1288
1065,GUJARAT,2014,12,DEATH OF DEAR PERSON,0,14,13,11,5,43,1,16,2,2,2,23,0,0,0,0,0,0,66
1611,GUJARAT,2014,12,DOWRY DISPUTE,0,0,0,0,0,0,0,10,0,0,0,10,0,0,0,0,0,0,10
2157,GUJARAT,2014,12,DRUG ABUSE,1,18,18,8,3,48,2,8,7,3,0,20,0,0,0,0,0,0,68
2703,GUJARAT,2014,12,ECONOMIC ISSUES,0,123,179,77,7,386,0,17,17,4,1,39,0,0,0,0,0,0,425
3249,GUJARAT,2014,12,EXAM FAILURE,3,53,1,0,0,57,2,46,0,0,0,48,0,0,0,0,0,0,105
3795,GUJARAT,2014,12,FAMILY PROBLEMS,5,160,168,77,13,423,3,193,93,34,8,331,0,0,0,0,0,0,754
4341,GUJARAT,2014,12,HEALTH ISSUES,0,278,518,374,215,1385,6,202,256,177,155,796,0,0,0,0,0,0,2181
4886,GUJARAT,2014,12,HERO WORSHIP,0,3,3,0,0,6,0,1,1,0,0,2,0,0,0,0,0,0,8
5431,GUJARAT,2014,12,ILLEGITIMATE PREGNANCY,0,0,0,0,0,0,0,1,1,0,0,2,0,0,0,0,0,0,2
5976,GUJARAT,2014,12,LOVE AFFAIRS,2,109,37,1,0,149,4,109,11,0,0,124,0,0,0,0,0,0,273
6522,GUJARAT,2014,12,MARITAL ISSUES,1,141,144,22,2,310,0,161,77,7,1,246,0,0,0,0,0,0,556
7068,GUJARAT,2014,12,MENTAL HEALTH,0,84,90,66,19,259,0,56,72,35,21,184,0,0,0,0,0,0,443
7614,GUJARAT,2014,12,OTHERS,9,748,670,264,82,1773,7,512,298,115,37,969,0,0,0,0,0,0,2742
7653,GUJARAT,2014,12,PHYSICAL ABUSE,0,0,0,0,0,0,0,2,3,0,0,5,0,0,0,0,0,0,5
8705,GUJARAT,2014,12,SOCIETAL ISSUES,0,4,4,7,1,16,0,1,0,1,0,2,0,0,0,0,0,0,18
13,HARYANA,2001,13,CAUSES NOT KNOWN,2,52,48,30,5,137,1,24,23,4,2,54,0,0,0,0,0,0,191
559,HARYANA,2001,13,DEATH OF DEAR PERSON,1,12,9,7,8,37,0,6,6,3,2,17,0,0,0,0,0,0,54
1105,HARYANA,2001,13,DOWRY DISPUTE,0,1,0,0,0,1,0,45,21,3,0,69,0,0,0,0,0,0,70
1651,HARYANA,2001,13,DRUG ABUSE,0,7,8,4,0,19,0,0,0,0,0,0,0,0,0,0,0,0,19
2197,HARYANA,2001,13,ECONOMIC ISSUES,0,54,61,38,3,156,0,13,13,5,0,31,0,0,0,0,0,0,187
2743,HARYANA,2001,13,EXAM FAILURE,5,20,1,0,0,26,5,11,3,0,0,19,0,0,0,0,0,0,45
3289,HARYANA,2001,13,FAMILY PROBLEMS,3,74,63,28,7,175,0,50,36,9,3,98,0,0,0,0,0,0,273
3835,HARYANA,2001,13,HEALTH ISSUES,0,31,33,21,12,97,0,11,12,6,3,32,0,0,0,0,0,0,129
4381,HARYANA,2001,13,HERO WORSHIP,0,0,0,0,0,0,0,0,0,0,0,0,0,0,0,0,0,0,0
4926,HARYANA,2001,13,ILLEGITIMATE PREGNANCY,0,0,0,0,0,0,0,3,1,0,0,4,0,0,0,0,0,0,4
5471,HARYANA,2001,13,LOVE AFFAIRS,0,22,2,0,0,24,0,15,2,0,0,17,0,0,0,0,0,0,41
6016,HARYANA,2001,13,MARITAL ISSUES,0,19,13,1,0,33,1,22,10,2,0,35,0,0,0,0,0,0,68
6562,HARYANA,2001,13,MENTAL HEALTH,1,10,17,7,0,35,2,3,5,1,2,13,0,0,0,0,0,0,48
7108,HARYANA,2001,13,OTHERS,21,191,227,87,34,560,10,86,70,20,12,198,0,0,0,0,0,0,758
7693,HARYANA,2001,13,"PHYSICAL ABUSE (RAPE,INCEST ETC.)",0,0,0,0,0,0,0,2,3,0,0,5,0,0,0,0,0,0,5
8199,HARYANA,2001,13,SOCIETAL ISSUES,1,26,17,13,7,64,1,31,15,3,1,51,0,0,0,0,0,0,115
52,HARYANA,2002,13,CAUSES NOT KNOWN,5,57,43,11,4,120,1,27,11,5,2,46,0,0,0,0,0,0,166
598,HARYANA,2002,13,DEATH OF DEAR PERSON,0,6,7,11,3,27,0,2,3,0,0,5,0,0,0,0,0,0,32
1144,HARYANA,2002,13,DOWRY DISPUTE,0,0,1,0,0,1,0,18,6,0,0,24,0,0,0,0,0,0,25
1690,HARYANA,2002,13,DRUG ABUSE,0,12,11,3,0,26,0,0,0,0,0,0,0,0,0,0,0,0,26
2236,HARYANA,2002,13,ECONOMIC ISSUES,0,44,52,51,4,151,0,3,3,2,5,13,0,0,0,0,0,0,164
2782,HARYANA,2002,13,EXAM FAILURE,4,17,1,0,0,22,2,9,0,0,0,11,0,0,0,0,0,0,33
3328,HARYANA,2002,13,FAMILY PROBLEMS,1,71,73,34,5,184,1,48,37,14,0,100,0,0,0,0,0,0,284
3874,HARYANA,2002,13,HEALTH ISSUES,0,33,39,25,22,119,0,20,23,9,4,56,0,0,0,0,0,0,175
4420,HARYANA,2002,13,HERO WORSHIP,0,0,0,0,0,0,0,0,0,0,0,0,0,0,0,0,0,0,0
4965,HARYANA,2002,13,ILLEGITIMATE PREGNANCY,0,0,0,0,0,0,0,0,0,0,0,0,0,0,0,0,0,0,0
5510,HARYANA,2002,13,LOVE AFFAIRS,0,22,2,1,0,25,0,14,2,0,0,16,0,0,0,0,0,0,41
6055,HARYANA,2002,13,MARITAL ISSUES,0,12,11,1,1,25,0,55,28,1,0,84,0,0,0,0,0,0,109
6601,HARYANA,2002,13,MENTAL HEALTH,0,17,23,8,2,50,0,5,5,0,0,10,0,0,0,0,0,0,60
7147,HARYANA,2002,13,OTHERS,26,233,355,142,44,800,16,136,84,22,6,264,0,0,0,0,0,0,1064
7732,HARYANA,2002,13,"PHYSICAL ABUSE (RAPE,INCEST ETC.)",0,1,0,1,0,2,0,0,0,0,0,0,0,0,0,0,0,0,2
8238,HARYANA,2002,13,SOCIETAL ISSUES,0,5,5,8,0,18,0,0,1,0,0,1,0,0,0,0,0,0,19
91,HARYANA,2003,13,CAUSES NOT KNOWN,5,78,54,29,13,179,4,33,13,5,1,56,0,0,0,0,0,0,235
637,HARYANA,2003,13,DEATH OF DEAR PERSON,0,4,9,7,2,22,0,4,3,0,1,8,0,0,0,0,0,0,30
1183,HARYANA,2003,13,DOWRY DISPUTE,0,1,0,0,0,1,0,9,5,0,0,14,0,0,0,0,0,0,15
1729,HARYANA,2003,13,DRUG ABUSE,2,11,16,5,3,37,0,26,14,1,0,41,0,0,0,0,0,0,78
2275,HARYANA,2003,13,ECONOMIC ISSUES,0,62,67,32,2,163,0,17,9,3,2,31,0,0,0,0,0,0,194
2821,HARYANA,2003,13,EXAM FAILURE,4,14,5,0,0,23,3,8,1,0,0,12,0,0,0,0,0,0,35
3367,HARYANA,2003,13,FAMILY PROBLEMS,4,88,56,28,5,181,2,56,34,13,0,105,0,0,0,0,0,0,286
3913,HARYANA,2003,13,HEALTH ISSUES,1,43,50,32,21,147,2,19,26,6,2,55,0,0,0,0,0,0,202
4459,HARYANA,2003,13,HERO WORSHIP,0,4,18,3,0,25,0,5,3,1,0,9,0,0,0,0,0,0,34
5004,HARYANA,2003,13,ILLEGITIMATE PREGNANCY,0,0,0,0,0,0,0,0,0,0,0,0,0,0,0,0,0,0,0
5549,HARYANA,2003,13,LOVE AFFAIRS,0,10,9,2,0,21,0,9,0,1,0,10,0,0,0,0,0,0,31
6094,HARYANA,2003,13,MARITAL ISSUES,0,13,23,8,0,44,0,34,18,3,1,56,0,0,0,0,0,0,100
6640,HARYANA,2003,13,MENTAL HEALTH,0,47,71,43,6,167,1,27,26,10,5,69,0,0,0,0,0,0,236
7186,HARYANA,2003,13,OTHERS,18,189,215,101,51,574,12,62,33,22,12,141,0,0,0,0,0,0,715
7771,HARYANA,2003,13,"PHYSICAL ABUSE (RAPE,INCEST ETC.)",0,5,3,2,0,10,0,4,0,0,0,4,0,0,0,0,0,0,14
8277,HARYANA,2003,13,SOCIETAL ISSUES,0,7,6,6,0,19,1,1,0,1,0,3,0,0,0,0,0,0,22
130,HARYANA,2004,13,CAUSES NOT KNOWN,10,40,33,20,13,116,3,10,14,8,5,40,0,0,0,0,0,0,156
676,HARYANA,2004,13,DEATH OF DEAR PERSON,0,3,10,4,3,20,1,3,3,0,0,7,0,0,0,0,0,0,27
1222,HARYANA,2004,13,DOWRY DISPUTE,0,0,0,0,0,0,0,13,7,3,0,23,0,0,0,0,0,0,23
1768,HARYANA,2004,13,DRUG ABUSE,4,16,12,5,1,38,0,18,9,1,0,28,0,0,0,0,0,0,66
2314,HARYANA,2004,13,ECONOMIC ISSUES,0,68,73,53,9,203,0,13,13,4,4,34,0,0,0,0,0,0,237
2860,HARYANA,2004,13,EXAM FAILURE,2,13,0,0,0,15,4,6,0,0,0,10,0,0,0,0,0,0,25
3406,HARYANA,2004,13,FAMILY PROBLEMS,2,96,90,46,18,252,4,76,48,15,3,146,0,0,0,0,0,0,398
3952,HARYANA,2004,13,HEALTH ISSUES,0,20,29,17,30,96,0,11,12,12,2,37,0,0,0,0,0,0,133
4498,HARYANA,2004,13,HERO WORSHIP,0,0,0,0,0,0,0,0,0,0,0,0,0,0,0,0,0,0,0
5043,HARYANA,2004,13,ILLEGITIMATE PREGNANCY,0,0,0,0,0,0,0,0,0,0,0,0,0,0,0,0,0,0,0
5588,HARYANA,2004,13,LOVE AFFAIRS,0,16,5,2,0,23,0,12,2,0,0,14,0,0,0,0,0,0,37
6133,HARYANA,2004,13,MARITAL ISSUES,0,14,6,0,0,20,0,11,5,2,0,18,0,0,0,0,0,0,38
6679,HARYANA,2004,13,MENTAL HEALTH,0,8,13,6,1,28,0,6,3,3,0,12,0,0,0,0,0,0,40
7225,HARYANA,2004,13,OTHERS,16,218,267,100,29,630,10,127,88,23,8,256,0,0,0,0,0,0,886
7810,HARYANA,2004,13,"PHYSICAL ABUSE (RAPE,INCEST ETC.)",0,0,0,0,0,0,0,0,0,0,1,1,0,0,0,0,0,0,1
8316,HARYANA,2004,13,SOCIETAL ISSUES,0,4,6,2,1,13,0,1,0,1,0,2,0,0,0,0,0,0,15
169,HARYANA,2005,13,CAUSES NOT KNOWN,2,46,46,19,6,119,0,22,9,5,1,37,0,0,0,0,0,0,156
715,HARYANA,2005,13,DEATH OF DEAR PERSON,0,4,6,14,3,27,0,0,0,1,0,1,0,0,0,0,0,0,28
1261,HARYANA,2005,13,DOWRY DISPUTE,0,2,2,1,0,5,0,7,12,2,2,23,0,0,0,0,0,0,28
1807,HARYANA,2005,13,DRUG ABUSE,0,14,22,14,0,50,0,0,0,0,0,0,0,0,0,0,0,0,50
2353,HARYANA,2005,13,ECONOMIC ISSUES,7,44,43,24,7,125,6,25,19,8,5,63,0,0,0,0,0,0,188
2899,HARYANA,2005,13,EXAM FAILURE,0,7,0,0,0,7,1,6,0,0,0,7,0,0,0,0,0,0,14
3445,HARYANA,2005,13,FAMILY PROBLEMS,5,95,101,36,11,248,0,57,44,19,0,120,0,0,0,0,0,0,368
3991,HARYANA,2005,13,HEALTH ISSUES,3,68,92,38,20,221,1,16,16,11,1,45,0,0,0,0,0,0,266
4537,HARYANA,2005,13,HERO WORSHIP,0,0,0,0,0,0,0,0,0,0,0,0,0,0,0,0,0,0,0
5082,HARYANA,2005,13,ILLEGITIMATE PREGNANCY,0,0,0,0,0,0,0,0,0,0,0,0,0,0,0,0,0,0,0
5627,HARYANA,2005,13,LOVE AFFAIRS,0,12,2,0,0,14,0,8,1,0,0,9,0,0,0,0,0,0,23
6172,HARYANA,2005,13,MARITAL ISSUES,0,30,45,10,7,92,0,28,7,1,0,36,0,0,0,0,0,0,128
6718,HARYANA,2005,13,MENTAL HEALTH,0,27,19,16,0,62,1,6,7,2,0,16,0,0,0,0,0,0,78
7264,HARYANA,2005,13,OTHERS,10,157,227,101,19,514,6,77,69,27,9,188,0,0,0,0,0,0,702
7849,HARYANA,2005,13,"PHYSICAL ABUSE (RAPE,INCEST ETC.)",0,1,0,0,0,1,0,1,0,0,0,1,0,0,0,0,0,0,2
8355,HARYANA,2005,13,SOCIETAL ISSUES,1,3,3,1,0,8,0,4,3,0,0,7,0,0,0,0,0,0,15
208,HARYANA,2006,13,CAUSES NOT KNOWN,4,137,117,80,28,366,3,33,34,12,7,89,0,0,0,0,0,0,455
754,HARYANA,2006,13,DEATH OF DEAR PERSON,0,2,2,0,0,4,0,6,1,0,0,7,0,0,0,0,0,0,11
1300,HARYANA,2006,13,DOWRY DISPUTE,0,0,0,0,0,0,0,7,0,0,0,7,0,0,0,0,0,0,7
1846,HARYANA,2006,13,DRUG ABUSE,0,12,24,4,1,41,0,0,0,0,0,0,0,0,0,0,0,0,41
2392,HARYANA,2006,13,ECONOMIC ISSUES,0,90,106,54,10,260,0,16,12,9,5,42,0,0,0,0,0,0,302
2938,HARYANA,2006,13,EXAM FAILURE,6,25,0,0,0,31,0,16,0,0,0,16,0,0,0,0,0,0,47
3484,HARYANA,2006,13,FAMILY PROBLEMS,5,117,123,41,8,294,1,67,55,16,5,144,0,0,0,0,0,0,438
4030,HARYANA,2006,13,HEALTH ISSUES,6,56,57,55,27,201,2,14,12,15,7,50,0,0,0,0,0,0,251
4576,HARYANA,2006,13,HERO WORSHIP,0,0,0,0,1,1,0,1,0,0,0,1,0,0,0,0,0,0,2
5121,HARYANA,2006,13,ILLEGITIMATE PREGNANCY,0,0,0,0,0,0,0,0,0,0,0,0,0,0,0,0,0,0,0
5666,HARYANA,2006,13,LOVE AFFAIRS,0,28,11,0,0,39,0,15,0,0,0,15,0,0,0,0,0,0,54
6211,HARYANA,2006,13,MARITAL ISSUES,0,7,7,1,0,15,0,5,2,0,0,7,0,0,0,0,0,0,22
6757,HARYANA,2006,13,MENTAL HEALTH,0,28,26,12,0,66,0,9,7,4,0,20,0,0,0,0,0,0,86
7303,HARYANA,2006,13,OTHERS,4,108,226,88,17,443,15,63,53,15,5,151,0,0,0,0,0,0,594
7888,HARYANA,2006,13,"PHYSICAL ABUSE (RAPE,INCEST ETC.)",0,0,0,0,0,0,0,0,1,0,0,1,0,0,0,0,0,0,1
8394,HARYANA,2006,13,SOCIETAL ISSUES,0,0,2,3,0,5,0,0,0,0,0,0,0,0,0,0,0,0,5
247,HARYANA,2007,13,CAUSES NOT KNOWN,4,92,61,30,10,197,0,29,12,5,4,50,0,0,0,0,0,0,247
793,HARYANA,2007,13,DEATH OF DEAR PERSON,0,0,1,0,0,1,0,1,0,0,0,1,0,0,0,0,0,0,2
1339,HARYANA,2007,13,DOWRY DISPUTE,0,0,0,0,0,0,0,53,5,1,0,59,0,0,0,0,0,0,59
1885,HARYANA,2007,13,DRUG ABUSE,0,13,16,12,2,43,0,0,0,0,0,0,0,0,0,0,0,0,43
2431,HARYANA,2007,13,ECONOMIC ISSUES,1,123,99,42,6,271,2,25,13,11,2,53,0,0,0,0,0,0,324
2977,HARYANA,2007,13,EXAM FAILURE,2,14,1,1,0,18,2,10,1,0,0,13,0,0,0,0,0,0,31
3523,HARYANA,2007,13,FAMILY PROBLEMS,2,104,143,50,19,318,1,58,52,24,2,137,0,0,0,0,0,0,455
4069,HARYANA,2007,13,HEALTH ISSUES,3,55,60,48,33,199,1,20,15,11,4,51,0,0,0,0,0,0,250
4614,HARYANA,2007,13,HERO WORSHIP,0,0,0,0,0,0,0,1,0,0,0,1,0,0,0,0,0,0,1
5159,HARYANA,2007,13,ILLEGITIMATE PREGNANCY,0,0,0,0,0,0,0,0,0,0,0,0,0,0,0,0,0,0,0
5704,HARYANA,2007,13,LOVE AFFAIRS,0,14,11,0,0,25,0,10,0,0,0,10,0,0,0,0,0,0,35
6250,HARYANA,2007,13,MARITAL ISSUES,0,16,8,0,0,24,0,21,6,0,0,27,0,0,0,0,0,0,51
6796,HARYANA,2007,13,MENTAL HEALTH,0,46,24,8,2,80,0,13,9,5,1,28,0,0,0,0,0,0,108
7342,HARYANA,2007,13,OTHERS,16,182,294,147,32,671,2,71,59,8,10,150,0,0,0,0,0,0,821
7926,HARYANA,2007,13,"PHYSICAL ABUSE (RAPE,INCEST ETC.)",0,0,0,0,0,0,0,1,0,0,0,1,0,0,0,0,0,0,1
8433,HARYANA,2007,13,SOCIETAL ISSUES,0,1,2,2,0,5,0,0,0,0,0,0,0,0,0,0,0,0,5
286,HARYANA,2008,13,CAUSES NOT KNOWN,9,144,159,58,47,417,8,41,35,9,4,97,0,0,0,0,0,0,514
832,HARYANA,2008,13,DEATH OF DEAR PERSON,0,1,0,1,1,3,0,1,0,0,1,2,0,0,0,0,0,0,5
1378,HARYANA,2008,13,DOWRY DISPUTE,0,4,5,0,0,9,0,10,4,1,1,16,0,0,0,0,0,0,25
1924,HARYANA,2008,13,DRUG ABUSE,0,13,19,5,0,37,0,0,2,0,0,2,0,0,0,0,0,0,39
2470,HARYANA,2008,13,ECONOMIC ISSUES,1,40,46,5,2,94,0,22,16,6,4,48,0,0,0,0,0,0,142
3016,HARYANA,2008,13,EXAM FAILURE,3,45,0,0,0,48,4,19,2,0,0,25,0,0,0,0,0,0,73
3562,HARYANA,2008,13,FAMILY PROBLEMS,3,109,143,37,21,313,3,38,35,11,1,88,0,0,0,0,0,0,401
4108,HARYANA,2008,13,HEALTH ISSUES,6,66,70,44,22,208,4,17,13,8,3,45,0,0,0,0,0,0,253
4653,HARYANA,2008,13,HERO WORSHIP,0,16,39,19,3,77,0,18,24,13,2,57,0,0,0,0,0,0,134
5198,HARYANA,2008,13,ILLEGITIMATE PREGNANCY,0,0,0,0,0,0,0,0,0,0,0,0,0,0,0,0,0,0,0
5743,HARYANA,2008,13,LOVE AFFAIRS,0,35,5,0,0,40,1,15,0,0,0,16,0,0,0,0,0,0,56
6289,HARYANA,2008,13,MARITAL ISSUES,0,2,2,0,0,4,0,4,1,0,0,5,0,0,0,0,0,0,9
6835,HARYANA,2008,13,MENTAL HEALTH,0,32,25,16,8,81,1,7,8,2,3,21,0,0,0,0,0,0,102
7381,HARYANA,2008,13,OTHERS,25,173,253,136,39,626,18,82,112,35,10,257,0,0,0,0,0,0,883
7965,HARYANA,2008,13,"PHYSICAL ABUSE (RAPE,INCEST ETC.)",0,6,6,1,0,13,0,0,3,0,0,3,0,0,0,0,0,0,16
8472,HARYANA,2008,13,SOCIETAL ISSUES,0,1,2,0,1,4,0,0,0,0,0,0,0,0,0,0,0,0,4
325,HARYANA,2009,13,CAUSES NOT KNOWN,13,150,139,79,16,397,11,53,26,11,3,104,0,0,0,0,0,0,501
871,HARYANA,2009,13,DEATH OF DEAR PERSON,0,1,2,2,1,6,0,1,1,1,0,3,0,0,0,0,0,0,9
1417,HARYANA,2009,13,DOWRY DISPUTE,0,3,6,0,0,9,0,7,0,0,0,7,0,0,0,0,0,0,16
1963,HARYANA,2009,13,DRUG ABUSE,0,15,26,4,1,46,0,0,0,0,0,0,0,0,0,0,0,0,46
2509,HARYANA,2009,13,ECONOMIC ISSUES,0,36,29,9,5,79,0,12,8,0,1,21,0,0,0,0,0,0,100
3055,HARYANA,2009,13,EXAM FAILURE,3,22,0,0,0,25,4,15,0,0,0,19,0,0,0,0,0,0,44
3601,HARYANA,2009,13,FAMILY PROBLEMS,5,182,195,78,18,478,3,99,79,24,5,210,0,0,0,0,0,0,688
4147,HARYANA,2009,13,HEALTH ISSUES,6,41,39,37,20,143,4,13,23,8,2,50,0,0,0,0,0,0,193
4692,HARYANA,2009,13,HERO WORSHIP,0,0,0,0,0,0,0,0,0,0,0,0,0,0,0,0,0,0,0
5237,HARYANA,2009,13,ILLEGITIMATE PREGNANCY,0,0,0,0,0,0,0,0,0,0,0,0,0,0,0,0,0,0,0
5782,HARYANA,2009,13,LOVE AFFAIRS,0,29,4,0,0,33,2,11,0,0,0,13,0,0,0,0,0,0,46
6328,HARYANA,2009,13,MARITAL ISSUES,1,5,4,1,0,11,2,5,1,0,0,8,0,0,0,0,0,0,19
6874,HARYANA,2009,13,MENTAL HEALTH,0,44,26,23,10,103,0,14,13,6,2,35,0,0,0,0,0,0,138
7420,HARYANA,2009,13,OTHERS,10,160,186,100,15,471,8,58,92,44,7,209,0,0,0,0,0,0,680
8004,HARYANA,2009,13,"PHYSICAL ABUSE (RAPE,INCEST ETC.)",0,0,0,0,0,0,0,2,0,0,0,2,0,0,0,0,0,0,2
8511,HARYANA,2009,13,SOCIETAL ISSUES,0,4,3,5,2,14,0,4,2,1,0,7,0,0,0,0,0,0,21
364,HARYANA,2010,13,CAUSES NOT KNOWN,6,172,158,95,35,466,7,38,35,12,6,98,0,0,0,0,0,0,564
910,HARYANA,2010,13,DEATH OF DEAR PERSON,0,2,1,0,0,3,0,2,0,0,0,2,0,0,0,0,0,0,5
1456,HARYANA,2010,13,DOWRY DISPUTE,0,0,0,0,0,0,0,4,2,0,0,6,0,0,0,0,0,0,6
2002,HARYANA,2010,13,DRUG ABUSE,0,19,24,7,1,51,0,0,0,0,0,0,0,0,0,0,0,0,51
2548,HARYANA,2010,13,ECONOMIC ISSUES,0,82,59,25,5,171,0,11,13,4,1,29,0,0,0,0,0,0,200
3094,HARYANA,2010,13,EXAM FAILURE,1,20,0,0,0,21,2,15,0,0,0,17,0,0,0,0,0,0,38
3640,HARYANA,2010,13,FAMILY PROBLEMS,2,162,170,68,16,418,0,111,58,21,8,198,0,0,0,0,0,0,616
4186,HARYANA,2010,13,HEALTH ISSUES,2,26,24,24,16,92,0,12,14,3,3,32,0,0,0,0,0,0,124
4731,HARYANA,2010,13,HERO WORSHIP,0,0,0,0,0,0,0,0,0,0,0,0,0,0,0,0,0,0,0
5276,HARYANA,2010,13,ILLEGITIMATE PREGNANCY,0,0,0,0,0,0,0,1,0,0,0,1,0,0,0,0,0,0,1
5821,HARYANA,2010,13,LOVE AFFAIRS,0,13,3,1,0,17,0,11,0,0,0,11,0,0,0,0,0,0,28
6367,HARYANA,2010,13,MARITAL ISSUES,0,3,0,0,0,3,0,2,4,0,0,6,0,0,0,0,0,0,9
6913,HARYANA,2010,13,MENTAL HEALTH,0,55,36,23,6,120,0,27,12,6,2,47,0,0,0,0,0,0,167
7459,HARYANA,2010,13,OTHERS,13,284,260,209,43,809,8,84,104,63,9,268,0,0,0,0,0,0,1077
8043,HARYANA,2010,13,"PHYSICAL ABUSE (RAPE,INCEST ETC.)",0,1,2,2,0,5,0,2,0,0,0,2,0,0,0,0,0,0,7
8550,HARYANA,2010,13,SOCIETAL ISSUES,0,0,1,1,0,2,0,0,0,0,0,0,0,0,0,0,0,0,2
403,HARYANA,2011,13,CAUSES NOT KNOWN,7,60,49,23,7,146,0,31,14,4,0,49,0,0,0,0,0,0,195
949,HARYANA,2011,13,DEATH OF DEAR PERSON,0,1,2,0,0,3,0,2,0,0,0,2,0,0,0,0,0,0,5
1495,HARYANA,2011,13,DOWRY DISPUTE,0,0,0,0,0,0,0,0,0,0,0,0,0,0,0,0,0,0,0
2041,HARYANA,2011,13,DRUG ABUSE,0,23,41,14,1,79,0,4,2,0,0,6,0,0,0,0,0,0,85
2587,HARYANA,2011,13,ECONOMIC ISSUES,2,96,77,43,7,225,0,18,17,19,2,56,0,0,0,0,0,0,281
3133,HARYANA,2011,13,EXAM FAILURE,0,22,0,0,0,22,0,17,0,0,0,17,0,0,0,0,0,0,39
3679,HARYANA,2011,13,FAMILY PROBLEMS,9,108,142,75,13,347,0,78,52,22,3,155,0,0,0,0,0,0,502
4225,HARYANA,2011,13,HEALTH ISSUES,2,28,49,35,24,138,1,15,11,5,2,34,0,0,0,0,0,0,172
4770,HARYANA,2011,13,HERO WORSHIP,0,0,0,0,0,0,0,0,0,0,0,0,0,0,0,0,0,0,0
5315,HARYANA,2011,13,ILLEGITIMATE PREGNANCY,0,0,0,0,0,0,0,0,0,0,0,0,0,0,0,0,0,0,0
5860,HARYANA,2011,13,LOVE AFFAIRS,0,10,1,0,0,11,0,5,1,0,0,6,0,0,0,0,0,0,17
6406,HARYANA,2011,13,MARITAL ISSUES,0,5,6,0,0,11,0,7,4,0,0,11,0,0,0,0,0,0,22
6952,HARYANA,2011,13,MENTAL HEALTH,0,42,25,21,4,92,0,21,12,3,2,38,0,0,0,0,0,0,130
7498,HARYANA,2011,13,OTHERS,50,564,491,230,51,1386,24,182,138,54,8,406,0,0,0,0,0,0,1792
8082,HARYANA,2011,13,"PHYSICAL ABUSE (RAPE,INCEST ETC.)",0,2,0,0,0,2,0,0,0,0,0,0,0,0,0,0,0,0,2
8589,HARYANA,2011,13,SOCIETAL ISSUES,0,0,2,0,0,2,0,0,1,0,0,1,0,0,0,0,0,0,3
442,HARYANA,2012,13,CAUSES NOT KNOWN,14,233,191,89,49,576,14,69,41,16,3,143,0,0,0,0,0,0,719
988,HARYANA,2012,13,DEATH OF DEAR PERSON,0,0,1,0,0,1,0,4,0,0,0,4,0,0,0,0,0,0,5
1534,HARYANA,2012,13,DOWRY DISPUTE,0,0,0,0,0,0,0,1,0,0,0,1,0,0,0,0,0,0,1
2080,HARYANA,2012,13,DRUG ABUSE,0,20,32,17,2,71,0,0,1,0,0,1,0,0,0,0,0,0,72
2626,HARYANA,2012,13,ECONOMIC ISSUES,0,88,76,29,4,197,1,37,16,2,1,57,0,0,0,0,0,0,254
3172,HARYANA,2012,13,EXAM FAILURE,3,32,2,0,0,37,0,15,0,0,0,15,0,0,0,0,0,0,52
3718,HARYANA,2012,13,FAMILY PROBLEMS,2,76,100,40,4,222,0,62,37,9,6,114,0,0,0,0,0,0,336
4264,HARYANA,2012,13,HEALTH ISSUES,1,29,53,42,21,146,3,19,11,4,3,40,0,0,0,0,0,0,186
4809,HARYANA,2012,13,HERO WORSHIP,4,23,10,10,2,49,1,17,15,5,3,41,0,0,0,0,0,0,90
5354,HARYANA,2012,13,ILLEGITIMATE PREGNANCY,0,0,0,0,0,0,0,0,0,0,0,0,0,0,0,0,0,0,0
5899,HARYANA,2012,13,LOVE AFFAIRS,0,14,2,0,0,16,0,3,0,1,0,4,0,0,0,0,0,0,20
6445,HARYANA,2012,13,MARITAL ISSUES,0,14,3,2,0,19,0,7,6,0,0,13,0,0,0,0,0,0,32
6991,HARYANA,2012,13,MENTAL HEALTH,0,34,28,23,7,92,0,22,15,3,2,42,0,0,0,0,0,0,134
7537,HARYANA,2012,13,OTHERS,19,203,238,144,39,643,9,97,92,63,16,277,0,0,0,0,0,0,920
8121,HARYANA,2012,13,"PHYSICAL ABUSE (RAPE,INCEST ETC.)",0,0,0,0,0,0,0,4,0,0,0,4,0,0,0,0,0,0,4
8628,HARYANA,2012,13,SOCIETAL ISSUES,0,0,1,1,0,2,0,0,0,0,0,0,0,0,0,0,0,0,2
481,HARYANA,2013,13,CAUSES NOT KNOWN,13,168,244,224,85,734,18,66,32,22,19,157,0,0,0,0,0,0,891
1027,HARYANA,2013,13,DEATH OF DEAR PERSON,0,0,0,0,0,0,0,4,0,0,0,4,0,0,0,0,0,0,4
1573,HARYANA,2013,13,DOWRY DISPUTE,0,1,0,0,0,1,0,3,1,0,0,4,0,0,0,0,0,0,5
2119,HARYANA,2013,13,DRUG ABUSE,0,26,44,25,4,99,0,0,1,0,0,1,0,0,0,0,0,0,100
2665,HARYANA,2013,13,ECONOMIC ISSUES,1,64,64,16,3,148,0,35,9,2,1,47,0,0,0,0,0,0,195
3211,HARYANA,2013,13,EXAM FAILURE,1,24,1,0,0,26,0,20,0,0,0,20,0,0,0,0,0,0,46
3757,HARYANA,2013,13,FAMILY PROBLEMS,2,93,97,41,3,236,2,62,47,9,1,121,0,0,0,0,0,0,357
4303,HARYANA,2013,13,HEALTH ISSUES,2,30,69,66,24,191,2,13,20,10,5,50,0,0,0,0,0,0,241
4848,HARYANA,2013,13,HERO WORSHIP,1,28,11,6,2,48,1,13,10,3,2,29,0,0,0,0,0,0,77
5393,HARYANA,2013,13,ILLEGITIMATE PREGNANCY,0,0,0,0,0,0,0,1,0,0,0,1,0,0,0,0,0,0,1
5938,HARYANA,2013,13,LOVE AFFAIRS,0,13,3,0,0,16,0,10,1,1,0,12,0,0,0,0,0,0,28
6484,HARYANA,2013,13,MARITAL ISSUES,0,8,3,3,0,14,0,7,5,0,0,12,0,0,0,0,0,0,26
7030,HARYANA,2013,13,MENTAL HEALTH,0,37,32,29,7,105,1,26,14,5,2,48,0,0,0,0,0,0,153
7576,HARYANA,2013,13,OTHERS,38,279,303,217,47,884,18,150,78,49,11,306,0,0,0,0,0,0,1190
8160,HARYANA,2013,13,"PHYSICAL ABUSE (RAPE,INCEST ETC.)",0,0,0,0,0,0,0,0,0,0,0,0,0,0,0,0,0,0,0
8667,HARYANA,2013,13,SOCIETAL ISSUES,0,0,0,0,0,0,1,1,0,0,0,2,0,0,0,0,0,0,2
520,HARYANA,2014,13,CAUSES NOT KNOWN,1,228,170,125,37,561,5,70,38,9,6,128,0,0,0,0,0,0,689
1066,HARYANA,2014,13,DEATH OF DEAR PERSON,0,0,3,0,0,3,0,3,0,0,1,4,0,0,0,0,0,0,7
1612,HARYANA,2014,13,DOWRY DISPUTE,0,0,1,0,0,1,0,12,5,0,0,17,0,0,0,0,0,0,18
2158,HARYANA,2014,13,DRUG ABUSE,0,15,42,25,4,86,0,0,0,0,0,0,0,0,0,0,0,0,86
2704,HARYANA,2014,13,ECONOMIC ISSUES,0,64,50,18,4,136,0,13,6,3,0,22,0,0,0,0,0,0,158
3250,HARYANA,2014,13,EXAM FAILURE,2,21,0,0,0,23,1,7,0,0,0,8,0,0,0,0,0,0,31
3796,HARYANA,2014,13,FAMILY PROBLEMS,2,100,98,34,6,240,2,56,45,5,2,110,0,0,0,0,0,0,350
4342,HARYANA,2014,13,HEALTH ISSUES,0,91,160,195,65,511,2,61,29,22,4,118,0,0,0,0,0,0,629
4887,HARYANA,2014,13,HERO WORSHIP,0,0,0,0,0,0,0,0,0,0,0,0,0,0,0,0,0,0,0
5432,HARYANA,2014,13,ILLEGITIMATE PREGNANCY,0,0,0,0,0,0,0,0,0,0,0,0,0,0,0,0,0,0,0
5977,HARYANA,2014,13,LOVE AFFAIRS,0,12,2,0,0,14,0,9,0,0,0,9,0,0,0,0,0,0,23
6523,HARYANA,2014,13,MARITAL ISSUES,0,6,5,2,0,13,0,28,5,0,0,33,0,0,0,0,0,0,46
7069,HARYANA,2014,13,MENTAL HEALTH,0,21,26,9,1,57,0,15,3,4,0,22,0,0,0,0,0,0,79
7615,HARYANA,2014,13,OTHERS,27,455,444,171,51,1148,9,162,79,32,14,296,0,0,0,0,0,0,1444
7654,HARYANA,2014,13,PHYSICAL ABUSE,0,0,0,0,0,0,0,0,0,0,0,0,0,0,0,0,0,0,0
8706,HARYANA,2014,13,SOCIETAL ISSUES,0,9,8,3,1,21,0,9,3,0,0,12,0,0,0,0,0,0,33
14,HIMACHAL PRADESH,2001,14,CAUSES NOT KNOWN,0,12,13,10,3,38,1,6,8,2,1,18,0,0,0,0,0,0,56
560,HIMACHAL PRADESH,2001,14,DEATH OF DEAR PERSON,0,1,0,0,0,1,0,2,0,1,0,3,0,0,0,0,0,0,4
1106,HIMACHAL PRADESH,2001,14,DOWRY DISPUTE,0,1,0,0,0,1,0,9,1,0,0,10,0,0,0,0,0,0,11
1652,HIMACHAL PRADESH,2001,14,DRUG ABUSE,0,0,0,0,0,0,0,0,0,0,0,0,0,0,0,0,0,0,0
2198,HIMACHAL PRADESH,2001,14,ECONOMIC ISSUES,0,7,4,4,2,17,0,1,4,3,4,12,0,0,0,0,0,0,29
2744,HIMACHAL PRADESH,2001,14,EXAM FAILURE,1,5,0,0,0,6,1,4,0,0,0,5,0,0,0,0,0,0,11
3290,HIMACHAL PRADESH,2001,14,FAMILY PROBLEMS,0,13,25,11,2,51,0,25,11,2,0,38,0,0,0,0,0,0,89
3836,HIMACHAL PRADESH,2001,14,HEALTH ISSUES,0,2,1,10,2,15,0,3,2,3,0,8,0,0,0,0,0,0,23
4382,HIMACHAL PRADESH,2001,14,HERO WORSHIP,0,0,0,0,0,0,0,0,0,0,0,0,0,0,0,0,0,0,0
4927,HIMACHAL PRADESH,2001,14,ILLEGITIMATE PREGNANCY,0,0,0,0,0,0,0,0,0,0,0,0,0,0,0,0,0,0,0
5472,HIMACHAL PRADESH,2001,14,LOVE AFFAIRS,0,1,3,0,0,4,0,7,1,0,0,8,0,0,0,0,0,0,12
6017,HIMACHAL PRADESH,2001,14,MARITAL ISSUES,0,0,2,0,0,2,0,3,3,0,0,6,0,0,0,0,0,0,8
6563,HIMACHAL PRADESH,2001,14,MENTAL HEALTH,0,0,5,4,0,9,0,4,5,0,0,9,0,0,0,0,0,0,18
7109,HIMACHAL PRADESH,2001,14,OTHERS,0,12,10,10,0,32,1,6,3,3,0,13,0,0,0,0,0,0,45
7694,HIMACHAL PRADESH,2001,14,"PHYSICAL ABUSE (RAPE,INCEST ETC.)",0,0,0,0,0,0,0,0,0,0,0,0,0,0,0,0,0,0,0
8200,HIMACHAL PRADESH,2001,14,SOCIETAL ISSUES,0,0,1,0,0,1,0,0,0,0,0,0,0,0,0,0,0,0,1
53,HIMACHAL PRADESH,2002,14,CAUSES NOT KNOWN,0,16,13,3,2,34,0,6,2,1,0,9,0,0,0,0,0,0,43
599,HIMACHAL PRADESH,2002,14,DEATH OF DEAR PERSON,0,0,0,0,0,0,0,0,0,0,0,0,0,0,0,0,0,0,0
1145,HIMACHAL PRADESH,2002,14,DOWRY DISPUTE,0,0,0,0,0,0,0,6,0,0,0,6,0,0,0,0,0,0,6
1691,HIMACHAL PRADESH,2002,14,DRUG ABUSE,0,0,5,1,0,6,0,0,0,0,0,0,0,0,0,0,0,0,6
2237,HIMACHAL PRADESH,2002,14,ECONOMIC ISSUES,0,2,3,2,0,7,0,2,1,1,0,4,0,0,0,0,0,0,11
2783,HIMACHAL PRADESH,2002,14,EXAM FAILURE,1,6,0,0,0,7,0,5,0,0,0,5,0,0,0,0,0,0,12
3329,HIMACHAL PRADESH,2002,14,FAMILY PROBLEMS,1,7,26,6,0,40,2,22,14,3,0,41,0,0,0,0,0,0,81
3875,HIMACHAL PRADESH,2002,14,HEALTH ISSUES,0,4,6,5,2,17,0,6,4,1,1,12,0,0,0,0,0,0,29
4421,HIMACHAL PRADESH,2002,14,HERO WORSHIP,0,0,0,1,0,1,0,0,0,0,0,0,0,0,0,0,0,0,1
4966,HIMACHAL PRADESH,2002,14,ILLEGITIMATE PREGNANCY,0,0,0,0,0,0,0,2,0,0,0,2,0,0,0,0,0,0,2
5511,HIMACHAL PRADESH,2002,14,LOVE AFFAIRS,0,7,1,0,0,8,0,5,0,0,0,5,0,0,0,0,0,0,13
6056,HIMACHAL PRADESH,2002,14,MARITAL ISSUES,0,5,3,0,0,8,0,5,3,0,0,8,0,0,0,0,0,0,16
6602,HIMACHAL PRADESH,2002,14,MENTAL HEALTH,0,5,4,6,1,16,0,2,3,2,1,8,0,0,0,0,0,0,24
7148,HIMACHAL PRADESH,2002,14,OTHERS,2,34,21,5,1,63,1,15,10,0,0,26,0,0,0,0,0,0,89
7733,HIMACHAL PRADESH,2002,14,"PHYSICAL ABUSE (RAPE,INCEST ETC.)",0,1,0,0,0,1,0,0,0,0,0,0,0,0,0,0,0,0,1
8239,HIMACHAL PRADESH,2002,14,SOCIETAL ISSUES,0,0,0,0,0,0,0,0,0,0,0,0,0,0,0,0,0,0,0
92,HIMACHAL PRADESH,2003,14,CAUSES NOT KNOWN,0,18,13,16,0,47,3,10,6,1,0,20,0,0,0,0,0,0,67
638,HIMACHAL PRADESH,2003,14,DEATH OF DEAR PERSON,0,1,0,0,0,1,0,0,0,0,0,0,0,0,0,0,0,0,1
1184,HIMACHAL PRADESH,2003,14,DOWRY DISPUTE,0,0,0,0,0,0,0,5,0,0,0,5,0,0,0,0,0,0,5
1730,HIMACHAL PRADESH,2003,14,DRUG ABUSE,0,0,1,0,0,1,0,0,0,0,0,0,0,0,0,0,0,0,1
2276,HIMACHAL PRADESH,2003,14,ECONOMIC ISSUES,0,5,8,7,0,20,0,1,3,1,0,5,0,0,0,0,0,0,25
2822,HIMACHAL PRADESH,2003,14,EXAM FAILURE,2,1,0,0,0,3,2,5,1,0,0,8,0,0,0,0,0,0,11
3368,HIMACHAL PRADESH,2003,14,FAMILY PROBLEMS,0,8,17,7,2,34,0,15,14,1,0,30,0,0,0,0,0,0,64
3914,HIMACHAL PRADESH,2003,14,HEALTH ISSUES,0,2,6,10,2,20,0,1,2,1,0,4,0,0,0,0,0,0,24
4460,HIMACHAL PRADESH,2003,14,HERO WORSHIP,0,0,0,0,0,0,0,0,0,0,0,0,0,0,0,0,0,0,0
5005,HIMACHAL PRADESH,2003,14,ILLEGITIMATE PREGNANCY,0,0,0,0,0,0,0,0,0,0,0,0,0,0,0,0,0,0,0
5550,HIMACHAL PRADESH,2003,14,LOVE AFFAIRS,0,7,2,0,0,9,0,12,0,0,0,12,0,0,0,0,0,0,21
6095,HIMACHAL PRADESH,2003,14,MARITAL ISSUES,0,6,3,3,0,12,0,5,3,1,0,9,0,0,0,0,0,0,21
6641,HIMACHAL PRADESH,2003,14,MENTAL HEALTH,0,7,5,9,7,28,0,2,3,7,2,14,0,0,0,0,0,0,42
7187,HIMACHAL PRADESH,2003,14,OTHERS,0,23,26,11,5,65,0,15,14,9,0,38,0,0,0,0,0,0,103
7772,HIMACHAL PRADESH,2003,14,"PHYSICAL ABUSE (RAPE,INCEST ETC.)",0,0,0,0,0,0,0,0,0,0,0,0,0,0,0,0,0,0,0
8278,HIMACHAL PRADESH,2003,14,SOCIETAL ISSUES,0,0,0,0,0,0,0,1,0,0,0,1,0,0,0,0,0,0,1
131,HIMACHAL PRADESH,2004,14,CAUSES NOT KNOWN,0,16,23,11,7,57,0,13,9,3,0,25,0,0,0,0,0,0,82
677,HIMACHAL PRADESH,2004,14,DEATH OF DEAR PERSON,0,0,0,0,0,0,0,0,0,0,0,0,0,0,0,0,0,0,0
1223,HIMACHAL PRADESH,2004,14,DOWRY DISPUTE,0,0,0,0,0,0,0,4,0,0,0,4,0,0,0,0,0,0,4
1769,HIMACHAL PRADESH,2004,14,DRUG ABUSE,0,3,0,1,0,4,0,0,0,0,0,0,0,0,0,0,0,0,4
2315,HIMACHAL PRADESH,2004,14,ECONOMIC ISSUES,0,6,6,0,0,12,1,2,1,0,0,4,0,0,0,0,0,0,16
2861,HIMACHAL PRADESH,2004,14,EXAM FAILURE,1,1,0,0,0,2,0,5,0,0,0,5,0,0,0,0,0,0,7
3407,HIMACHAL PRADESH,2004,14,FAMILY PROBLEMS,0,26,26,9,3,64,1,15,17,2,0,35,0,0,0,0,0,0,99
3953,HIMACHAL PRADESH,2004,14,HEALTH ISSUES,0,4,8,6,2,20,0,2,1,3,1,7,0,0,0,0,0,0,27
4499,HIMACHAL PRADESH,2004,14,HERO WORSHIP,0,0,0,0,0,0,0,0,0,0,0,0,0,0,0,0,0,0,0
5044,HIMACHAL PRADESH,2004,14,ILLEGITIMATE PREGNANCY,0,0,0,0,0,0,0,0,0,0,0,0,0,0,0,0,0,0,0
5589,HIMACHAL PRADESH,2004,14,LOVE AFFAIRS,0,7,0,0,0,7,0,7,1,0,0,8,0,0,0,0,0,0,15
6134,HIMACHAL PRADESH,2004,14,MARITAL ISSUES,0,4,1,1,0,6,0,8,3,0,0,11,0,0,0,0,0,0,17
6680,HIMACHAL PRADESH,2004,14,MENTAL HEALTH,0,4,7,3,0,14,0,4,0,3,1,8,0,0,0,0,0,0,22
7226,HIMACHAL PRADESH,2004,14,OTHERS,4,4,11,19,6,44,2,10,10,3,2,27,0,0,0,0,0,0,71
7811,HIMACHAL PRADESH,2004,14,"PHYSICAL ABUSE (RAPE,INCEST ETC.)",0,0,0,0,0,0,0,1,0,0,0,1,0,0,0,0,0,0,1
8317,HIMACHAL PRADESH,2004,14,SOCIETAL ISSUES,0,2,0,4,0,6,0,0,0,0,0,0,0,0,0,0,0,0,6
170,HIMACHAL PRADESH,2005,14,CAUSES NOT KNOWN,0,8,9,6,3,26,0,3,2,3,1,9,0,0,0,0,0,0,35
716,HIMACHAL PRADESH,2005,14,DEATH OF DEAR PERSON,0,0,0,0,0,0,0,1,0,0,0,1,0,0,0,0,0,0,1
1262,HIMACHAL PRADESH,2005,14,DOWRY DISPUTE,0,0,0,0,0,0,0,2,3,1,0,6,0,0,0,0,0,0,6
1808,HIMACHAL PRADESH,2005,14,DRUG ABUSE,0,1,1,0,3,5,0,0,0,0,0,0,0,0,0,0,0,0,5
2354,HIMACHAL PRADESH,2005,14,ECONOMIC ISSUES,0,2,10,2,0,14,0,1,1,1,0,3,0,0,0,0,0,0,17
2900,HIMACHAL PRADESH,2005,14,EXAM FAILURE,0,5,0,0,0,5,0,8,0,0,0,8,0,0,0,0,0,0,13
3446,HIMACHAL PRADESH,2005,14,FAMILY PROBLEMS,0,12,26,15,4,57,0,25,18,4,0,47,0,0,0,0,0,0,104
3992,HIMACHAL PRADESH,2005,14,HEALTH ISSUES,0,4,7,5,2,18,1,7,7,2,0,17,0,0,0,0,0,0,35
4538,HIMACHAL PRADESH,2005,14,HERO WORSHIP,0,0,0,0,0,0,0,0,0,0,0,0,0,0,0,0,0,0,0
5083,HIMACHAL PRADESH,2005,14,ILLEGITIMATE PREGNANCY,0,0,0,0,0,0,0,0,0,0,0,0,0,0,0,0,0,0,0
5628,HIMACHAL PRADESH,2005,14,LOVE AFFAIRS,0,10,1,0,0,11,0,9,1,0,0,10,0,0,0,0,0,0,21
6173,HIMACHAL PRADESH,2005,14,MARITAL ISSUES,0,4,6,0,1,11,0,6,5,0,0,11,0,0,0,0,0,0,22
6719,HIMACHAL PRADESH,2005,14,MENTAL HEALTH,0,3,3,3,2,11,0,5,1,0,0,6,0,0,0,0,0,0,17
7265,HIMACHAL PRADESH,2005,14,OTHERS,2,20,21,10,0,53,0,14,9,2,2,27,0,0,0,0,0,0,80
7850,HIMACHAL PRADESH,2005,14,"PHYSICAL ABUSE (RAPE,INCEST ETC.)",0,0,0,0,0,0,0,0,0,0,0,0,0,0,0,0,0,0,0
8356,HIMACHAL PRADESH,2005,14,SOCIETAL ISSUES,0,0,2,1,0,3,0,0,0,0,0,0,0,0,0,0,0,0,3
209,HIMACHAL PRADESH,2006,14,CAUSES NOT KNOWN,0,15,19,7,2,43,0,12,7,6,1,26,0,0,0,0,0,0,69
755,HIMACHAL PRADESH,2006,14,DEATH OF DEAR PERSON,0,0,0,0,0,0,0,1,0,0,0,1,0,0,0,0,0,0,1
1301,HIMACHAL PRADESH,2006,14,DOWRY DISPUTE,0,0,0,0,0,0,0,2,1,3,0,6,0,0,0,0,0,0,6
1847,HIMACHAL PRADESH,2006,14,DRUG ABUSE,0,4,6,1,0,11,0,1,0,1,0,2,0,0,0,0,0,0,13
2393,HIMACHAL PRADESH,2006,14,ECONOMIC ISSUES,0,0,6,5,0,11,0,1,1,0,0,2,0,0,0,0,0,0,13
2939,HIMACHAL PRADESH,2006,14,EXAM FAILURE,1,5,0,0,0,6,0,4,0,0,0,4,0,0,0,0,0,0,10
3485,HIMACHAL PRADESH,2006,14,FAMILY PROBLEMS,0,17,30,26,8,81,0,21,11,12,2,46,0,0,0,0,0,0,127
4031,HIMACHAL PRADESH,2006,14,HEALTH ISSUES,0,7,22,8,8,45,0,3,8,7,2,20,0,0,0,0,0,0,65
4577,HIMACHAL PRADESH,2006,14,HERO WORSHIP,0,0,0,0,0,0,0,0,0,0,0,0,0,0,0,0,0,0,0
5122,HIMACHAL PRADESH,2006,14,ILLEGITIMATE PREGNANCY,0,0,0,0,0,0,0,0,0,0,0,0,0,0,0,0,0,0,0
5667,HIMACHAL PRADESH,2006,14,LOVE AFFAIRS,0,9,1,0,0,10,0,8,2,0,0,10,0,0,0,0,0,0,20
6212,HIMACHAL PRADESH,2006,14,MARITAL ISSUES,0,3,3,0,0,6,0,3,3,1,0,7,0,0,0,0,0,0,13
6758,HIMACHAL PRADESH,2006,14,MENTAL HEALTH,0,10,12,6,1,29,0,1,2,3,3,9,0,0,0,0,0,0,38
7304,HIMACHAL PRADESH,2006,14,OTHERS,3,19,20,12,2,56,1,10,8,4,0,23,0,0,0,0,0,0,79
7889,HIMACHAL PRADESH,2006,14,"PHYSICAL ABUSE (RAPE,INCEST ETC.)",0,0,0,0,0,0,0,0,0,0,0,0,0,0,0,0,0,0,0
8395,HIMACHAL PRADESH,2006,14,SOCIETAL ISSUES,0,1,2,0,0,3,0,0,0,0,0,0,0,0,0,0,0,0,3
248,HIMACHAL PRADESH,2007,14,CAUSES NOT KNOWN,2,25,19,9,4,59,0,13,6,1,2,22,0,0,0,0,0,0,81
794,HIMACHAL PRADESH,2007,14,DEATH OF DEAR PERSON,0,0,0,0,0,0,0,0,0,0,0,0,0,0,0,0,0,0,0
1340,HIMACHAL PRADESH,2007,14,DOWRY DISPUTE,0,0,0,0,0,0,0,3,0,0,0,3,0,0,0,0,0,0,3
1886,HIMACHAL PRADESH,2007,14,DRUG ABUSE,0,0,0,0,0,0,0,0,0,0,0,0,0,0,0,0,0,0,0
2432,HIMACHAL PRADESH,2007,14,ECONOMIC ISSUES,0,3,6,4,2,15,0,0,1,0,1,2,0,0,0,0,0,0,17
2978,HIMACHAL PRADESH,2007,14,EXAM FAILURE,0,4,1,0,0,5,0,10,1,0,0,11,0,0,0,0,0,0,16
3524,HIMACHAL PRADESH,2007,14,FAMILY PROBLEMS,0,18,36,7,11,72,0,18,17,5,2,42,0,0,0,0,0,0,114
4070,HIMACHAL PRADESH,2007,14,HEALTH ISSUES,0,1,10,7,7,25,0,1,3,3,6,13,0,0,0,0,0,0,38
4615,HIMACHAL PRADESH,2007,14,HERO WORSHIP,0,0,0,0,0,0,0,0,0,0,0,0,0,0,0,0,0,0,0
5160,HIMACHAL PRADESH,2007,14,ILLEGITIMATE PREGNANCY,0,0,0,0,0,0,0,0,0,0,0,0,0,0,0,0,0,0,0
5705,HIMACHAL PRADESH,2007,14,LOVE AFFAIRS,0,7,1,0,0,8,0,4,1,0,0,5,0,0,0,0,0,0,13
6251,HIMACHAL PRADESH,2007,14,MARITAL ISSUES,0,6,4,0,0,10,0,5,3,0,0,8,0,0,0,0,0,0,18
6797,HIMACHAL PRADESH,2007,14,MENTAL HEALTH,0,9,14,6,2,31,0,3,7,0,1,11,0,0,0,0,0,0,42
7343,HIMACHAL PRADESH,2007,14,OTHERS,0,19,7,4,2,32,0,15,7,2,2,26,0,0,0,0,0,0,58
7927,HIMACHAL PRADESH,2007,14,"PHYSICAL ABUSE (RAPE,INCEST ETC.)",0,0,0,1,0,1,0,0,0,0,1,1,0,0,0,0,0,0,2
8434,HIMACHAL PRADESH,2007,14,SOCIETAL ISSUES,0,0,0,0,0,0,0,0,0,0,0,0,0,0,0,0,0,0,0
287,HIMACHAL PRADESH,2008,14,CAUSES NOT KNOWN,3,34,29,17,2,85,3,17,8,5,1,34,0,0,0,0,0,0,119
833,HIMACHAL PRADESH,2008,14,DEATH OF DEAR PERSON,0,0,0,0,0,0,0,0,0,0,0,0,0,0,0,0,0,0,0
1379,HIMACHAL PRADESH,2008,14,DOWRY DISPUTE,0,0,0,0,0,0,0,2,0,0,0,2,0,0,0,0,0,0,2
1925,HIMACHAL PRADESH,2008,14,DRUG ABUSE,0,1,1,3,4,9,0,0,0,0,0,0,0,0,0,0,0,0,9
2471,HIMACHAL PRADESH,2008,14,ECONOMIC ISSUES,1,7,4,2,1,15,1,4,0,0,0,5,0,0,0,0,0,0,20
3017,HIMACHAL PRADESH,2008,14,EXAM FAILURE,1,5,0,0,0,6,3,3,0,0,0,6,0,0,0,0,0,0,12
3563,HIMACHAL PRADESH,2008,14,FAMILY PROBLEMS,0,19,22,18,8,67,1,26,16,3,4,50,0,0,0,0,0,0,117
4109,HIMACHAL PRADESH,2008,14,HEALTH ISSUES,0,4,7,12,4,27,0,2,2,5,3,12,0,0,0,0,0,0,39
4654,HIMACHAL PRADESH,2008,14,HERO WORSHIP,0,0,0,0,0,0,0,0,0,0,0,0,0,0,0,0,0,0,0
5199,HIMACHAL PRADESH,2008,14,ILLEGITIMATE PREGNANCY,0,0,0,0,0,0,0,1,0,0,0,1,0,0,0,0,0,0,1
5744,HIMACHAL PRADESH,2008,14,LOVE AFFAIRS,0,7,0,1,0,8,0,6,1,0,0,7,0,0,0,0,0,0,15
6290,HIMACHAL PRADESH,2008,14,MARITAL ISSUES,0,4,3,0,1,8,0,3,4,1,0,8,0,0,0,0,0,0,16
6836,HIMACHAL PRADESH,2008,14,MENTAL HEALTH,0,19,9,8,4,40,1,6,4,2,4,17,0,0,0,0,0,0,57
7382,HIMACHAL PRADESH,2008,14,OTHERS,1,31,36,52,15,135,1,27,20,8,6,62,0,0,0,0,0,0,197
7966,HIMACHAL PRADESH,2008,14,"PHYSICAL ABUSE (RAPE,INCEST ETC.)",0,0,0,0,0,0,0,0,0,0,0,0,0,0,0,0,0,0,0
8473,HIMACHAL PRADESH,2008,14,SOCIETAL ISSUES,0,9,4,3,1,17,0,6,2,1,0,9,0,0,0,0,0,0,26
326,HIMACHAL PRADESH,2009,14,CAUSES NOT KNOWN,2,18,20,6,4,50,1,11,3,2,5,22,0,0,0,0,0,0,72
872,HIMACHAL PRADESH,2009,14,DEATH OF DEAR PERSON,0,0,0,0,0,0,1,0,0,0,0,1,0,0,0,0,0,0,1
1418,HIMACHAL PRADESH,2009,14,DOWRY DISPUTE,0,0,0,0,0,0,0,0,0,0,0,0,0,0,0,0,0,0,0
1964,HIMACHAL PRADESH,2009,14,DRUG ABUSE,0,0,1,0,0,1,0,0,0,0,0,0,0,0,0,0,0,0,1
2510,HIMACHAL PRADESH,2009,14,ECONOMIC ISSUES,0,2,3,1,2,8,0,0,1,2,1,4,0,0,0,0,0,0,12
3056,HIMACHAL PRADESH,2009,14,EXAM FAILURE,1,2,0,0,0,3,1,2,0,0,0,3,0,0,0,0,0,0,6
3602,HIMACHAL PRADESH,2009,14,FAMILY PROBLEMS,0,12,26,12,1,51,1,18,19,8,3,49,0,0,0,0,0,0,100
4148,HIMACHAL PRADESH,2009,14,HEALTH ISSUES,0,4,9,18,7,38,0,2,2,4,3,11,0,0,0,0,0,0,49
4693,HIMACHAL PRADESH,2009,14,HERO WORSHIP,0,0,0,0,0,0,0,0,0,0,0,0,0,0,0,0,0,0,0
5238,HIMACHAL PRADESH,2009,14,ILLEGITIMATE PREGNANCY,0,0,0,0,0,0,0,0,0,0,0,0,0,0,0,0,0,0,0
5783,HIMACHAL PRADESH,2009,14,LOVE AFFAIRS,0,13,2,0,0,15,0,10,2,0,0,12,0,0,0,0,0,0,27
6329,HIMACHAL PRADESH,2009,14,MARITAL ISSUES,0,4,1,0,0,5,0,7,1,0,0,8,0,0,0,0,0,0,13
6875,HIMACHAL PRADESH,2009,14,MENTAL HEALTH,0,5,6,2,0,13,0,3,3,0,2,8,0,0,0,0,0,0,21
7421,HIMACHAL PRADESH,2009,14,OTHERS,2,66,60,33,21,182,7,31,23,10,4,75,0,0,0,0,0,0,257
8005,HIMACHAL PRADESH,2009,14,"PHYSICAL ABUSE (RAPE,INCEST ETC.)",0,0,0,0,0,0,0,0,1,0,0,1,0,0,0,0,0,0,1
8512,HIMACHAL PRADESH,2009,14,SOCIETAL ISSUES,0,0,0,0,0,0,0,0,0,0,0,0,0,0,0,0,0,0,0
365,HIMACHAL PRADESH,2010,14,CAUSES NOT KNOWN,2,18,12,9,2,43,2,14,7,8,2,33,0,0,0,0,0,0,76
911,HIMACHAL PRADESH,2010,14,DEATH OF DEAR PERSON,0,0,0,0,0,0,0,1,0,0,0,1,0,0,0,0,0,0,1
1457,HIMACHAL PRADESH,2010,14,DOWRY DISPUTE,0,0,0,0,0,0,0,1,0,0,0,1,0,0,0,0,0,0,1
2003,HIMACHAL PRADESH,2010,14,DRUG ABUSE,0,2,2,1,0,5,0,0,0,0,0,0,0,0,0,0,0,0,5
2549,HIMACHAL PRADESH,2010,14,ECONOMIC ISSUES,0,2,0,2,1,5,0,0,1,1,0,2,0,0,0,0,0,0,7
3095,HIMACHAL PRADESH,2010,14,EXAM FAILURE,0,2,0,0,0,2,0,6,0,0,0,6,0,0,0,0,0,0,8
3641,HIMACHAL PRADESH,2010,14,FAMILY PROBLEMS,0,13,19,10,1,43,0,14,15,8,0,37,0,0,0,0,0,0,80
4187,HIMACHAL PRADESH,2010,14,HEALTH ISSUES,0,2,7,6,6,21,0,3,2,2,3,10,0,0,0,0,0,0,31
4732,HIMACHAL PRADESH,2010,14,HERO WORSHIP,0,0,0,0,0,0,0,0,0,0,0,0,0,0,0,0,0,0,0
5277,HIMACHAL PRADESH,2010,14,ILLEGITIMATE PREGNANCY,0,0,0,0,0,0,0,0,0,0,0,0,0,0,0,0,0,0,0
5822,HIMACHAL PRADESH,2010,14,LOVE AFFAIRS,0,8,2,0,0,10,0,9,1,0,0,10,0,0,0,0,0,0,20
6368,HIMACHAL PRADESH,2010,14,MARITAL ISSUES,0,2,4,0,0,6,1,2,3,0,0,6,0,0,0,0,0,0,12
6914,HIMACHAL PRADESH,2010,14,MENTAL HEALTH,0,6,7,8,2,23,0,5,4,3,1,13,0,0,0,0,0,0,36
7460,HIMACHAL PRADESH,2010,14,OTHERS,6,61,71,37,13,188,1,41,17,9,5,73,0,0,0,0,0,0,261
8044,HIMACHAL PRADESH,2010,14,"PHYSICAL ABUSE (RAPE,INCEST ETC.)",0,1,0,0,0,1,0,0,1,0,0,1,0,0,0,0,0,0,2
8551,HIMACHAL PRADESH,2010,14,SOCIETAL ISSUES,0,0,1,0,0,1,0,1,0,0,0,1,0,0,0,0,0,0,2
404,HIMACHAL PRADESH,2011,14,CAUSES NOT KNOWN,1,23,16,8,6,54,1,18,15,10,1,45,0,0,0,0,0,0,99
950,HIMACHAL PRADESH,2011,14,DEATH OF DEAR PERSON,0,0,0,0,0,0,0,0,0,0,0,0,0,0,0,0,0,0,0
1496,HIMACHAL PRADESH,2011,14,DOWRY DISPUTE,0,0,0,0,0,0,0,0,0,0,0,0,0,0,0,0,0,0,0
2042,HIMACHAL PRADESH,2011,14,DRUG ABUSE,0,1,2,2,0,5,0,0,0,0,0,0,0,0,0,0,0,0,5
2588,HIMACHAL PRADESH,2011,14,ECONOMIC ISSUES,0,2,1,4,2,9,0,0,1,1,0,2,0,0,0,0,0,0,11
3134,HIMACHAL PRADESH,2011,14,EXAM FAILURE,0,4,0,0,0,4,0,9,0,0,0,9,0,0,0,0,0,0,13
3680,HIMACHAL PRADESH,2011,14,FAMILY PROBLEMS,0,15,13,9,2,39,0,9,19,10,2,40,0,0,0,0,0,0,79
4226,HIMACHAL PRADESH,2011,14,HEALTH ISSUES,0,2,9,7,11,29,0,0,5,3,5,13,0,0,0,0,0,0,42
4771,HIMACHAL PRADESH,2011,14,HERO WORSHIP,0,0,0,0,0,0,0,0,0,0,0,0,0,0,0,0,0,0,0
5316,HIMACHAL PRADESH,2011,14,ILLEGITIMATE PREGNANCY,0,0,0,0,0,0,0,0,0,0,0,0,0,0,0,0,0,0,0
5861,HIMACHAL PRADESH,2011,14,LOVE AFFAIRS,0,7,2,0,0,9,0,8,1,0,0,9,0,0,0,0,0,0,18
6407,HIMACHAL PRADESH,2011,14,MARITAL ISSUES,0,1,5,0,0,6,0,3,6,0,0,9,0,0,0,0,0,0,15
6953,HIMACHAL PRADESH,2011,14,MENTAL HEALTH,0,4,7,5,2,18,0,5,4,1,2,12,0,0,0,0,0,0,30
7499,HIMACHAL PRADESH,2011,14,OTHERS,4,39,33,10,9,95,4,14,11,5,1,35,0,0,0,0,0,0,130
8083,HIMACHAL PRADESH,2011,14,"PHYSICAL ABUSE (RAPE,INCEST ETC.)",0,0,0,0,0,0,0,0,0,0,0,0,0,0,0,0,0,0,0
8590,HIMACHAL PRADESH,2011,14,SOCIETAL ISSUES,0,0,0,1,0,1,0,0,0,0,0,0,0,0,0,0,0,0,1
443,HIMACHAL PRADESH,2012,14,CAUSES NOT KNOWN,5,17,20,13,9,64,4,8,5,3,4,24,0,0,0,0,0,0,88
989,HIMACHAL PRADESH,2012,14,DEATH OF DEAR PERSON,0,0,0,0,0,0,0,0,0,0,0,0,0,0,0,0,0,0,0
1535,HIMACHAL PRADESH,2012,14,DOWRY DISPUTE,0,0,0,0,0,0,0,1,0,0,0,1,0,0,0,0,0,0,1
2081,HIMACHAL PRADESH,2012,14,DRUG ABUSE,0,2,2,3,1,8,0,0,0,0,0,0,0,0,0,0,0,0,8
2627,HIMACHAL PRADESH,2012,14,ECONOMIC ISSUES,0,4,5,5,2,16,0,0,2,2,0,4,0,0,0,0,0,0,20
3173,HIMACHAL PRADESH,2012,14,EXAM FAILURE,1,5,0,0,0,6,0,9,0,0,0,9,0,0,0,0,0,0,15
3719,HIMACHAL PRADESH,2012,14,FAMILY PROBLEMS,0,12,22,10,1,45,2,23,13,6,1,45,0,0,0,0,0,0,90
4265,HIMACHAL PRADESH,2012,14,HEALTH ISSUES,0,2,8,6,12,28,0,1,6,2,6,15,0,0,0,0,0,0,43
4810,HIMACHAL PRADESH,2012,14,HERO WORSHIP,0,0,0,0,0,0,0,0,0,0,0,0,0,0,0,0,0,0,0
5355,HIMACHAL PRADESH,2012,14,ILLEGITIMATE PREGNANCY,0,0,0,0,0,0,0,0,0,0,0,0,0,0,0,0,0,0,0
5900,HIMACHAL PRADESH,2012,14,LOVE AFFAIRS,0,7,3,1,0,11,0,8,1,1,0,10,0,0,0,0,0,0,21
6446,HIMACHAL PRADESH,2012,14,MARITAL ISSUES,0,5,6,3,0,14,0,7,6,3,0,16,0,0,0,0,0,0,30
6992,HIMACHAL PRADESH,2012,14,MENTAL HEALTH,0,7,3,7,5,22,0,2,2,1,3,8,0,0,0,0,0,0,30
7538,HIMACHAL PRADESH,2012,14,OTHERS,4,51,50,24,11,140,0,15,17,8,1,41,0,0,0,0,0,0,181
8122,HIMACHAL PRADESH,2012,14,"PHYSICAL ABUSE (RAPE,INCEST ETC.)",0,0,0,0,0,0,0,0,0,0,0,0,0,0,0,0,0,0,0
8629,HIMACHAL PRADESH,2012,14,SOCIETAL ISSUES,0,0,0,0,0,0,0,1,0,0,0,1,0,0,0,0,0,0,1
482,HIMACHAL PRADESH,2013,14,CAUSES NOT KNOWN,1,28,20,9,3,61,3,6,4,1,0,14,0,0,0,0,0,0,75
1028,HIMACHAL PRADESH,2013,14,DEATH OF DEAR PERSON,0,1,0,0,0,1,0,1,0,0,0,1,0,0,0,0,0,0,2
1574,HIMACHAL PRADESH,2013,14,DOWRY DISPUTE,0,0,0,0,0,0,0,1,1,0,0,2,0,0,0,0,0,0,2
2120,HIMACHAL PRADESH,2013,14,DRUG ABUSE,0,2,3,2,1,8,0,0,0,0,0,0,0,0,0,0,0,0,8
2666,HIMACHAL PRADESH,2013,14,ECONOMIC ISSUES,0,11,3,2,1,17,0,1,0,1,0,2,0,0,0,0,0,0,19
3212,HIMACHAL PRADESH,2013,14,EXAM FAILURE,0,1,0,0,0,1,0,0,0,0,0,0,0,0,0,0,0,0,1
3758,HIMACHAL PRADESH,2013,14,FAMILY PROBLEMS,1,19,19,13,3,55,3,26,10,5,1,45,0,0,0,0,0,0,100
4304,HIMACHAL PRADESH,2013,14,HEALTH ISSUES,0,5,6,5,5,21,0,2,2,3,3,10,0,0,0,0,0,0,31
4849,HIMACHAL PRADESH,2013,14,HERO WORSHIP,0,0,0,0,0,0,0,0,0,0,0,0,0,0,0,0,0,0,0
5394,HIMACHAL PRADESH,2013,14,ILLEGITIMATE PREGNANCY,0,0,0,0,0,0,0,0,0,0,0,0,0,0,0,0,0,0,0
5939,HIMACHAL PRADESH,2013,14,LOVE AFFAIRS,1,9,2,1,0,13,0,15,1,0,0,16,0,0,0,0,0,0,29
6485,HIMACHAL PRADESH,2013,14,MARITAL ISSUES,0,6,9,3,0,18,0,14,7,3,0,24,0,0,0,0,0,0,42
7031,HIMACHAL PRADESH,2013,14,MENTAL HEALTH,1,14,9,4,1,29,0,7,5,2,0,14,0,0,0,0,0,0,43
7577,HIMACHAL PRADESH,2013,14,OTHERS,1,45,51,31,9,137,0,17,23,16,6,62,0,0,0,0,0,0,199
8161,HIMACHAL PRADESH,2013,14,"PHYSICAL ABUSE (RAPE,INCEST ETC.)",0,0,0,0,0,0,0,0,0,0,0,0,0,0,0,0,0,0,0
8668,HIMACHAL PRADESH,2013,14,SOCIETAL ISSUES,0,1,0,1,1,3,0,0,0,0,0,0,0,0,0,0,0,0,3
521,HIMACHAL PRADESH,2014,14,CAUSES NOT KNOWN,3,31,44,16,5,99,2,27,13,5,2,49,0,0,0,0,0,0,148
1067,HIMACHAL PRADESH,2014,14,DEATH OF DEAR PERSON,0,0,0,1,0,1,0,1,0,1,2,4,0,0,0,0,0,0,5
1613,HIMACHAL PRADESH,2014,14,DOWRY DISPUTE,0,0,0,0,0,0,0,3,1,1,0,5,0,0,0,0,0,0,5
2159,HIMACHAL PRADESH,2014,14,DRUG ABUSE,0,5,5,0,0,10,0,0,0,0,0,0,0,0,0,0,0,0,10
2705,HIMACHAL PRADESH,2014,14,ECONOMIC ISSUES,0,6,7,6,2,21,0,6,7,2,0,15,0,0,0,0,0,0,36
3251,HIMACHAL PRADESH,2014,14,EXAM FAILURE,0,3,0,0,0,3,1,2,0,0,0,3,0,0,0,0,0,0,6
3797,HIMACHAL PRADESH,2014,14,FAMILY PROBLEMS,0,23,29,14,3,69,0,14,18,10,1,43,0,0,0,0,0,0,112
4343,HIMACHAL PRADESH,2014,14,HEALTH ISSUES,1,46,36,11,7,101,0,24,19,16,6,65,0,0,0,0,0,0,166
4888,HIMACHAL PRADESH,2014,14,HERO WORSHIP,0,0,1,0,0,1,0,0,0,0,0,0,0,0,0,0,0,0,1
5433,HIMACHAL PRADESH,2014,14,ILLEGITIMATE PREGNANCY,0,0,0,0,0,0,0,0,0,0,0,0,0,0,0,0,0,0,0
5978,HIMACHAL PRADESH,2014,14,LOVE AFFAIRS,0,14,1,0,0,15,0,14,1,0,0,15,0,0,0,0,0,0,30
6524,HIMACHAL PRADESH,2014,14,MARITAL ISSUES,0,36,20,9,4,69,0,28,22,4,1,55,0,0,0,0,0,0,124
7070,HIMACHAL PRADESH,2014,14,MENTAL HEALTH,1,18,16,5,1,41,0,8,7,4,2,21,0,0,0,0,0,0,62
7616,HIMACHAL PRADESH,2014,14,OTHERS,2,24,28,16,8,78,1,24,22,8,4,59,0,0,0,0,0,0,137
7655,HIMACHAL PRADESH,2014,14,PHYSICAL ABUSE,0,0,0,0,0,0,0,0,0,0,0,0,0,0,0,0,0,0,0
8707,HIMACHAL PRADESH,2014,14,SOCIETAL ISSUES,0,0,2,0,0,2,0,0,0,0,0,0,0,0,0,0,0,0,2
15,JAMMU & KASHMIR,2001,15,CAUSES NOT KNOWN,2,15,15,7,1,40,1,13,8,1,0,23,0,0,0,0,0,0,63
561,JAMMU & KASHMIR,2001,15,DEATH OF DEAR PERSON,0,0,0,0,0,0,0,0,0,0,0,0,0,0,0,0,0,0,0
1107,JAMMU & KASHMIR,2001,15,DOWRY DISPUTE,0,0,0,0,0,0,0,5,4,0,0,9,0,0,0,0,0,0,9
1653,JAMMU & KASHMIR,2001,15,DRUG ABUSE,0,1,0,0,0,1,0,0,0,0,0,0,0,0,0,0,0,0,1
2199,JAMMU & KASHMIR,2001,15,ECONOMIC ISSUES,0,1,2,2,0,5,0,0,0,0,0,0,0,0,0,0,0,0,5
2745,JAMMU & KASHMIR,2001,15,EXAM FAILURE,0,3,0,0,0,3,0,0,0,0,0,0,0,0,0,0,0,0,3
3291,JAMMU & KASHMIR,2001,15,FAMILY PROBLEMS,0,3,10,5,10,28,0,6,6,3,1,16,0,0,0,0,0,0,44
3837,JAMMU & KASHMIR,2001,15,HEALTH ISSUES,0,0,0,3,0,3,0,0,0,0,2,2,0,0,0,0,0,0,5
4383,JAMMU & KASHMIR,2001,15,HERO WORSHIP,0,0,0,0,0,0,0,0,0,0,0,0,0,0,0,0,0,0,0
4928,JAMMU & KASHMIR,2001,15,ILLEGITIMATE PREGNANCY,0,0,0,0,0,0,0,0,0,0,0,0,0,0,0,0,0,0,0
5473,JAMMU & KASHMIR,2001,15,LOVE AFFAIRS,0,1,1,0,0,2,0,2,0,0,0,2,0,0,0,0,0,0,4
6018,JAMMU & KASHMIR,2001,15,MARITAL ISSUES,0,3,1,0,0,4,0,1,2,0,0,3,0,0,0,0,0,0,7
6564,JAMMU & KASHMIR,2001,15,MENTAL HEALTH,0,0,0,0,0,0,1,0,0,0,0,1,0,0,0,0,0,0,1
7110,JAMMU & KASHMIR,2001,15,OTHERS,0,0,2,1,0,3,0,4,1,1,0,6,0,0,0,0,0,0,9
7695,JAMMU & KASHMIR,2001,15,"PHYSICAL ABUSE (RAPE,INCEST ETC.)",0,0,0,0,0,0,0,0,0,0,0,0,0,0,0,0,0,0,0
8201,JAMMU & KASHMIR,2001,15,SOCIETAL ISSUES,0,2,0,0,0,2,0,0,0,0,0,0,0,0,0,0,0,0,2
54,JAMMU & KASHMIR,2002,15,CAUSES NOT KNOWN,1,25,18,12,2,58,0,21,2,0,0,23,0,0,0,0,0,0,81
600,JAMMU & KASHMIR,2002,15,DEATH OF DEAR PERSON,0,0,0,0,0,0,0,0,0,0,0,0,0,0,0,0,0,0,0
1146,JAMMU & KASHMIR,2002,15,DOWRY DISPUTE,0,0,0,0,0,0,0,9,7,0,0,16,0,0,0,0,0,0,16
1692,JAMMU & KASHMIR,2002,15,DRUG ABUSE,0,0,4,0,0,4,0,8,0,0,0,8,0,0,0,0,0,0,12
2238,JAMMU & KASHMIR,2002,15,ECONOMIC ISSUES,3,4,0,0,0,7,0,2,0,0,0,2,0,0,0,0,0,0,9
2784,JAMMU & KASHMIR,2002,15,EXAM FAILURE,0,0,0,0,0,0,0,0,0,0,0,0,0,0,0,0,0,0,0
3330,JAMMU & KASHMIR,2002,15,FAMILY PROBLEMS,0,6,4,1,0,11,0,5,6,5,0,16,0,0,0,0,0,0,27
3876,JAMMU & KASHMIR,2002,15,HEALTH ISSUES,0,0,0,1,0,1,0,0,0,0,0,0,0,0,0,0,0,0,1
4422,JAMMU & KASHMIR,2002,15,HERO WORSHIP,0,0,0,0,0,0,0,0,0,0,0,0,0,0,0,0,0,0,0
4967,JAMMU & KASHMIR,2002,15,ILLEGITIMATE PREGNANCY,0,0,0,0,0,0,0,1,0,0,0,1,0,0,0,0,0,0,1
5512,JAMMU & KASHMIR,2002,15,LOVE AFFAIRS,0,0,0,0,0,0,0,0,0,0,0,0,0,0,0,0,0,0,0
6057,JAMMU & KASHMIR,2002,15,MARITAL ISSUES,0,0,1,0,0,1,0,3,0,0,0,3,0,0,0,0,0,0,4
6603,JAMMU & KASHMIR,2002,15,MENTAL HEALTH,0,0,0,0,0,0,0,0,0,0,0,0,0,0,0,0,0,0,0
7149,JAMMU & KASHMIR,2002,15,OTHERS,0,3,9,0,2,14,0,11,6,1,0,18,0,0,0,0,0,0,32
7734,JAMMU & KASHMIR,2002,15,"PHYSICAL ABUSE (RAPE,INCEST ETC.)",0,0,0,0,0,0,0,0,0,0,0,0,0,0,0,0,0,0,0
8240,JAMMU & KASHMIR,2002,15,SOCIETAL ISSUES,0,0,0,0,0,0,0,1,0,0,0,1,0,0,0,0,0,0,1
93,JAMMU & KASHMIR,2003,15,CAUSES NOT KNOWN,0,5,4,2,0,11,1,2,4,0,1,8,0,0,0,0,0,0,19
639,JAMMU & KASHMIR,2003,15,DEATH OF DEAR PERSON,0,0,0,0,0,0,0,0,0,0,0,0,0,0,0,0,0,0,0
1185,JAMMU & KASHMIR,2003,15,DOWRY DISPUTE,0,0,0,0,0,0,0,12,4,0,0,16,0,0,0,0,0,0,16
1731,JAMMU & KASHMIR,2003,15,DRUG ABUSE,0,3,0,1,0,4,0,2,0,0,0,2,0,0,0,0,0,0,6
2277,JAMMU & KASHMIR,2003,15,ECONOMIC ISSUES,0,1,0,0,0,1,0,1,0,0,0,1,0,0,0,0,0,0,2
2823,JAMMU & KASHMIR,2003,15,EXAM FAILURE,0,0,0,0,0,0,0,0,0,0,0,0,0,0,0,0,0,0,0
3369,JAMMU & KASHMIR,2003,15,FAMILY PROBLEMS,0,7,3,1,1,12,0,8,1,0,0,9,0,0,0,0,0,0,21
3915,JAMMU & KASHMIR,2003,15,HEALTH ISSUES,1,5,4,3,2,15,2,0,2,2,2,8,0,0,0,0,0,0,23
4461,JAMMU & KASHMIR,2003,15,HERO WORSHIP,0,0,0,0,0,0,0,0,0,0,0,0,0,0,0,0,0,0,0
5006,JAMMU & KASHMIR,2003,15,ILLEGITIMATE PREGNANCY,0,0,2,0,1,3,0,0,0,0,0,0,0,0,0,0,0,0,3
5551,JAMMU & KASHMIR,2003,15,LOVE AFFAIRS,0,4,0,1,0,5,0,1,0,0,0,1,0,0,0,0,0,0,6
6096,JAMMU & KASHMIR,2003,15,MARITAL ISSUES,0,2,3,1,0,6,1,0,0,1,0,2,0,0,0,0,0,0,8
6642,JAMMU & KASHMIR,2003,15,MENTAL HEALTH,0,0,0,0,0,0,0,0,0,0,0,0,0,0,0,0,0,0,0
7188,JAMMU & KASHMIR,2003,15,OTHERS,0,3,3,0,0,6,1,17,9,0,0,27,0,0,0,0,0,0,33
7773,JAMMU & KASHMIR,2003,15,"PHYSICAL ABUSE (RAPE,INCEST ETC.)",0,0,0,0,0,0,0,0,0,0,0,0,0,0,0,0,0,0,0
8279,JAMMU & KASHMIR,2003,15,SOCIETAL ISSUES,0,0,0,0,0,0,0,0,1,0,0,1,0,0,0,0,0,0,1
132,JAMMU & KASHMIR,2004,15,CAUSES NOT KNOWN,0,4,1,1,0,6,0,3,9,1,0,13,0,0,0,0,0,0,19
678,JAMMU & KASHMIR,2004,15,DEATH OF DEAR PERSON,0,0,0,0,0,0,0,0,0,0,0,0,0,0,0,0,0,0,0
1224,JAMMU & KASHMIR,2004,15,DOWRY DISPUTE,0,0,0,0,0,0,0,5,2,0,0,7,0,0,0,0,0,0,7
1770,JAMMU & KASHMIR,2004,15,DRUG ABUSE,0,3,2,0,0,5,0,1,0,0,0,1,0,0,0,0,0,0,6
2316,JAMMU & KASHMIR,2004,15,ECONOMIC ISSUES,0,2,0,0,0,2,0,0,1,0,0,1,0,0,0,0,0,0,3
2862,JAMMU & KASHMIR,2004,15,EXAM FAILURE,0,0,0,0,0,0,0,2,0,0,0,2,0,0,0,0,0,0,2
3408,JAMMU & KASHMIR,2004,15,FAMILY PROBLEMS,0,3,1,0,0,4,0,6,4,0,0,10,0,0,0,0,0,0,14
3954,JAMMU & KASHMIR,2004,15,HEALTH ISSUES,0,0,0,0,0,0,0,0,0,0,0,0,0,0,0,0,0,0,0
4500,JAMMU & KASHMIR,2004,15,HERO WORSHIP,0,0,0,0,0,0,0,0,0,0,0,0,0,0,0,0,0,0,0
5045,JAMMU & KASHMIR,2004,15,ILLEGITIMATE PREGNANCY,0,0,0,0,0,0,0,0,0,0,0,0,0,0,0,0,0,0,0
5590,JAMMU & KASHMIR,2004,15,LOVE AFFAIRS,0,0,0,0,0,0,0,0,2,0,0,2,0,0,0,0,0,0,2
6135,JAMMU & KASHMIR,2004,15,MARITAL ISSUES,0,0,0,0,0,0,0,0,0,0,0,0,0,0,0,0,0,0,0
6681,JAMMU & KASHMIR,2004,15,MENTAL HEALTH,0,0,0,1,0,1,0,0,0,0,0,0,0,0,0,0,0,0,1
7227,JAMMU & KASHMIR,2004,15,OTHERS,0,15,12,6,0,33,0,12,11,2,0,25,0,0,0,0,0,0,58
7812,JAMMU & KASHMIR,2004,15,"PHYSICAL ABUSE (RAPE,INCEST ETC.)",0,0,0,0,0,0,0,0,0,0,0,0,0,0,0,0,0,0,0
8318,JAMMU & KASHMIR,2004,15,SOCIETAL ISSUES,0,0,0,0,0,0,0,0,0,0,0,0,0,0,0,0,0,0,0
171,JAMMU & KASHMIR,2005,15,CAUSES NOT KNOWN,0,32,14,3,0,49,0,2,3,0,0,5,0,0,0,0,0,0,54
717,JAMMU & KASHMIR,2005,15,DEATH OF DEAR PERSON,0,0,0,0,0,0,0,0,0,0,0,0,0,0,0,0,0,0,0
1263,JAMMU & KASHMIR,2005,15,DOWRY DISPUTE,0,0,0,0,0,0,0,4,2,0,0,6,0,0,0,0,0,0,6
1809,JAMMU & KASHMIR,2005,15,DRUG ABUSE,1,3,5,0,0,9,1,2,2,1,0,6,0,0,0,0,0,0,15
2355,JAMMU & KASHMIR,2005,15,ECONOMIC ISSUES,0,2,3,1,0,6,0,2,0,0,0,2,0,0,0,0,0,0,8
2901,JAMMU & KASHMIR,2005,15,EXAM FAILURE,0,12,0,0,0,12,0,3,0,0,0,3,0,0,0,0,0,0,15
3447,JAMMU & KASHMIR,2005,15,FAMILY PROBLEMS,0,3,4,2,0,9,0,6,3,0,0,9,0,0,0,0,0,0,18
3993,JAMMU & KASHMIR,2005,15,HEALTH ISSUES,0,6,1,0,0,7,0,2,0,0,0,2,0,0,0,0,0,0,9
4539,JAMMU & KASHMIR,2005,15,HERO WORSHIP,0,0,0,0,0,0,0,0,0,0,0,0,0,0,0,0,0,0,0
5084,JAMMU & KASHMIR,2005,15,ILLEGITIMATE PREGNANCY,0,0,0,0,0,0,0,2,0,0,0,2,0,0,0,0,0,0,2
5629,JAMMU & KASHMIR,2005,15,LOVE AFFAIRS,0,15,0,0,0,15,0,0,0,0,0,0,0,0,0,0,0,0,15
6174,JAMMU & KASHMIR,2005,15,MARITAL ISSUES,0,13,2,0,0,15,0,11,0,0,0,11,0,0,0,0,0,0,26
6720,JAMMU & KASHMIR,2005,15,MENTAL HEALTH,0,0,0,0,0,0,0,0,0,0,0,0,0,0,0,0,0,0,0
7266,JAMMU & KASHMIR,2005,15,OTHERS,2,25,27,11,4,69,3,18,16,0,3,40,0,0,0,0,0,0,109
7851,JAMMU & KASHMIR,2005,15,"PHYSICAL ABUSE (RAPE,INCEST ETC.)",0,0,0,0,0,0,0,0,0,0,0,0,0,0,0,0,0,0,0
8357,JAMMU & KASHMIR,2005,15,SOCIETAL ISSUES,0,2,3,0,0,5,0,2,10,0,0,12,0,0,0,0,0,0,17
210,JAMMU & KASHMIR,2006,15,CAUSES NOT KNOWN,1,8,13,8,1,31,0,11,7,4,0,22,0,0,0,0,0,0,53
756,JAMMU & KASHMIR,2006,15,DEATH OF DEAR PERSON,0,0,0,0,0,0,0,0,0,0,0,0,0,0,0,0,0,0,0
1302,JAMMU & KASHMIR,2006,15,DOWRY DISPUTE,0,1,1,0,0,2,0,6,1,0,0,7,0,0,0,0,0,0,9
1848,JAMMU & KASHMIR,2006,15,DRUG ABUSE,0,3,1,1,0,5,0,0,0,0,0,0,0,0,0,0,0,0,5
2394,JAMMU & KASHMIR,2006,15,ECONOMIC ISSUES,0,4,1,1,0,6,0,1,2,2,0,5,0,0,0,0,0,0,11
2940,JAMMU & KASHMIR,2006,15,EXAM FAILURE,0,1,0,0,0,1,0,5,0,0,0,5,0,0,0,0,0,0,6
3486,JAMMU & KASHMIR,2006,15,FAMILY PROBLEMS,0,6,9,3,1,19,0,7,9,0,0,16,0,0,0,0,0,0,35
4032,JAMMU & KASHMIR,2006,15,HEALTH ISSUES,0,6,8,6,1,21,0,4,3,1,0,8,0,0,0,0,0,0,29
4578,JAMMU & KASHMIR,2006,15,HERO WORSHIP,0,0,0,0,0,0,0,0,0,0,0,0,0,0,0,0,0,0,0
5123,JAMMU & KASHMIR,2006,15,ILLEGITIMATE PREGNANCY,0,0,0,0,0,0,0,1,0,0,0,1,0,0,0,0,0,0,1
5668,JAMMU & KASHMIR,2006,15,LOVE AFFAIRS,0,3,0,0,0,3,0,3,0,0,0,3,0,0,0,0,0,0,6
6213,JAMMU & KASHMIR,2006,15,MARITAL ISSUES,0,9,3,0,0,12,0,4,2,0,0,6,0,0,0,0,0,0,18
6759,JAMMU & KASHMIR,2006,15,MENTAL HEALTH,0,1,1,0,0,2,0,0,0,0,0,0,0,0,0,0,0,0,2
7305,JAMMU & KASHMIR,2006,15,OTHERS,0,22,18,6,3,49,0,26,9,2,0,37,0,0,0,0,0,0,86
7890,JAMMU & KASHMIR,2006,15,"PHYSICAL ABUSE (RAPE,INCEST ETC.)",0,0,0,0,0,0,0,0,0,0,0,0,0,0,0,0,0,0,0
8396,JAMMU & KASHMIR,2006,15,SOCIETAL ISSUES,0,0,1,0,0,1,0,0,0,0,0,0,0,0,0,0,0,0,1
249,JAMMU & KASHMIR,2007,15,CAUSES NOT KNOWN,0,12,16,8,5,41,0,12,5,1,1,19,0,0,0,0,0,0,60
795,JAMMU & KASHMIR,2007,15,DEATH OF DEAR PERSON,0,0,0,1,0,1,0,0,0,0,0,0,0,0,0,0,0,0,1
1341,JAMMU & KASHMIR,2007,15,DOWRY DISPUTE,0,0,2,0,0,2,0,3,3,0,0,6,0,0,0,0,0,0,8
1887,JAMMU & KASHMIR,2007,15,DRUG ABUSE,0,4,3,0,0,7,0,0,0,0,0,0,0,0,0,0,0,0,7
2433,JAMMU & KASHMIR,2007,15,ECONOMIC ISSUES,0,11,7,3,0,21,0,5,0,0,1,6,0,0,0,0,0,0,27
2979,JAMMU & KASHMIR,2007,15,EXAM FAILURE,0,0,0,0,0,0,0,2,0,0,0,2,0,0,0,0,0,0,2
3525,JAMMU & KASHMIR,2007,15,FAMILY PROBLEMS,0,8,5,3,0,16,0,10,4,1,0,15,0,0,0,0,0,0,31
4071,JAMMU & KASHMIR,2007,15,HEALTH ISSUES,0,2,1,0,0,3,0,2,2,0,0,4,0,0,0,0,0,0,7
4616,JAMMU & KASHMIR,2007,15,HERO WORSHIP,0,0,0,0,0,0,0,0,0,0,0,0,0,0,0,0,0,0,0
5161,JAMMU & KASHMIR,2007,15,ILLEGITIMATE PREGNANCY,0,0,0,0,0,0,0,0,0,0,0,0,0,0,0,0,0,0,0
5706,JAMMU & KASHMIR,2007,15,LOVE AFFAIRS,0,3,0,0,0,3,0,1,0,0,0,1,0,0,0,0,0,0,4
6252,JAMMU & KASHMIR,2007,15,MARITAL ISSUES,0,3,1,2,0,6,0,2,2,0,0,4,0,0,0,0,0,0,10
6798,JAMMU & KASHMIR,2007,15,MENTAL HEALTH,0,0,0,0,1,1,0,1,1,0,0,2,0,0,0,0,0,0,3
7344,JAMMU & KASHMIR,2007,15,OTHERS,0,20,22,6,2,50,0,12,7,2,0,21,0,0,0,0,0,0,71
7928,JAMMU & KASHMIR,2007,15,"PHYSICAL ABUSE (RAPE,INCEST ETC.)",0,2,0,0,0,2,0,1,0,0,0,1,0,0,0,0,0,0,3
8435,JAMMU & KASHMIR,2007,15,SOCIETAL ISSUES,0,0,0,0,0,0,0,0,0,0,0,0,0,0,0,0,0,0,0
288,JAMMU & KASHMIR,2008,15,CAUSES NOT KNOWN,1,17,30,24,5,77,0,7,7,1,0,15,0,0,0,0,0,0,92
834,JAMMU & KASHMIR,2008,15,DEATH OF DEAR PERSON,0,0,0,0,0,0,0,2,0,0,0,2,0,0,0,0,0,0,2
1380,JAMMU & KASHMIR,2008,15,DOWRY DISPUTE,0,0,0,0,0,0,0,5,2,0,0,7,0,0,0,0,0,0,7
1926,JAMMU & KASHMIR,2008,15,DRUG ABUSE,0,0,0,0,0,0,0,0,0,0,0,0,0,0,0,0,0,0,0
2472,JAMMU & KASHMIR,2008,15,ECONOMIC ISSUES,0,4,6,3,5,18,0,3,1,0,0,4,0,0,0,0,0,0,22
3018,JAMMU & KASHMIR,2008,15,EXAM FAILURE,0,4,0,0,0,4,0,0,1,0,0,1,0,0,0,0,0,0,5
3564,JAMMU & KASHMIR,2008,15,FAMILY PROBLEMS,0,6,3,3,1,13,0,18,10,0,0,28,0,0,0,0,0,0,41
4110,JAMMU & KASHMIR,2008,15,HEALTH ISSUES,0,1,4,4,1,10,0,5,6,0,0,11,0,0,0,0,0,0,21
4655,JAMMU & KASHMIR,2008,15,HERO WORSHIP,0,0,0,0,0,0,0,0,0,0,0,0,0,0,0,0,0,0,0
5200,JAMMU & KASHMIR,2008,15,ILLEGITIMATE PREGNANCY,0,0,0,0,0,0,0,0,0,0,0,0,0,0,0,0,0,0,0
5745,JAMMU & KASHMIR,2008,15,LOVE AFFAIRS,0,6,0,0,0,6,0,2,1,0,0,3,0,0,0,0,0,0,9
6291,JAMMU & KASHMIR,2008,15,MARITAL ISSUES,0,0,0,0,1,1,1,3,2,0,0,6,0,0,0,0,0,0,7
6837,JAMMU & KASHMIR,2008,15,MENTAL HEALTH,0,0,0,0,0,0,0,0,0,0,0,0,0,0,0,0,0,0,0
7383,JAMMU & KASHMIR,2008,15,OTHERS,0,18,19,7,2,46,0,35,18,0,0,53,0,0,0,0,0,0,99
7967,JAMMU & KASHMIR,2008,15,"PHYSICAL ABUSE (RAPE,INCEST ETC.)",0,0,0,0,0,0,0,0,0,0,0,0,0,0,0,0,0,0,0
8474,JAMMU & KASHMIR,2008,15,SOCIETAL ISSUES,0,0,1,0,1,2,0,0,3,0,0,3,0,0,0,0,0,0,5
327,JAMMU & KASHMIR,2009,15,CAUSES NOT KNOWN,0,2,14,3,0,19,2,16,8,0,0,26,0,0,0,0,0,0,45
873,JAMMU & KASHMIR,2009,15,DEATH OF DEAR PERSON,0,0,0,0,0,0,0,0,1,0,0,1,0,0,0,0,0,0,1
1419,JAMMU & KASHMIR,2009,15,DOWRY DISPUTE,0,0,0,0,0,0,0,2,2,0,0,4,0,0,0,0,0,0,4
1965,JAMMU & KASHMIR,2009,15,DRUG ABUSE,0,0,11,6,3,20,0,0,0,0,0,0,0,0,0,0,0,0,20
2511,JAMMU & KASHMIR,2009,15,ECONOMIC ISSUES,0,3,5,4,0,12,0,0,4,2,1,7,0,0,0,0,0,0,19
3057,JAMMU & KASHMIR,2009,15,EXAM FAILURE,0,3,2,0,0,5,0,4,3,0,0,7,0,0,0,0,0,0,12
3603,JAMMU & KASHMIR,2009,15,FAMILY PROBLEMS,0,11,7,1,0,19,0,22,12,2,1,37,0,0,0,0,0,0,56
4149,JAMMU & KASHMIR,2009,15,HEALTH ISSUES,0,3,9,15,13,40,0,3,6,4,4,17,0,0,0,0,0,0,57
4694,JAMMU & KASHMIR,2009,15,HERO WORSHIP,0,1,1,0,0,2,0,0,0,0,0,0,0,0,0,0,0,0,2
5239,JAMMU & KASHMIR,2009,15,ILLEGITIMATE PREGNANCY,0,0,0,0,0,0,0,2,1,0,0,3,0,0,0,0,0,0,3
5784,JAMMU & KASHMIR,2009,15,LOVE AFFAIRS,0,3,1,0,0,4,0,10,1,0,0,11,0,0,0,0,0,0,15
6330,JAMMU & KASHMIR,2009,15,MARITAL ISSUES,0,3,2,0,0,5,0,5,4,0,0,9,0,0,0,0,0,0,14
6876,JAMMU & KASHMIR,2009,15,MENTAL HEALTH,0,0,6,2,0,8,0,0,1,1,0,2,0,0,0,0,0,0,10
7422,JAMMU & KASHMIR,2009,15,OTHERS,0,15,15,3,0,33,0,16,9,0,0,25,0,0,0,0,0,0,58
8006,JAMMU & KASHMIR,2009,15,"PHYSICAL ABUSE (RAPE,INCEST ETC.)",0,0,0,0,0,0,0,0,1,0,0,1,0,0,0,0,0,0,1
8513,JAMMU & KASHMIR,2009,15,SOCIETAL ISSUES,0,0,1,0,0,1,0,1,1,1,0,3,0,0,0,0,0,0,4
366,JAMMU & KASHMIR,2010,15,CAUSES NOT KNOWN,0,9,6,11,1,27,0,22,7,0,0,29,0,0,0,0,0,0,56
912,JAMMU & KASHMIR,2010,15,DEATH OF DEAR PERSON,0,0,0,0,0,0,0,0,0,0,0,0,0,0,0,0,0,0,0
1458,JAMMU & KASHMIR,2010,15,DOWRY DISPUTE,0,1,1,1,0,3,0,2,2,0,0,4,0,0,0,0,0,0,7
2004,JAMMU & KASHMIR,2010,15,DRUG ABUSE,0,1,3,1,1,6,0,0,0,0,0,0,0,0,0,0,0,0,6
2550,JAMMU & KASHMIR,2010,15,ECONOMIC ISSUES,0,2,6,1,1,10,0,0,1,0,0,1,0,0,0,0,0,0,11
3096,JAMMU & KASHMIR,2010,15,EXAM FAILURE,0,2,1,0,0,3,0,5,0,0,0,5,0,0,0,0,0,0,8
3642,JAMMU & KASHMIR,2010,15,FAMILY PROBLEMS,0,6,4,2,1,13,0,13,13,4,0,30,0,0,0,0,0,0,43
4188,JAMMU & KASHMIR,2010,15,HEALTH ISSUES,0,1,2,2,1,6,0,1,1,1,0,3,0,0,0,0,0,0,9
4733,JAMMU & KASHMIR,2010,15,HERO WORSHIP,0,0,0,0,0,0,0,0,0,0,0,0,0,0,0,0,0,0,0
5278,JAMMU & KASHMIR,2010,15,ILLEGITIMATE PREGNANCY,0,0,0,0,0,0,1,3,0,0,0,4,0,0,0,0,0,0,4
5823,JAMMU & KASHMIR,2010,15,LOVE AFFAIRS,0,3,1,0,0,4,1,3,1,0,0,5,0,0,0,0,0,0,9
6369,JAMMU & KASHMIR,2010,15,MARITAL ISSUES,0,3,2,1,0,6,0,4,3,0,0,7,0,0,0,0,0,0,13
6915,JAMMU & KASHMIR,2010,15,MENTAL HEALTH,0,2,1,0,0,3,0,2,0,1,0,3,0,0,0,0,0,0,6
7461,JAMMU & KASHMIR,2010,15,OTHERS,3,16,12,7,2,40,1,30,11,2,1,45,0,0,0,0,0,0,85
8045,JAMMU & KASHMIR,2010,15,"PHYSICAL ABUSE (RAPE,INCEST ETC.)",0,0,0,0,0,0,0,0,0,0,0,0,0,0,0,0,0,0,0
8552,JAMMU & KASHMIR,2010,15,SOCIETAL ISSUES,0,0,1,0,0,1,0,1,0,0,0,1,0,0,0,0,0,0,2
405,JAMMU & KASHMIR,2011,15,CAUSES NOT KNOWN,2,16,9,6,2,35,3,20,4,3,0,30,0,0,0,0,0,0,65
951,JAMMU & KASHMIR,2011,15,DEATH OF DEAR PERSON,0,0,0,0,0,0,0,0,0,0,0,0,0,0,0,0,0,0,0
1497,JAMMU & KASHMIR,2011,15,DOWRY DISPUTE,0,0,0,0,0,0,0,1,3,0,0,4,0,0,0,0,0,0,4
2043,JAMMU & KASHMIR,2011,15,DRUG ABUSE,0,1,5,4,1,11,0,1,0,0,0,1,0,0,0,0,0,0,12
2589,JAMMU & KASHMIR,2011,15,ECONOMIC ISSUES,0,3,8,4,0,15,0,0,1,1,0,2,0,0,0,0,0,0,17
3135,JAMMU & KASHMIR,2011,15,EXAM FAILURE,1,2,0,0,0,3,0,2,0,0,0,2,0,0,0,0,0,0,5
3681,JAMMU & KASHMIR,2011,15,FAMILY PROBLEMS,0,2,10,5,1,18,1,15,8,5,1,30,0,0,0,0,0,0,48
4227,JAMMU & KASHMIR,2011,15,HEALTH ISSUES,0,1,2,4,3,10,0,0,1,1,0,2,0,0,0,0,0,0,12
4772,JAMMU & KASHMIR,2011,15,HERO WORSHIP,0,0,0,0,0,0,0,0,0,0,0,0,0,0,0,0,0,0,0
5317,JAMMU & KASHMIR,2011,15,ILLEGITIMATE PREGNANCY,0,0,0,0,0,0,0,0,0,0,0,0,0,0,0,0,0,0,0
5862,JAMMU & KASHMIR,2011,15,LOVE AFFAIRS,0,2,4,0,0,6,0,19,1,0,0,20,0,0,0,0,0,0,26
6408,JAMMU & KASHMIR,2011,15,MARITAL ISSUES,0,2,2,3,0,7,0,2,2,0,0,4,0,0,0,0,0,0,11
6954,JAMMU & KASHMIR,2011,15,MENTAL HEALTH,0,0,3,2,0,5,0,1,0,0,0,1,0,0,0,0,0,0,6
7500,JAMMU & KASHMIR,2011,15,OTHERS,1,9,8,9,1,28,1,24,18,1,0,44,0,0,0,0,0,0,72
8084,JAMMU & KASHMIR,2011,15,"PHYSICAL ABUSE (RAPE,INCEST ETC.)",0,0,0,0,0,0,0,2,0,0,0,2,0,0,0,0,0,0,2
8591,JAMMU & KASHMIR,2011,15,SOCIETAL ISSUES,0,2,2,2,0,6,0,0,1,0,0,1,0,0,0,0,0,0,7
444,JAMMU & KASHMIR,2012,15,CAUSES NOT KNOWN,0,26,22,12,7,67,0,35,22,5,1,63,0,0,0,0,0,0,130
990,JAMMU & KASHMIR,2012,15,DEATH OF DEAR PERSON,0,0,0,0,0,0,0,0,1,0,0,1,0,0,0,0,0,0,1
1536,JAMMU & KASHMIR,2012,15,DOWRY DISPUTE,0,0,0,0,0,0,0,1,2,0,0,3,0,0,0,0,0,0,3
2082,JAMMU & KASHMIR,2012,15,DRUG ABUSE,0,1,2,1,0,4,0,0,0,0,0,0,0,0,0,0,0,0,4
2628,JAMMU & KASHMIR,2012,15,ECONOMIC ISSUES,0,0,7,5,0,12,0,5,3,1,24,33,0,0,0,0,0,0,45
3174,JAMMU & KASHMIR,2012,15,EXAM FAILURE,0,4,0,0,0,4,0,7,0,0,0,7,0,0,0,0,0,0,11
3720,JAMMU & KASHMIR,2012,15,FAMILY PROBLEMS,1,5,11,1,0,18,0,13,15,2,0,30,0,0,0,0,0,0,48
4266,JAMMU & KASHMIR,2012,15,HEALTH ISSUES,0,1,7,8,11,27,0,1,3,5,5,14,0,0,0,0,0,0,41
4811,JAMMU & KASHMIR,2012,15,HERO WORSHIP,0,0,0,0,0,0,0,0,0,0,0,0,0,0,0,0,0,0,0
5356,JAMMU & KASHMIR,2012,15,ILLEGITIMATE PREGNANCY,0,0,0,0,0,0,0,4,1,0,0,5,0,0,0,0,0,0,5
5901,JAMMU & KASHMIR,2012,15,LOVE AFFAIRS,0,9,1,0,0,10,1,14,0,0,0,15,0,0,0,0,0,0,25
6447,JAMMU & KASHMIR,2012,15,MARITAL ISSUES,0,3,5,1,0,9,0,5,5,2,0,12,0,0,0,0,0,0,21
6993,JAMMU & KASHMIR,2012,15,MENTAL HEALTH,0,1,1,0,0,2,0,3,0,0,0,3,0,0,0,0,0,0,5
7539,JAMMU & KASHMIR,2012,15,OTHERS,1,6,17,10,2,36,1,13,16,3,1,34,0,0,0,0,0,0,70
8123,JAMMU & KASHMIR,2012,15,"PHYSICAL ABUSE (RAPE,INCEST ETC.)",0,0,0,0,0,0,0,0,0,0,0,0,0,0,0,0,0,0,0
8630,JAMMU & KASHMIR,2012,15,SOCIETAL ISSUES,0,0,1,2,0,3,0,0,0,1,1,2,0,0,0,0,0,0,5
483,JAMMU & KASHMIR,2013,15,CAUSES NOT KNOWN,1,11,15,10,4,41,3,31,15,2,1,52,0,0,0,0,0,0,93
1029,JAMMU & KASHMIR,2013,15,DEATH OF DEAR PERSON,0,0,0,0,0,0,0,0,0,0,0,0,0,0,0,0,0,0,0
1575,JAMMU & KASHMIR,2013,15,DOWRY DISPUTE,0,0,0,0,0,0,0,0,2,0,0,2,0,0,0,0,0,0,2
2121,JAMMU & KASHMIR,2013,15,DRUG ABUSE,0,0,5,7,2,14,0,0,0,0,0,0,0,0,0,0,0,0,14
2667,JAMMU & KASHMIR,2013,15,ECONOMIC ISSUES,0,1,6,5,3,15,0,0,0,2,0,2,0,0,0,0,0,0,17
3213,JAMMU & KASHMIR,2013,15,EXAM FAILURE,0,6,1,0,0,7,0,6,0,0,0,6,0,0,0,0,0,0,13
3759,JAMMU & KASHMIR,2013,15,FAMILY PROBLEMS,0,6,8,2,0,16,0,8,10,1,0,19,0,0,0,0,0,0,35
4305,JAMMU & KASHMIR,2013,15,HEALTH ISSUES,0,1,15,15,6,37,0,0,5,1,2,8,0,0,0,0,0,0,45
4850,JAMMU & KASHMIR,2013,15,HERO WORSHIP,0,0,0,0,0,0,0,0,0,0,0,0,0,0,0,0,0,0,0
5395,JAMMU & KASHMIR,2013,15,ILLEGITIMATE PREGNANCY,0,0,0,0,0,0,0,0,0,0,0,0,0,0,0,0,0,0,0
5940,JAMMU & KASHMIR,2013,15,LOVE AFFAIRS,0,3,0,0,0,3,0,3,0,0,0,3,0,0,0,0,0,0,6
6486,JAMMU & KASHMIR,2013,15,MARITAL ISSUES,0,0,1,1,0,2,0,2,2,0,0,4,0,0,0,0,0,0,6
7032,JAMMU & KASHMIR,2013,15,MENTAL HEALTH,0,0,1,3,0,4,0,0,0,0,2,2,0,0,0,0,0,0,6
7578,JAMMU & KASHMIR,2013,15,OTHERS,0,10,16,1,1,28,0,14,18,3,0,35,0,0,0,0,0,0,63
8162,JAMMU & KASHMIR,2013,15,"PHYSICAL ABUSE (RAPE,INCEST ETC.)",0,0,0,0,0,0,0,1,0,0,0,1,0,0,0,0,0,0,1
8669,JAMMU & KASHMIR,2013,15,SOCIETAL ISSUES,0,0,1,0,0,1,0,0,0,0,0,0,0,0,0,0,0,0,1
522,JAMMU & KASHMIR,2014,15,CAUSES NOT KNOWN,1,19,13,11,4,48,0,22,9,2,0,33,0,0,0,0,0,0,81
1068,JAMMU & KASHMIR,2014,15,DEATH OF DEAR PERSON,0,0,0,0,0,0,0,0,0,0,0,0,0,0,0,0,0,0,0
1614,JAMMU & KASHMIR,2014,15,DOWRY DISPUTE,0,0,0,0,0,0,0,1,0,0,0,1,0,0,0,0,0,0,1
2160,JAMMU & KASHMIR,2014,15,DRUG ABUSE,0,0,1,0,0,1,0,0,0,0,0,0,0,0,0,0,0,0,1
2706,JAMMU & KASHMIR,2014,15,ECONOMIC ISSUES,0,1,1,1,1,4,0,2,1,0,0,3,0,0,0,0,0,0,7
3252,JAMMU & KASHMIR,2014,15,EXAM FAILURE,0,0,0,0,0,0,0,2,0,0,0,2,0,0,0,0,0,0,2
3798,JAMMU & KASHMIR,2014,15,FAMILY PROBLEMS,1,17,8,4,1,31,0,9,3,2,0,14,0,0,0,0,0,0,45
4344,JAMMU & KASHMIR,2014,15,HEALTH ISSUES,0,3,1,2,1,7,0,0,2,1,0,3,0,0,0,0,0,0,10
4889,JAMMU & KASHMIR,2014,15,HERO WORSHIP,0,0,0,0,0,0,0,0,0,0,0,0,0,0,0,0,0,0,0
5434,JAMMU & KASHMIR,2014,15,ILLEGITIMATE PREGNANCY,0,0,0,0,0,0,0,0,0,0,0,0,0,0,0,0,0,0,0
5979,JAMMU & KASHMIR,2014,15,LOVE AFFAIRS,0,3,0,0,0,3,0,8,0,0,0,8,0,0,0,0,0,0,11
6525,JAMMU & KASHMIR,2014,15,MARITAL ISSUES,0,7,2,1,0,10,0,17,0,0,0,17,0,0,0,0,0,0,27
7071,JAMMU & KASHMIR,2014,15,MENTAL HEALTH,0,3,1,2,1,7,0,0,0,1,0,1,0,0,0,0,0,0,8
7617,JAMMU & KASHMIR,2014,15,OTHERS,1,14,30,9,1,55,0,25,12,2,0,39,0,0,0,0,0,0,94
7656,JAMMU & KASHMIR,2014,15,PHYSICAL ABUSE,0,0,0,0,0,0,0,0,0,0,0,0,0,0,0,0,0,0,0
8708,JAMMU & KASHMIR,2014,15,SOCIETAL ISSUES,0,0,0,0,0,0,0,0,0,0,0,0,0,0,0,0,0,0,0
16,JHARKHAND,2001,16,CAUSES NOT KNOWN,0,7,11,7,0,25,1,7,0,2,0,10,0,0,0,0,0,0,35
562,JHARKHAND,2001,16,DEATH OF DEAR PERSON,0,0,3,0,0,3,0,0,0,8,0,8,0,0,0,0,0,0,11
1108,JHARKHAND,2001,16,DOWRY DISPUTE,0,0,0,0,0,0,0,0,0,0,0,0,0,0,0,0,0,0,0
1654,JHARKHAND,2001,16,DRUG ABUSE,0,0,0,0,0,0,0,0,0,0,0,0,0,0,0,0,0,0,0
2200,JHARKHAND,2001,16,ECONOMIC ISSUES,0,17,27,7,1,52,0,1,2,0,0,3,0,0,0,0,0,0,55
2746,JHARKHAND,2001,16,EXAM FAILURE,3,3,0,0,0,6,1,1,0,0,0,2,0,0,0,0,0,0,8
3292,JHARKHAND,2001,16,FAMILY PROBLEMS,0,0,0,1,0,1,0,0,21,0,0,21,0,0,0,0,0,0,22
3838,JHARKHAND,2001,16,HEALTH ISSUES,0,0,0,0,0,0,0,0,0,0,0,0,0,0,0,0,0,0,0
4384,JHARKHAND,2001,16,HERO WORSHIP,0,0,0,0,0,0,0,0,0,0,0,0,0,0,0,0,0,0,0
4929,JHARKHAND,2001,16,ILLEGITIMATE PREGNANCY,0,0,0,0,0,0,0,0,0,0,0,0,0,0,0,0,0,0,0
5474,JHARKHAND,2001,16,LOVE AFFAIRS,0,0,0,0,0,0,0,20,0,0,0,20,0,0,0,0,0,0,20
6019,JHARKHAND,2001,16,MARITAL ISSUES,0,0,0,0,0,0,0,9,0,0,0,9,0,0,0,0,0,0,9
6565,JHARKHAND,2001,16,MENTAL HEALTH,0,0,0,0,0,0,0,0,0,0,0,0,0,0,0,0,0,0,0
7111,JHARKHAND,2001,16,OTHERS,1,18,12,11,9,51,3,12,6,13,0,34,0,0,0,0,0,0,85
7696,JHARKHAND,2001,16,"PHYSICAL ABUSE (RAPE,INCEST ETC.)",0,0,0,0,0,0,0,0,0,0,0,0,0,0,0,0,0,0,0
8202,JHARKHAND,2001,16,SOCIETAL ISSUES,0,0,3,0,0,3,0,0,2,0,0,2,0,0,0,0,0,0,5
55,JHARKHAND,2002,16,CAUSES NOT KNOWN,2,6,10,11,0,29,1,2,6,4,0,13,0,0,0,0,0,0,42
601,JHARKHAND,2002,16,DEATH OF DEAR PERSON,0,0,2,0,0,2,0,0,0,9,0,9,0,0,0,0,0,0,11
1147,JHARKHAND,2002,16,DOWRY DISPUTE,0,0,0,0,0,0,0,0,0,0,0,0,0,0,0,0,0,0,0
1693,JHARKHAND,2002,16,DRUG ABUSE,0,0,0,0,0,0,0,0,0,0,0,0,0,0,0,0,0,0,0
2239,JHARKHAND,2002,16,ECONOMIC ISSUES,0,15,27,10,1,53,0,1,3,2,0,6,0,0,0,0,0,0,59
2785,JHARKHAND,2002,16,EXAM FAILURE,5,4,0,0,0,9,1,2,0,0,0,3,0,0,0,0,0,0,12
3331,JHARKHAND,2002,16,FAMILY PROBLEMS,0,0,0,3,0,3,0,4,20,1,0,25,0,0,0,0,0,0,28
3877,JHARKHAND,2002,16,HEALTH ISSUES,0,0,0,0,0,0,0,0,0,0,0,0,0,0,0,0,0,0,0
4423,JHARKHAND,2002,16,HERO WORSHIP,0,0,0,0,0,0,0,0,0,0,0,0,0,0,0,0,0,0,0
4968,JHARKHAND,2002,16,ILLEGITIMATE PREGNANCY,0,0,0,0,0,0,0,0,0,0,0,0,0,0,0,0,0,0,0
5513,JHARKHAND,2002,16,LOVE AFFAIRS,0,0,0,0,0,0,0,18,2,0,0,20,0,0,0,0,0,0,20
6058,JHARKHAND,2002,16,MARITAL ISSUES,0,0,0,0,0,0,0,10,0,0,0,10,0,0,0,0,0,0,10
6604,JHARKHAND,2002,16,MENTAL HEALTH,0,0,0,0,0,0,0,0,0,0,0,0,0,0,0,0,0,0,0
7150,JHARKHAND,2002,16,OTHERS,2,20,11,12,10,55,2,10,5,12,0,29,0,0,0,0,0,0,84
7735,JHARKHAND,2002,16,"PHYSICAL ABUSE (RAPE,INCEST ETC.)",0,0,0,0,0,0,0,0,0,0,0,0,0,0,0,0,0,0,0
8241,JHARKHAND,2002,16,SOCIETAL ISSUES,0,0,2,0,0,2,0,0,4,0,0,4,0,0,0,0,0,0,6
94,JHARKHAND,2003,16,CAUSES NOT KNOWN,2,6,10,11,0,29,1,2,6,4,0,13,0,0,0,0,0,0,42
640,JHARKHAND,2003,16,DEATH OF DEAR PERSON,0,0,2,0,0,2,0,0,0,9,0,9,0,0,0,0,0,0,11
1186,JHARKHAND,2003,16,DOWRY DISPUTE,0,0,0,0,0,0,0,0,0,0,0,0,0,0,0,0,0,0,0
1732,JHARKHAND,2003,16,DRUG ABUSE,0,0,0,0,0,0,0,0,0,0,0,0,0,0,0,0,0,0,0
2278,JHARKHAND,2003,16,ECONOMIC ISSUES,0,15,27,10,1,53,0,1,3,2,0,6,0,0,0,0,0,0,59
2824,JHARKHAND,2003,16,EXAM FAILURE,5,4,0,0,0,9,1,2,0,0,0,3,0,0,0,0,0,0,12
3370,JHARKHAND,2003,16,FAMILY PROBLEMS,0,0,0,3,0,3,0,4,20,1,0,25,0,0,0,0,0,0,28
3916,JHARKHAND,2003,16,HEALTH ISSUES,0,0,0,0,0,0,0,0,0,0,0,0,0,0,0,0,0,0,0
4462,JHARKHAND,2003,16,HERO WORSHIP,0,0,0,0,0,0,0,0,0,0,0,0,0,0,0,0,0,0,0
5007,JHARKHAND,2003,16,ILLEGITIMATE PREGNANCY,0,0,0,0,0,0,0,0,0,0,0,0,0,0,0,0,0,0,0
5552,JHARKHAND,2003,16,LOVE AFFAIRS,0,0,0,0,0,0,0,18,2,0,0,20,0,0,0,0,0,0,20
6097,JHARKHAND,2003,16,MARITAL ISSUES,0,0,0,0,0,0,0,10,0,0,0,10,0,0,0,0,0,0,10
6643,JHARKHAND,2003,16,MENTAL HEALTH,0,0,0,0,0,0,0,0,0,0,0,0,0,0,0,0,0,0,0
7189,JHARKHAND,2003,16,OTHERS,2,20,11,12,10,55,2,10,5,12,0,29,0,0,0,0,0,0,84
7774,JHARKHAND,2003,16,"PHYSICAL ABUSE (RAPE,INCEST ETC.)",0,0,0,0,0,0,0,0,0,0,0,0,0,0,0,0,0,0,0
8280,JHARKHAND,2003,16,SOCIETAL ISSUES,0,0,2,0,0,2,0,0,4,0,0,4,0,0,0,0,0,0,6
133,JHARKHAND,2004,16,CAUSES NOT KNOWN,2,8,10,11,0,31,1,3,6,4,0,14,0,0,0,0,0,0,45
679,JHARKHAND,2004,16,DEATH OF DEAR PERSON,0,0,2,0,0,2,0,0,0,9,0,9,0,0,0,0,0,0,11
1225,JHARKHAND,2004,16,DOWRY DISPUTE,0,0,0,0,0,0,0,0,2,0,0,2,0,0,0,0,0,0,2
1771,JHARKHAND,2004,16,DRUG ABUSE,0,2,4,1,0,7,0,0,0,1,0,1,0,0,0,0,0,0,8
2317,JHARKHAND,2004,16,ECONOMIC ISSUES,0,20,36,11,1,68,0,2,5,2,0,9,0,0,0,0,0,0,77
2863,JHARKHAND,2004,16,EXAM FAILURE,5,6,0,0,0,11,1,5,0,0,0,6,0,0,0,0,0,0,17
3409,JHARKHAND,2004,16,FAMILY PROBLEMS,0,6,6,18,0,30,0,11,32,10,0,53,0,0,0,0,0,0,83
3955,JHARKHAND,2004,16,HEALTH ISSUES,0,0,0,1,0,1,0,0,0,0,0,0,0,0,0,0,0,0,1
4501,JHARKHAND,2004,16,HERO WORSHIP,0,0,0,0,0,0,0,0,0,0,0,0,0,0,0,0,0,0,0
5046,JHARKHAND,2004,16,ILLEGITIMATE PREGNANCY,0,0,0,0,0,0,0,0,0,0,0,0,0,0,0,0,0,0,0
5591,JHARKHAND,2004,16,LOVE AFFAIRS,0,5,3,2,0,10,0,20,10,2,0,32,0,0,0,0,0,0,42
6136,JHARKHAND,2004,16,MARITAL ISSUES,0,3,5,3,0,11,0,14,6,5,0,25,0,0,0,0,0,0,36
6682,JHARKHAND,2004,16,MENTAL HEALTH,0,0,1,0,0,1,0,0,0,0,0,0,0,0,0,0,0,0,1
7228,JHARKHAND,2004,16,OTHERS,2,22,11,12,10,57,2,10,5,12,0,29,0,0,0,0,0,0,86
7813,JHARKHAND,2004,16,"PHYSICAL ABUSE (RAPE,INCEST ETC.)",0,0,0,0,0,0,0,0,0,0,0,0,0,0,0,0,0,0,0
8319,JHARKHAND,2004,16,SOCIETAL ISSUES,0,0,2,2,0,4,0,0,4,0,0,4,0,0,0,0,0,0,8
172,JHARKHAND,2005,16,CAUSES NOT KNOWN,1,14,19,7,2,43,3,9,12,4,0,28,0,0,0,0,0,0,71
718,JHARKHAND,2005,16,DEATH OF DEAR PERSON,0,0,0,0,0,0,0,0,0,0,0,0,0,0,0,0,0,0,0
1264,JHARKHAND,2005,16,DOWRY DISPUTE,0,0,0,0,0,0,0,4,3,1,0,8,0,0,0,0,0,0,8
1810,JHARKHAND,2005,16,DRUG ABUSE,0,5,7,14,0,26,0,1,0,2,0,3,0,0,0,0,0,0,29
2356,JHARKHAND,2005,16,ECONOMIC ISSUES,0,7,21,17,1,46,1,7,9,3,0,20,0,0,0,0,0,0,66
2902,JHARKHAND,2005,16,EXAM FAILURE,1,24,3,0,0,28,2,9,5,0,0,16,0,0,0,0,0,0,44
3448,JHARKHAND,2005,16,FAMILY PROBLEMS,0,11,17,12,0,40,0,11,7,4,0,22,0,0,0,0,0,0,62
3994,JHARKHAND,2005,16,HEALTH ISSUES,1,0,22,10,0,33,0,0,10,4,0,14,0,0,0,0,0,0,47
4540,JHARKHAND,2005,16,HERO WORSHIP,0,0,0,0,0,0,0,0,0,0,0,0,0,0,0,0,0,0,0
5085,JHARKHAND,2005,16,ILLEGITIMATE PREGNANCY,0,0,0,0,0,0,0,0,0,0,0,0,0,0,0,0,0,0,0
5630,JHARKHAND,2005,16,LOVE AFFAIRS,0,9,7,0,0,16,0,10,2,0,0,12,0,0,0,0,0,0,28
6175,JHARKHAND,2005,16,MARITAL ISSUES,0,7,6,6,0,19,0,7,10,2,0,19,0,0,0,0,0,0,38
6721,JHARKHAND,2005,16,MENTAL HEALTH,0,9,22,43,7,81,1,9,7,3,0,20,0,0,0,0,0,0,101
7267,JHARKHAND,2005,16,OTHERS,5,94,63,22,4,188,6,39,63,5,4,117,0,0,0,0,0,0,305
7852,JHARKHAND,2005,16,"PHYSICAL ABUSE (RAPE,INCEST ETC.)",0,1,0,0,0,1,0,6,0,0,0,6,0,0,0,0,0,0,7
8358,JHARKHAND,2005,16,SOCIETAL ISSUES,0,0,0,2,0,2,0,0,0,0,0,0,0,0,0,0,0,0,2
211,JHARKHAND,2006,16,CAUSES NOT KNOWN,2,36,31,23,3,95,2,23,17,5,2,49,0,0,0,0,0,0,144
757,JHARKHAND,2006,16,DEATH OF DEAR PERSON,0,0,0,0,0,0,0,1,0,0,0,1,0,0,0,0,0,0,1
1303,JHARKHAND,2006,16,DOWRY DISPUTE,0,0,0,0,0,0,0,6,2,0,0,8,0,0,0,0,0,0,8
1849,JHARKHAND,2006,16,DRUG ABUSE,0,4,9,11,0,24,0,0,2,3,0,5,0,0,0,0,0,0,29
2395,JHARKHAND,2006,16,ECONOMIC ISSUES,0,24,21,7,4,56,1,4,10,1,0,16,0,0,0,0,0,0,72
2941,JHARKHAND,2006,16,EXAM FAILURE,4,18,0,0,0,22,1,7,2,0,0,10,0,0,0,0,0,0,32
3487,JHARKHAND,2006,16,FAMILY PROBLEMS,2,19,32,16,0,69,2,24,23,7,0,56,0,0,0,0,0,0,125
4033,JHARKHAND,2006,16,HEALTH ISSUES,1,0,6,1,2,10,2,3,1,0,0,6,0,0,0,0,0,0,16
4579,JHARKHAND,2006,16,HERO WORSHIP,0,0,0,0,0,0,0,0,0,0,0,0,0,0,0,0,0,0,0
5124,JHARKHAND,2006,16,ILLEGITIMATE PREGNANCY,0,0,0,0,0,0,0,0,1,0,0,1,0,0,0,0,0,0,1
5669,JHARKHAND,2006,16,LOVE AFFAIRS,0,11,2,0,0,13,0,10,1,0,0,11,0,0,0,0,0,0,24
6214,JHARKHAND,2006,16,MARITAL ISSUES,0,20,12,4,0,36,1,30,24,0,0,55,0,0,0,0,0,0,91
6760,JHARKHAND,2006,16,MENTAL HEALTH,0,16,16,4,3,39,1,7,3,0,0,11,0,0,0,0,0,0,50
7306,JHARKHAND,2006,16,OTHERS,12,38,46,27,9,132,4,31,28,21,2,86,0,0,0,0,0,0,218
7891,JHARKHAND,2006,16,"PHYSICAL ABUSE (RAPE,INCEST ETC.)",0,0,5,0,1,6,0,6,5,0,0,11,0,0,0,0,0,0,17
8397,JHARKHAND,2006,16,SOCIETAL ISSUES,0,4,13,2,0,19,1,6,1,1,0,9,0,0,0,0,0,0,28
250,JHARKHAND,2007,16,CAUSES NOT KNOWN,1,26,46,22,5,100,4,9,14,3,1,31,0,0,0,0,0,0,131
796,JHARKHAND,2007,16,DEATH OF DEAR PERSON,0,0,0,0,0,0,0,1,0,0,0,1,0,0,0,0,0,0,1
1342,JHARKHAND,2007,16,DOWRY DISPUTE,0,5,0,0,0,5,0,13,12,1,0,26,0,0,0,0,0,0,31
1888,JHARKHAND,2007,16,DRUG ABUSE,3,10,29,8,1,51,0,0,0,0,0,0,0,0,0,0,0,0,51
2434,JHARKHAND,2007,16,ECONOMIC ISSUES,0,16,19,19,6,60,0,5,6,1,1,13,0,0,0,0,0,0,73
2980,JHARKHAND,2007,16,EXAM FAILURE,11,23,0,0,0,34,3,3,2,0,0,8,0,0,0,0,0,0,42
3526,JHARKHAND,2007,16,FAMILY PROBLEMS,0,15,26,11,2,54,3,25,15,3,1,47,0,0,0,0,0,0,101
4072,JHARKHAND,2007,16,HEALTH ISSUES,1,6,7,17,8,39,0,6,1,1,0,8,0,0,0,0,0,0,47
4617,JHARKHAND,2007,16,HERO WORSHIP,0,0,0,0,0,0,0,1,0,0,0,1,0,0,0,0,0,0,1
5162,JHARKHAND,2007,16,ILLEGITIMATE PREGNANCY,0,0,0,0,0,0,0,1,0,0,0,1,0,0,0,0,0,0,1
5707,JHARKHAND,2007,16,LOVE AFFAIRS,0,8,2,0,0,10,0,6,0,0,0,6,0,0,0,0,0,0,16
6253,JHARKHAND,2007,16,MARITAL ISSUES,2,17,27,5,2,53,0,20,22,4,0,46,0,0,0,0,0,0,99
6799,JHARKHAND,2007,16,MENTAL HEALTH,0,15,22,8,2,47,0,4,8,7,0,19,0,0,0,0,0,0,66
7345,JHARKHAND,2007,16,OTHERS,28,117,137,106,34,422,12,69,54,33,17,185,0,0,0,0,0,0,607
7929,JHARKHAND,2007,16,"PHYSICAL ABUSE (RAPE,INCEST ETC.)",0,0,0,0,0,0,0,1,0,0,0,1,0,0,0,0,0,0,1
8436,JHARKHAND,2007,16,SOCIETAL ISSUES,0,3,1,1,0,5,0,14,1,1,0,16,0,0,0,0,0,0,21
289,JHARKHAND,2008,16,CAUSES NOT KNOWN,5,30,51,35,8,129,7,16,16,4,1,44,0,0,0,0,0,0,173
835,JHARKHAND,2008,16,DEATH OF DEAR PERSON,0,0,0,0,0,0,0,1,1,0,0,2,0,0,0,0,0,0,2
1381,JHARKHAND,2008,16,DOWRY DISPUTE,0,0,0,2,0,2,0,0,3,0,0,3,0,0,0,0,0,0,5
1927,JHARKHAND,2008,16,DRUG ABUSE,0,3,18,12,2,35,0,0,1,1,0,2,0,0,0,0,0,0,37
2473,JHARKHAND,2008,16,ECONOMIC ISSUES,0,4,11,3,1,19,0,0,4,0,0,4,0,0,0,0,0,0,23
3019,JHARKHAND,2008,16,EXAM FAILURE,1,9,8,0,0,18,1,15,0,0,0,16,0,0,0,0,0,0,34
3565,JHARKHAND,2008,16,FAMILY PROBLEMS,0,13,27,21,10,71,12,16,23,8,0,59,0,0,0,0,0,0,130
4111,JHARKHAND,2008,16,HEALTH ISSUES,0,7,14,11,4,36,0,5,2,3,0,10,0,0,0,0,0,0,46
4656,JHARKHAND,2008,16,HERO WORSHIP,0,0,0,0,0,0,0,0,0,0,0,0,0,0,0,0,0,0,0
5201,JHARKHAND,2008,16,ILLEGITIMATE PREGNANCY,0,0,0,0,0,0,0,3,0,0,0,3,0,0,0,0,0,0,3
5746,JHARKHAND,2008,16,LOVE AFFAIRS,0,12,1,0,0,13,1,9,0,0,0,10,0,0,0,0,0,0,23
6292,JHARKHAND,2008,16,MARITAL ISSUES,0,4,14,4,0,22,0,4,11,5,0,20,0,0,0,0,0,0,42
6838,JHARKHAND,2008,16,MENTAL HEALTH,2,8,7,5,0,22,2,2,0,1,0,5,0,0,0,0,0,0,27
7384,JHARKHAND,2008,16,OTHERS,12,80,86,39,14,231,8,42,40,24,5,119,0,0,0,0,0,0,350
7968,JHARKHAND,2008,16,"PHYSICAL ABUSE (RAPE,INCEST ETC.)",0,0,0,0,0,0,0,0,3,4,0,7,0,0,0,0,0,0,7
8475,JHARKHAND,2008,16,SOCIETAL ISSUES,0,1,1,2,0,4,0,0,4,0,1,5,0,0,0,0,0,0,9
328,JHARKHAND,2009,16,CAUSES NOT KNOWN,1,26,31,30,9,97,4,10,16,5,2,37,0,0,0,0,0,0,134
874,JHARKHAND,2009,16,DEATH OF DEAR PERSON,0,0,0,0,0,0,0,2,0,0,0,2,0,0,0,0,0,0,2
1420,JHARKHAND,2009,16,DOWRY DISPUTE,0,1,0,0,0,1,0,9,4,0,0,13,0,0,0,0,0,0,14
1966,JHARKHAND,2009,16,DRUG ABUSE,0,9,18,12,1,40,1,1,0,0,0,2,0,0,0,0,0,0,42
2512,JHARKHAND,2009,16,ECONOMIC ISSUES,0,15,58,21,6,100,0,4,6,4,0,14,0,0,0,0,0,0,114
3058,JHARKHAND,2009,16,EXAM FAILURE,2,11,3,0,0,16,2,4,0,0,0,6,0,0,0,0,0,0,22
3604,JHARKHAND,2009,16,FAMILY PROBLEMS,0,15,40,15,4,74,4,24,18,2,5,53,0,0,0,0,0,0,127
4150,JHARKHAND,2009,16,HEALTH ISSUES,0,5,3,15,9,32,1,3,5,2,0,11,0,0,0,0,0,0,43
4695,JHARKHAND,2009,16,HERO WORSHIP,0,0,0,0,0,0,0,0,0,0,0,0,0,0,0,0,0,0,0
5240,JHARKHAND,2009,16,ILLEGITIMATE PREGNANCY,0,0,0,0,0,0,0,5,2,0,0,7,0,0,0,0,0,0,7
5785,JHARKHAND,2009,16,LOVE AFFAIRS,0,24,7,2,0,33,3,13,1,0,0,17,0,0,0,0,0,0,50
6331,JHARKHAND,2009,16,MARITAL ISSUES,0,6,9,7,0,22,0,20,23,5,0,48,0,0,0,0,0,0,70
6877,JHARKHAND,2009,16,MENTAL HEALTH,1,9,23,11,2,46,0,1,3,9,1,14,0,0,0,0,0,0,60
7423,JHARKHAND,2009,16,OTHERS,12,80,75,85,20,272,7,33,43,34,15,132,0,0,0,0,0,0,404
8007,JHARKHAND,2009,16,"PHYSICAL ABUSE (RAPE,INCEST ETC.)",0,0,0,0,0,0,0,2,1,0,0,3,0,0,0,0,0,0,3
8514,JHARKHAND,2009,16,SOCIETAL ISSUES,0,2,5,4,0,11,0,4,2,3,0,9,0,0,0,0,0,0,20
367,JHARKHAND,2010,16,CAUSES NOT KNOWN,2,33,37,39,0,111,4,17,21,11,1,54,0,0,0,0,0,0,165
913,JHARKHAND,2010,16,DEATH OF DEAR PERSON,63,10,3,6,1,83,0,5,4,4,0,13,0,0,0,0,0,0,96
1459,JHARKHAND,2010,16,DOWRY DISPUTE,0,0,1,0,0,1,0,12,8,0,0,20,0,0,0,0,0,0,21
2005,JHARKHAND,2010,16,DRUG ABUSE,0,2,9,1,0,12,0,0,0,3,0,3,0,0,0,0,0,0,15
2551,JHARKHAND,2010,16,ECONOMIC ISSUES,0,12,31,13,0,56,1,3,8,5,3,20,0,0,0,0,0,0,76
3097,JHARKHAND,2010,16,EXAM FAILURE,9,32,3,0,0,44,5,14,0,0,0,19,0,0,0,0,0,0,63
3643,JHARKHAND,2010,16,FAMILY PROBLEMS,0,20,24,16,1,61,1,15,20,5,0,41,0,0,0,0,0,0,102
4189,JHARKHAND,2010,16,HEALTH ISSUES,1,10,7,8,1,27,0,1,4,7,0,12,0,0,0,0,0,0,39
4734,JHARKHAND,2010,16,HERO WORSHIP,0,3,2,0,0,5,0,0,2,0,0,2,0,0,0,0,0,0,7
5279,JHARKHAND,2010,16,ILLEGITIMATE PREGNANCY,0,0,0,0,0,0,0,8,1,1,0,10,0,0,0,0,0,0,10
5824,JHARKHAND,2010,16,LOVE AFFAIRS,1,14,9,0,0,24,1,29,3,0,0,33,0,0,0,0,0,0,57
6370,JHARKHAND,2010,16,MARITAL ISSUES,0,13,15,6,0,34,0,17,20,11,0,48,0,0,0,0,0,0,82
6916,JHARKHAND,2010,16,MENTAL HEALTH,1,4,15,5,0,25,0,1,4,3,0,8,0,0,0,0,0,0,33
7462,JHARKHAND,2010,16,OTHERS,5,93,118,78,9,303,4,50,46,29,20,149,0,0,0,0,0,0,452
8046,JHARKHAND,2010,16,"PHYSICAL ABUSE (RAPE,INCEST ETC.)",0,0,0,0,0,0,0,1,0,1,0,2,0,0,0,0,0,0,2
8553,JHARKHAND,2010,16,SOCIETAL ISSUES,2,6,1,0,0,9,0,2,1,0,0,3,0,0,0,0,0,0,12
406,JHARKHAND,2011,16,CAUSES NOT KNOWN,0,21,27,30,0,78,0,12,14,10,0,36,0,0,0,0,0,0,114
952,JHARKHAND,2011,16,DEATH OF DEAR PERSON,0,1,3,1,0,5,0,2,0,2,0,4,0,0,0,0,0,0,9
1498,JHARKHAND,2011,16,DOWRY DISPUTE,0,1,1,0,0,2,0,2,0,0,0,2,0,0,0,0,0,0,4
2044,JHARKHAND,2011,16,DRUG ABUSE,0,14,9,10,1,34,0,1,0,0,0,1,0,0,0,0,0,0,35
2590,JHARKHAND,2011,16,ECONOMIC ISSUES,0,23,35,18,1,77,0,9,7,2,0,18,0,0,0,0,0,0,95
3136,JHARKHAND,2011,16,EXAM FAILURE,2,28,1,0,0,31,5,18,0,0,0,23,0,0,0,0,0,0,54
3682,JHARKHAND,2011,16,FAMILY PROBLEMS,0,29,29,15,3,76,2,30,21,4,3,60,0,0,0,0,0,0,136
4228,JHARKHAND,2011,16,HEALTH ISSUES,2,5,1,6,4,18,0,3,1,1,0,5,0,0,0,0,0,0,23
4773,JHARKHAND,2011,16,HERO WORSHIP,0,0,0,0,0,0,0,0,0,0,0,0,0,0,0,0,0,0,0
5318,JHARKHAND,2011,16,ILLEGITIMATE PREGNANCY,0,0,0,0,0,0,0,4,0,0,0,4,0,0,0,0,0,0,4
5863,JHARKHAND,2011,16,LOVE AFFAIRS,0,32,6,0,0,38,0,17,5,0,0,22,0,0,0,0,0,0,60
6409,JHARKHAND,2011,16,MARITAL ISSUES,0,8,9,2,0,19,0,18,12,0,0,30,0,0,0,0,0,0,49
6955,JHARKHAND,2011,16,MENTAL HEALTH,0,9,11,5,2,27,0,0,2,2,0,4,0,0,0,0,0,0,31
7501,JHARKHAND,2011,16,OTHERS,9,149,127,90,35,410,11,69,62,23,6,171,0,0,0,0,0,0,581
8085,JHARKHAND,2011,16,"PHYSICAL ABUSE (RAPE,INCEST ETC.)",0,0,2,1,0,3,0,0,0,0,0,0,0,0,0,0,0,0,3
8592,JHARKHAND,2011,16,SOCIETAL ISSUES,0,4,2,1,0,7,0,4,3,0,0,7,0,0,0,0,0,0,14
445,JHARKHAND,2012,16,CAUSES NOT KNOWN,3,55,29,42,16,145,4,29,22,16,5,76,0,0,0,0,0,0,221
991,JHARKHAND,2012,16,DEATH OF DEAR PERSON,0,0,1,1,0,2,1,0,2,0,0,3,0,0,0,0,0,0,5
1537,JHARKHAND,2012,16,DOWRY DISPUTE,0,0,0,0,0,0,0,9,9,1,0,19,0,0,0,0,0,0,19
2083,JHARKHAND,2012,16,DRUG ABUSE,0,12,8,6,4,30,0,5,1,4,0,10,0,0,0,0,0,0,40
2629,JHARKHAND,2012,16,ECONOMIC ISSUES,3,35,36,24,5,103,2,13,10,7,2,34,0,0,0,0,0,0,137
3175,JHARKHAND,2012,16,EXAM FAILURE,4,21,5,3,0,33,3,13,7,0,0,23,0,0,0,0,0,0,56
3721,JHARKHAND,2012,16,FAMILY PROBLEMS,4,37,55,31,5,132,1,40,23,6,0,70,0,0,0,0,0,0,202
4267,JHARKHAND,2012,16,HEALTH ISSUES,1,6,7,7,3,24,3,2,3,3,0,11,0,0,0,0,0,0,35
4812,JHARKHAND,2012,16,HERO WORSHIP,0,0,0,0,0,0,0,0,0,0,0,0,0,0,0,0,0,0,0
5357,JHARKHAND,2012,16,ILLEGITIMATE PREGNANCY,0,0,0,0,0,0,0,5,0,0,0,5,0,0,0,0,0,0,5
5902,JHARKHAND,2012,16,LOVE AFFAIRS,0,21,6,0,0,27,1,16,4,0,0,21,0,0,0,0,0,0,48
6448,JHARKHAND,2012,16,MARITAL ISSUES,0,8,21,5,0,34,5,25,20,3,0,53,0,0,0,0,0,0,87
6994,JHARKHAND,2012,16,MENTAL HEALTH,3,9,17,11,1,41,3,6,5,2,0,16,0,0,0,0,0,0,57
7540,JHARKHAND,2012,16,OTHERS,3,87,78,66,19,253,10,48,43,28,1,130,0,0,0,0,0,0,383
8124,JHARKHAND,2012,16,"PHYSICAL ABUSE (RAPE,INCEST ETC.)",2,0,1,0,0,3,1,4,1,0,0,6,0,0,0,0,0,0,9
8631,JHARKHAND,2012,16,SOCIETAL ISSUES,0,6,3,2,0,11,0,2,2,0,0,4,0,0,0,0,0,0,15
484,JHARKHAND,2013,16,CAUSES NOT KNOWN,1,48,36,35,7,127,1,22,15,8,1,47,0,0,0,0,0,0,174
1030,JHARKHAND,2013,16,DEATH OF DEAR PERSON,0,1,0,1,1,3,0,1,1,0,0,2,0,0,0,0,0,0,5
1576,JHARKHAND,2013,16,DOWRY DISPUTE,0,0,0,0,0,0,0,12,10,0,0,22,0,0,0,0,0,0,22
2122,JHARKHAND,2013,16,DRUG ABUSE,0,22,21,21,3,67,0,0,6,5,0,11,0,0,0,0,0,0,78
2668,JHARKHAND,2013,16,ECONOMIC ISSUES,0,18,38,19,6,81,0,7,6,0,0,13,0,0,0,0,0,0,94
3214,JHARKHAND,2013,16,EXAM FAILURE,3,24,2,0,2,31,0,13,7,0,0,20,0,0,0,0,0,0,51
3760,JHARKHAND,2013,16,FAMILY PROBLEMS,0,30,46,30,8,114,1,28,20,15,2,66,0,0,0,0,0,0,180
4306,JHARKHAND,2013,16,HEALTH ISSUES,2,9,14,24,13,62,0,7,11,9,3,30,0,0,0,0,0,0,92
4851,JHARKHAND,2013,16,HERO WORSHIP,0,0,0,0,0,0,0,3,0,0,0,3,0,0,0,0,0,0,3
5396,JHARKHAND,2013,16,ILLEGITIMATE PREGNANCY,0,0,0,0,0,0,0,4,0,0,0,4,0,0,0,0,0,0,4
5941,JHARKHAND,2013,16,LOVE AFFAIRS,0,41,16,0,0,57,4,33,4,0,0,41,0,0,0,0,0,0,98
6487,JHARKHAND,2013,16,MARITAL ISSUES,0,27,10,4,0,41,0,26,15,2,0,43,0,0,0,0,0,0,84
7033,JHARKHAND,2013,16,MENTAL HEALTH,1,14,17,10,4,46,2,6,6,3,1,18,0,0,0,0,0,0,64
7579,JHARKHAND,2013,16,OTHERS,43,76,82,78,28,307,14,38,41,38,9,140,0,0,0,0,0,0,447
8163,JHARKHAND,2013,16,"PHYSICAL ABUSE (RAPE,INCEST ETC.)",0,0,7,23,0,30,0,3,8,0,0,11,0,0,0,0,0,0,41
8670,JHARKHAND,2013,16,SOCIETAL ISSUES,0,8,6,4,0,18,0,3,1,0,1,5,0,0,0,0,0,0,23
523,JHARKHAND,2014,16,CAUSES NOT KNOWN,4,52,47,28,2,133,2,51,28,6,6,93,0,0,0,0,0,0,226
1069,JHARKHAND,2014,16,DEATH OF DEAR PERSON,0,1,1,1,2,5,0,1,0,0,0,1,0,0,0,0,0,0,6
1615,JHARKHAND,2014,16,DOWRY DISPUTE,0,0,1,0,0,1,0,6,0,0,0,6,0,0,0,0,0,0,7
2161,JHARKHAND,2014,16,DRUG ABUSE,0,11,5,0,0,16,0,1,0,1,0,2,0,0,0,0,0,0,18
2707,JHARKHAND,2014,16,ECONOMIC ISSUES,0,28,27,13,0,68,0,16,11,3,0,30,0,0,0,0,0,0,98
3253,JHARKHAND,2014,16,EXAM FAILURE,2,24,5,0,0,31,2,11,1,0,0,14,0,0,0,0,0,0,45
3799,JHARKHAND,2014,16,FAMILY PROBLEMS,0,35,22,40,6,103,0,29,19,0,0,48,0,0,0,0,0,0,151
4345,JHARKHAND,2014,16,HEALTH ISSUES,1,45,46,31,0,123,0,8,10,11,4,33,0,0,0,0,0,0,156
4890,JHARKHAND,2014,16,HERO WORSHIP,0,0,0,0,0,0,0,0,0,0,0,0,0,0,0,0,0,0,0
5435,JHARKHAND,2014,16,ILLEGITIMATE PREGNANCY,0,0,0,0,0,0,0,0,0,0,0,0,0,0,0,0,0,0,0
5980,JHARKHAND,2014,16,LOVE AFFAIRS,0,31,6,6,0,43,1,21,2,0,0,24,0,0,0,0,0,0,67
6526,JHARKHAND,2014,16,MARITAL ISSUES,0,40,18,9,0,67,0,37,9,2,1,49,0,0,0,0,0,0,116
7072,JHARKHAND,2014,16,MENTAL HEALTH,1,9,14,9,0,33,0,6,2,3,2,13,0,0,0,0,0,0,46
7618,JHARKHAND,2014,16,OTHERS,14,191,122,45,12,384,19,95,25,6,2,147,0,0,0,0,0,0,531
7657,JHARKHAND,2014,16,PHYSICAL ABUSE,0,0,0,0,0,0,0,0,0,0,0,0,0,0,0,0,0,0,0
8709,JHARKHAND,2014,16,SOCIETAL ISSUES,0,4,5,4,3,16,0,0,1,2,0,3,0,0,0,0,0,0,19
17,KARNATAKA,2001,17,CAUSES NOT KNOWN,51,608,816,496,209,2180,42,350,244,145,71,852,0,0,0,0,0,0,3032
563,KARNATAKA,2001,17,DEATH OF DEAR PERSON,2,11,10,5,4,32,0,10,4,6,1,21,0,0,0,0,0,0,53
1109,KARNATAKA,2001,17,DOWRY DISPUTE,0,1,2,0,0,3,0,63,24,2,0,89,0,0,0,0,0,0,92
1655,KARNATAKA,2001,17,DRUG ABUSE,2,14,16,12,11,55,5,5,3,3,3,19,0,0,0,0,0,0,74
2201,KARNATAKA,2001,17,ECONOMIC ISSUES,8,260,356,209,78,911,1,71,52,34,13,171,0,0,0,0,0,0,1082
2747,KARNATAKA,2001,17,EXAM FAILURE,26,70,4,1,0,101,16,52,2,0,0,70,0,0,0,0,0,0,171
3293,KARNATAKA,2001,17,FAMILY PROBLEMS,10,301,493,286,69,1159,23,370,265,82,12,752,0,0,0,0,0,0,1911
3839,KARNATAKA,2001,17,HEALTH ISSUES,17,532,659,481,245,1934,31,468,278,198,96,1071,0,0,0,0,0,0,3005
4385,KARNATAKA,2001,17,HERO WORSHIP,1,1,1,0,0,3,0,1,1,1,0,3,0,0,0,0,0,0,6
4930,KARNATAKA,2001,17,ILLEGITIMATE PREGNANCY,0,0,0,0,0,0,0,9,1,0,0,10,0,0,0,0,0,0,10
5475,KARNATAKA,2001,17,LOVE AFFAIRS,1,51,9,3,0,64,3,54,5,0,0,62,0,0,0,0,0,0,126
6020,KARNATAKA,2001,17,MARITAL ISSUES,0,23,31,16,2,72,1,83,33,8,0,125,0,0,0,0,0,0,197
6566,KARNATAKA,2001,17,MENTAL HEALTH,5,96,155,86,38,380,11,92,77,48,39,267,0,0,0,0,0,0,647
7112,KARNATAKA,2001,17,OTHERS,52,235,282,211,64,844,51,176,118,98,27,470,0,0,0,0,0,0,1314
7697,KARNATAKA,2001,17,"PHYSICAL ABUSE (RAPE,INCEST ETC.)",0,0,0,10,3,13,0,7,4,0,3,14,0,0,0,0,0,0,27
8203,KARNATAKA,2001,17,SOCIETAL ISSUES,5,39,46,20,10,120,0,6,7,1,0,14,0,0,0,0,0,0,134
56,KARNATAKA,2002,17,CAUSES NOT KNOWN,34,548,742,453,196,1973,49,296,247,123,105,820,0,0,0,0,0,0,2793
602,KARNATAKA,2002,17,DEATH OF DEAR PERSON,3,10,14,10,5,42,1,13,5,5,1,25,0,0,0,0,0,0,67
1148,KARNATAKA,2002,17,DOWRY DISPUTE,0,0,0,0,0,0,0,72,26,3,0,101,0,0,0,0,0,0,101
1694,KARNATAKA,2002,17,DRUG ABUSE,2,15,24,16,13,70,5,4,6,4,5,24,0,0,0,0,0,0,94
2240,KARNATAKA,2002,17,ECONOMIC ISSUES,8,214,320,178,54,774,3,67,52,27,9,158,0,0,0,0,0,0,932
2786,KARNATAKA,2002,17,EXAM FAILURE,15,92,3,0,0,110,23,64,0,0,0,87,0,0,0,0,0,0,197
3332,KARNATAKA,2002,17,FAMILY PROBLEMS,4,298,545,291,60,1198,7,391,326,87,29,840,0,0,0,0,0,0,2038
3878,KARNATAKA,2002,17,HEALTH ISSUES,22,553,779,484,312,2150,82,448,341,210,113,1194,0,0,0,0,0,0,3344
4424,KARNATAKA,2002,17,HERO WORSHIP,0,8,0,4,0,12,0,0,0,0,1,1,0,0,0,0,0,0,13
4969,KARNATAKA,2002,17,ILLEGITIMATE PREGNANCY,0,0,0,0,0,0,0,3,1,0,0,4,0,0,0,0,0,0,4
5514,KARNATAKA,2002,17,LOVE AFFAIRS,0,48,10,1,1,60,2,40,2,0,0,44,0,0,0,0,0,0,104
6059,KARNATAKA,2002,17,MARITAL ISSUES,0,38,35,12,0,85,2,82,45,3,0,132,0,0,0,0,0,0,217
6605,KARNATAKA,2002,17,MENTAL HEALTH,1,87,134,84,39,345,5,73,70,42,34,224,0,0,0,0,0,0,569
7151,KARNATAKA,2002,17,OTHERS,32,363,418,290,128,1231,25,234,157,63,43,522,0,0,0,0,0,0,1753
7736,KARNATAKA,2002,17,"PHYSICAL ABUSE (RAPE,INCEST ETC.)",0,0,2,0,0,2,0,4,1,0,0,5,0,0,0,0,0,0,7
8242,KARNATAKA,2002,17,SOCIETAL ISSUES,0,11,5,9,3,28,0,5,3,1,0,9,0,0,0,0,0,0,37
95,KARNATAKA,2003,17,CAUSES NOT KNOWN,47,617,756,469,211,2100,48,315,323,158,73,917,0,0,0,0,0,0,3017
641,KARNATAKA,2003,17,DEATH OF DEAR PERSON,0,24,10,14,8,56,1,22,11,0,2,36,0,0,0,0,0,0,92
1187,KARNATAKA,2003,17,DOWRY DISPUTE,0,0,0,0,0,0,0,28,15,2,0,45,0,0,0,0,0,0,45
1733,KARNATAKA,2003,17,DRUG ABUSE,0,19,18,11,4,52,0,3,2,0,0,5,0,0,0,0,0,0,57
2279,KARNATAKA,2003,17,ECONOMIC ISSUES,10,262,410,220,84,986,5,52,67,39,22,185,0,0,0,0,0,0,1171
2825,KARNATAKA,2003,17,EXAM FAILURE,11,66,4,0,0,81,10,45,1,0,0,56,0,0,0,0,0,0,137
3371,KARNATAKA,2003,17,FAMILY PROBLEMS,4,302,421,307,82,1116,11,256,239,96,40,642,0,0,0,0,0,0,1758
3917,KARNATAKA,2003,17,HEALTH ISSUES,29,456,543,442,262,1732,38,384,279,173,105,979,0,0,0,0,0,0,2711
4463,KARNATAKA,2003,17,HERO WORSHIP,0,8,0,4,0,12,0,0,0,0,1,1,0,0,0,0,0,0,13
5008,KARNATAKA,2003,17,ILLEGITIMATE PREGNANCY,0,0,0,0,0,0,0,1,0,0,0,1,0,0,0,0,0,0,1
5553,KARNATAKA,2003,17,LOVE AFFAIRS,1,47,7,1,0,56,5,56,5,0,0,66,0,0,0,0,0,0,122
6098,KARNATAKA,2003,17,MARITAL ISSUES,0,25,37,10,0,72,4,50,41,7,0,102,0,0,0,0,0,0,174
6644,KARNATAKA,2003,17,MENTAL HEALTH,4,115,172,104,73,468,2,94,65,46,19,226,0,0,0,0,0,0,694
7190,KARNATAKA,2003,17,OTHERS,35,481,508,418,185,1627,30,316,231,90,47,714,0,0,0,0,0,0,2341
7775,KARNATAKA,2003,17,"PHYSICAL ABUSE (RAPE,INCEST ETC.)",0,0,0,0,0,0,0,1,1,0,0,2,0,0,0,0,0,0,2
8281,KARNATAKA,2003,17,SOCIETAL ISSUES,1,4,9,2,1,17,0,8,1,0,0,9,0,0,0,0,0,0,26
134,KARNATAKA,2004,17,CAUSES NOT KNOWN,20,655,767,509,211,2162,36,317,289,110,50,802,0,0,0,0,0,0,2964
680,KARNATAKA,2004,17,DEATH OF DEAR PERSON,0,19,9,7,3,38,3,10,5,2,4,24,0,0,0,0,0,0,62
1226,KARNATAKA,2004,17,DOWRY DISPUTE,0,0,0,0,0,0,0,33,10,0,0,43,0,0,0,0,0,0,43
1772,KARNATAKA,2004,17,DRUG ABUSE,0,17,14,15,4,50,0,3,2,0,0,5,0,0,0,0,0,0,55
2318,KARNATAKA,2004,17,ECONOMIC ISSUES,8,197,290,210,45,750,4,54,68,32,12,170,0,0,0,0,0,0,920
2864,KARNATAKA,2004,17,EXAM FAILURE,15,45,7,4,0,71,6,47,0,2,0,55,0,0,0,0,0,0,126
3410,KARNATAKA,2004,17,FAMILY PROBLEMS,16,257,430,237,56,996,18,317,214,71,25,645,0,0,0,0,0,0,1641
3956,KARNATAKA,2004,17,HEALTH ISSUES,26,489,616,431,241,1803,17,383,275,168,97,940,0,0,0,0,0,0,2743
4502,KARNATAKA,2004,17,HERO WORSHIP,0,0,0,0,0,0,0,0,0,0,0,0,0,0,0,0,0,0,0
5047,KARNATAKA,2004,17,ILLEGITIMATE PREGNANCY,0,0,0,0,0,0,1,4,3,0,0,8,0,0,0,0,0,0,8
5592,KARNATAKA,2004,17,LOVE AFFAIRS,0,34,15,0,0,49,4,41,3,0,0,48,0,0,0,0,0,0,97
6137,KARNATAKA,2004,17,MARITAL ISSUES,2,24,43,13,2,84,0,49,34,3,0,86,0,0,0,0,0,0,170
6683,KARNATAKA,2004,17,MENTAL HEALTH,4,129,127,79,37,376,5,89,85,39,19,237,0,0,0,0,0,0,613
7229,KARNATAKA,2004,17,OTHERS,68,435,588,353,141,1585,52,337,242,170,50,851,0,0,0,0,0,0,2436
7814,KARNATAKA,2004,17,"PHYSICAL ABUSE (RAPE,INCEST ETC.)",0,1,0,0,0,1,0,0,0,0,0,0,0,0,0,0,0,0,1
8320,KARNATAKA,2004,17,SOCIETAL ISSUES,0,27,22,4,0,53,0,4,1,0,0,5,0,0,0,0,0,0,58
173,KARNATAKA,2005,17,CAUSES NOT KNOWN,22,717,755,566,135,2195,15,300,260,134,51,760,0,0,0,0,0,0,2955
719,KARNATAKA,2005,17,DEATH OF DEAR PERSON,0,5,11,11,8,35,0,11,8,6,1,26,0,0,0,0,0,0,61
1265,KARNATAKA,2005,17,DOWRY DISPUTE,0,0,0,0,0,0,0,34,4,0,0,38,0,0,0,0,0,0,38
1811,KARNATAKA,2005,17,DRUG ABUSE,0,7,27,15,3,52,0,1,2,0,4,7,0,0,0,0,0,0,59
2357,KARNATAKA,2005,17,ECONOMIC ISSUES,1,168,235,130,40,574,1,42,47,20,9,119,0,0,0,0,0,0,693
2903,KARNATAKA,2005,17,EXAM FAILURE,7,71,3,0,0,81,6,49,5,0,1,61,0,0,0,0,0,0,142
3449,KARNATAKA,2005,17,FAMILY PROBLEMS,12,276,418,243,51,1000,8,211,178,79,23,499,0,0,0,0,0,0,1499
3995,KARNATAKA,2005,17,HEALTH ISSUES,12,394,516,412,261,1595,16,377,300,174,79,946,0,0,0,0,0,0,2541
4541,KARNATAKA,2005,17,HERO WORSHIP,1,3,4,4,0,12,0,7,1,0,0,8,0,0,0,0,0,0,20
5086,KARNATAKA,2005,17,ILLEGITIMATE PREGNANCY,0,0,0,0,0,0,0,1,0,0,0,1,0,0,0,0,0,0,1
5631,KARNATAKA,2005,17,LOVE AFFAIRS,0,49,13,0,0,62,0,30,4,0,0,34,0,0,0,0,0,0,96
6176,KARNATAKA,2005,17,MARITAL ISSUES,0,23,33,13,1,70,0,52,42,14,2,110,0,0,0,0,0,0,180
6722,KARNATAKA,2005,17,MENTAL HEALTH,2,86,146,91,33,358,3,85,73,56,45,262,0,0,0,0,0,0,620
7268,KARNATAKA,2005,17,OTHERS,47,454,513,454,166,1634,38,412,297,167,57,971,0,0,0,0,0,0,2605
7853,KARNATAKA,2005,17,"PHYSICAL ABUSE (RAPE,INCEST ETC.)",0,1,0,2,0,3,0,1,1,0,0,2,0,0,0,0,0,0,5
8359,KARNATAKA,2005,17,SOCIETAL ISSUES,0,7,17,11,1,36,0,1,4,1,0,6,0,0,0,0,0,0,42
212,KARNATAKA,2006,17,CAUSES NOT KNOWN,33,589,581,488,108,1799,16,281,195,119,33,644,0,0,0,0,0,0,2443
758,KARNATAKA,2006,17,DEATH OF DEAR PERSON,0,5,12,11,6,34,0,11,6,8,1,26,0,0,0,0,0,0,60
1304,KARNATAKA,2006,17,DOWRY DISPUTE,0,10,2,0,0,12,0,26,7,0,0,33,0,0,0,0,0,0,45
1850,KARNATAKA,2006,17,DRUG ABUSE,2,16,35,11,4,68,2,3,1,0,1,7,0,0,0,0,0,0,75
2396,KARNATAKA,2006,17,ECONOMIC ISSUES,1,143,189,140,55,528,1,81,53,34,13,182,0,0,0,0,0,0,710
2942,KARNATAKA,2006,17,EXAM FAILURE,3,50,13,4,0,70,3,60,9,3,0,75,0,0,0,0,0,0,145
3488,KARNATAKA,2006,17,FAMILY PROBLEMS,9,257,415,312,97,1090,10,262,235,107,23,637,0,0,0,0,0,0,1727
4034,KARNATAKA,2006,17,HEALTH ISSUES,7,403,594,560,242,1806,29,398,374,213,82,1096,0,0,0,0,0,0,2902
4580,KARNATAKA,2006,17,HERO WORSHIP,0,1,5,2,1,9,0,2,0,1,0,3,0,0,0,0,0,0,12
5125,KARNATAKA,2006,17,ILLEGITIMATE PREGNANCY,0,0,0,0,0,0,0,2,0,0,0,2,0,0,0,0,0,0,2
5670,KARNATAKA,2006,17,LOVE AFFAIRS,1,47,4,0,0,52,2,36,10,0,1,49,0,0,0,0,0,0,101
6215,KARNATAKA,2006,17,MARITAL ISSUES,0,27,18,10,2,57,0,53,20,6,0,79,0,0,0,0,0,0,136
6761,KARNATAKA,2006,17,MENTAL HEALTH,0,94,124,75,46,339,6,65,64,40,14,189,0,0,0,0,0,0,528
7307,KARNATAKA,2006,17,OTHERS,95,663,843,408,164,2173,62,473,351,159,97,1142,0,0,0,0,0,0,3315
7892,KARNATAKA,2006,17,"PHYSICAL ABUSE (RAPE,INCEST ETC.)",0,1,2,1,0,4,0,0,0,0,0,0,0,0,0,0,0,0,4
8398,KARNATAKA,2006,17,SOCIETAL ISSUES,0,1,3,3,0,7,0,0,0,0,0,0,0,0,0,0,0,0,7
251,KARNATAKA,2007,17,CAUSES NOT KNOWN,30,527,714,735,149,2155,16,217,284,178,27,722,0,0,0,0,0,0,2877
797,KARNATAKA,2007,17,DEATH OF DEAR PERSON,0,5,21,12,2,40,0,7,9,3,4,23,0,0,0,0,0,0,63
1343,KARNATAKA,2007,17,DOWRY DISPUTE,0,1,0,0,0,1,0,34,8,0,0,42,0,0,0,0,0,0,43
1889,KARNATAKA,2007,17,DRUG ABUSE,0,5,18,4,4,31,0,8,1,0,0,9,0,0,0,0,0,0,40
2435,KARNATAKA,2007,17,ECONOMIC ISSUES,5,154,224,134,51,568,17,71,41,21,4,154,0,0,0,0,0,0,722
2981,KARNATAKA,2007,17,EXAM FAILURE,6,45,2,0,0,53,7,36,3,0,0,46,0,0,0,0,0,0,99
3527,KARNATAKA,2007,17,FAMILY PROBLEMS,5,301,487,436,75,1304,7,309,243,162,49,770,0,0,0,0,0,0,2074
4073,KARNATAKA,2007,17,HEALTH ISSUES,18,395,570,510,219,1712,20,352,288,219,102,981,0,0,0,0,0,0,2693
4618,KARNATAKA,2007,17,HERO WORSHIP,0,0,1,1,0,2,0,0,0,0,0,0,0,0,0,0,0,0,2
5163,KARNATAKA,2007,17,ILLEGITIMATE PREGNANCY,0,0,0,0,0,0,0,1,2,0,0,3,0,0,0,0,0,0,3
5708,KARNATAKA,2007,17,LOVE AFFAIRS,0,41,9,0,0,50,1,33,3,0,1,38,0,0,0,0,0,0,88
6254,KARNATAKA,2007,17,MARITAL ISSUES,0,22,37,15,4,78,1,65,38,10,0,114,0,0,0,0,0,0,192
6800,KARNATAKA,2007,17,MENTAL HEALTH,4,106,140,112,46,408,6,89,67,42,25,229,0,0,0,0,0,0,637
7346,KARNATAKA,2007,17,OTHERS,41,547,750,453,176,1967,52,296,241,118,62,769,0,0,0,0,0,0,2736
7930,KARNATAKA,2007,17,"PHYSICAL ABUSE (RAPE,INCEST ETC.)",0,5,3,2,0,10,0,3,3,0,0,6,0,0,0,0,0,0,16
8437,KARNATAKA,2007,17,SOCIETAL ISSUES,0,0,8,5,0,13,0,2,4,0,0,6,0,0,0,0,0,0,19
290,KARNATAKA,2008,17,CAUSES NOT KNOWN,18,452,516,609,154,1749,14,275,199,116,76,680,0,0,0,0,0,0,2429
836,KARNATAKA,2008,17,DEATH OF DEAR PERSON,0,5,9,5,5,24,1,15,9,5,2,32,0,0,0,0,0,0,56
1382,KARNATAKA,2008,17,DOWRY DISPUTE,0,0,0,0,0,0,0,27,11,0,0,38,0,0,0,0,0,0,38
1928,KARNATAKA,2008,17,DRUG ABUSE,0,4,10,12,2,28,1,0,0,0,1,2,0,0,0,0,0,0,30
2474,KARNATAKA,2008,17,ECONOMIC ISSUES,0,113,183,124,47,467,4,54,31,25,9,123,0,0,0,0,0,0,590
3020,KARNATAKA,2008,17,EXAM FAILURE,7,65,6,9,0,87,12,51,0,0,0,63,0,0,0,0,0,0,150
3566,KARNATAKA,2008,17,FAMILY PROBLEMS,2,317,467,354,73,1213,2,290,271,150,52,765,0,0,0,0,0,0,1978
4112,KARNATAKA,2008,17,HEALTH ISSUES,5,382,581,484,266,1718,19,383,287,201,84,974,0,0,0,0,0,0,2692
4657,KARNATAKA,2008,17,HERO WORSHIP,0,0,0,0,0,0,0,2,0,0,0,2,0,0,0,0,0,0,2
5202,KARNATAKA,2008,17,ILLEGITIMATE PREGNANCY,0,0,0,0,0,0,0,3,0,0,0,3,0,0,0,0,0,0,3
5747,KARNATAKA,2008,17,LOVE AFFAIRS,0,56,7,0,0,63,0,31,3,0,0,34,0,0,0,0,0,0,97
6293,KARNATAKA,2008,17,MARITAL ISSUES,1,13,26,12,2,54,2,47,35,8,0,92,0,0,0,0,0,0,146
6839,KARNATAKA,2008,17,MENTAL HEALTH,3,116,153,102,57,431,4,97,60,32,32,225,0,0,0,0,0,0,656
7385,KARNATAKA,2008,17,OTHERS,18,670,903,585,182,2358,19,374,353,151,60,957,0,0,0,0,0,0,3315
7969,KARNATAKA,2008,17,"PHYSICAL ABUSE (RAPE,INCEST ETC.)",0,2,6,3,2,13,1,4,1,0,0,6,0,0,0,0,0,0,19
8476,KARNATAKA,2008,17,SOCIETAL ISSUES,0,3,3,4,1,11,1,4,1,2,2,10,0,0,0,0,0,0,21
329,KARNATAKA,2009,17,CAUSES NOT KNOWN,116,539,800,636,219,2310,68,340,292,163,97,960,0,0,0,0,0,0,3270
875,KARNATAKA,2009,17,DEATH OF DEAR PERSON,1,13,13,9,10,46,1,4,10,4,1,20,0,0,0,0,0,0,66
1421,KARNATAKA,2009,17,DOWRY DISPUTE,0,0,8,1,0,9,0,29,13,9,4,55,0,0,0,0,0,0,64
1967,KARNATAKA,2009,17,DRUG ABUSE,3,7,18,15,10,53,0,8,4,0,0,12,0,0,0,0,0,0,65
2513,KARNATAKA,2009,17,ECONOMIC ISSUES,4,126,207,144,69,550,4,45,44,28,10,131,0,0,0,0,0,0,681
3059,KARNATAKA,2009,17,EXAM FAILURE,7,59,3,11,0,80,11,56,0,0,0,67,0,0,0,0,0,0,147
3605,KARNATAKA,2009,17,FAMILY PROBLEMS,24,296,486,478,181,1465,12,224,282,136,51,705,0,0,0,0,0,0,2170
4151,KARNATAKA,2009,17,HEALTH ISSUES,20,305,542,533,311,1711,32,262,283,228,130,935,0,0,0,0,0,0,2646
4696,KARNATAKA,2009,17,HERO WORSHIP,0,0,3,6,1,10,0,0,0,0,0,0,0,0,0,0,0,0,10
5241,KARNATAKA,2009,17,ILLEGITIMATE PREGNANCY,0,0,0,0,0,0,0,1,1,0,0,2,0,0,0,0,0,0,2
5786,KARNATAKA,2009,17,LOVE AFFAIRS,0,46,12,15,0,73,8,37,6,1,1,53,0,0,0,0,0,0,126
6332,KARNATAKA,2009,17,MARITAL ISSUES,2,18,38,13,1,72,1,52,44,16,4,117,0,0,0,0,0,0,189
6878,KARNATAKA,2009,17,MENTAL HEALTH,3,138,134,77,33,385,1,71,69,35,17,193,0,0,0,0,0,0,578
7424,KARNATAKA,2009,17,OTHERS,23,262,636,373,117,1411,25,167,203,275,55,725,0,0,0,0,0,0,2136
8008,KARNATAKA,2009,17,"PHYSICAL ABUSE (RAPE,INCEST ETC.)",0,6,2,0,0,8,0,6,0,0,0,6,0,0,0,0,0,0,14
8515,KARNATAKA,2009,17,SOCIETAL ISSUES,0,4,1,20,1,26,0,4,1,0,0,5,0,0,0,0,0,0,31
368,KARNATAKA,2010,17,CAUSES NOT KNOWN,18,425,668,515,161,1787,37,269,226,137,56,725,0,0,0,0,0,0,2512
914,KARNATAKA,2010,17,DEATH OF DEAR PERSON,0,10,20,14,8,52,1,16,5,4,6,32,0,0,0,0,0,0,84
1460,KARNATAKA,2010,17,DOWRY DISPUTE,0,0,16,2,2,20,0,37,17,10,3,67,0,0,0,0,0,0,87
2006,KARNATAKA,2010,17,DRUG ABUSE,0,13,17,20,8,58,1,8,0,1,0,10,0,0,0,0,0,0,68
2552,KARNATAKA,2010,17,ECONOMIC ISSUES,0,134,212,231,59,636,3,26,22,25,16,92,0,0,0,0,0,0,728
3098,KARNATAKA,2010,17,EXAM FAILURE,9,78,0,0,0,87,9,51,0,0,0,60,0,0,0,0,0,0,147
3644,KARNATAKA,2010,17,FAMILY PROBLEMS,3,240,472,413,177,1305,1,310,219,138,58,726,0,0,0,0,0,0,2031
4190,KARNATAKA,2010,17,HEALTH ISSUES,8,377,672,661,313,2031,34,320,338,291,137,1120,0,0,0,0,0,0,3151
4735,KARNATAKA,2010,17,HERO WORSHIP,0,2,3,2,1,8,0,4,2,0,1,7,0,0,0,0,0,0,15
5280,KARNATAKA,2010,17,ILLEGITIMATE PREGNANCY,0,0,0,0,0,0,0,5,5,0,0,10,0,0,0,0,0,0,10
5825,KARNATAKA,2010,17,LOVE AFFAIRS,2,60,24,0,0,86,19,32,5,0,0,56,0,0,0,0,0,0,142
6371,KARNATAKA,2010,17,MARITAL ISSUES,0,17,21,9,3,50,0,58,39,9,2,108,0,0,0,0,0,0,158
6917,KARNATAKA,2010,17,MENTAL HEALTH,16,91,114,79,75,375,26,68,52,28,23,197,0,0,0,0,0,0,572
7463,KARNATAKA,2010,17,OTHERS,31,606,615,430,178,1860,37,395,318,192,89,1031,0,0,0,0,0,0,2891
8047,KARNATAKA,2010,17,"PHYSICAL ABUSE (RAPE,INCEST ETC.)",0,0,1,0,0,1,0,0,0,0,0,0,0,0,0,0,0,0,1
8554,KARNATAKA,2010,17,SOCIETAL ISSUES,0,17,10,12,12,51,0,3,0,0,0,3,0,0,0,0,0,0,54
407,KARNATAKA,2011,17,CAUSES NOT KNOWN,15,553,685,434,199,1886,11,248,245,162,36,702,0,0,0,0,0,0,2588
953,KARNATAKA,2011,17,DEATH OF DEAR PERSON,0,10,9,11,5,35,0,11,9,4,5,29,0,0,0,0,0,0,64
1499,KARNATAKA,2011,17,DOWRY DISPUTE,0,2,0,0,0,2,0,38,32,0,0,70,0,0,0,0,0,0,72
2045,KARNATAKA,2011,17,DRUG ABUSE,0,13,21,19,7,60,0,3,1,5,2,11,0,0,0,0,0,0,71
2591,KARNATAKA,2011,17,ECONOMIC ISSUES,0,160,250,163,40,613,2,36,33,24,13,108,0,0,0,0,0,0,721
3137,KARNATAKA,2011,17,EXAM FAILURE,59,82,2,0,0,143,5,75,0,2,0,82,0,0,0,0,0,0,225
3683,KARNATAKA,2011,17,FAMILY PROBLEMS,5,443,648,391,92,1579,4,337,276,199,38,854,0,0,0,0,0,0,2433
4229,KARNATAKA,2011,17,HEALTH ISSUES,2,348,566,505,224,1645,3,325,259,254,112,953,0,0,0,0,0,0,2598
4774,KARNATAKA,2011,17,HERO WORSHIP,0,0,0,0,0,0,0,0,0,0,0,0,0,0,0,0,0,0,0
5319,KARNATAKA,2011,17,ILLEGITIMATE PREGNANCY,0,0,0,0,0,0,0,0,0,0,0,0,0,0,0,0,0,0,0
5864,KARNATAKA,2011,17,LOVE AFFAIRS,113,78,7,2,0,200,0,70,14,2,0,86,0,0,0,0,0,0,286
6410,KARNATAKA,2011,17,MARITAL ISSUES,0,37,47,23,0,107,0,56,48,6,0,110,0,0,0,0,0,0,217
6956,KARNATAKA,2011,17,MENTAL HEALTH,1,100,104,66,53,324,6,96,58,35,29,224,0,0,0,0,0,0,548
7502,KARNATAKA,2011,17,OTHERS,24,486,681,475,162,1828,57,304,279,177,75,892,0,0,0,0,0,0,2720
8086,KARNATAKA,2011,17,"PHYSICAL ABUSE (RAPE,INCEST ETC.)",1,1,5,1,0,8,0,2,0,0,0,2,0,0,0,0,0,0,10
8593,KARNATAKA,2011,17,SOCIETAL ISSUES,0,13,19,9,1,42,0,11,9,5,2,27,0,0,0,0,0,0,69
446,KARNATAKA,2012,17,CAUSES NOT KNOWN,18,402,596,375,146,1537,21,248,186,89,34,578,0,0,0,0,0,0,2115
992,KARNATAKA,2012,17,DEATH OF DEAR PERSON,0,8,10,12,6,36,3,14,13,7,6,43,0,0,0,0,0,0,79
1538,KARNATAKA,2012,17,DOWRY DISPUTE,0,0,0,0,0,0,0,27,17,0,0,44,0,0,0,0,0,0,44
2084,KARNATAKA,2012,17,DRUG ABUSE,0,24,22,19,6,71,0,2,0,2,2,6,0,0,0,0,0,0,77
2630,KARNATAKA,2012,17,ECONOMIC ISSUES,4,173,259,176,32,644,2,64,52,35,7,160,0,0,0,0,0,0,804
3176,KARNATAKA,2012,17,EXAM FAILURE,11,84,1,0,0,96,5,79,3,0,0,87,0,0,0,0,0,0,183
3722,KARNATAKA,2012,17,FAMILY PROBLEMS,5,483,784,477,98,1847,16,432,286,160,41,935,0,0,0,0,0,0,2782
4268,KARNATAKA,2012,17,HEALTH ISSUES,6,376,582,529,235,1728,12,325,284,231,80,932,0,0,0,0,0,0,2660
4813,KARNATAKA,2012,17,HERO WORSHIP,0,4,0,0,0,4,0,0,0,0,0,0,0,0,0,0,0,0,4
5358,KARNATAKA,2012,17,ILLEGITIMATE PREGNANCY,0,0,0,0,0,0,0,1,0,0,0,1,0,0,0,0,0,0,1
5903,KARNATAKA,2012,17,LOVE AFFAIRS,16,137,12,1,0,166,0,139,11,0,0,150,0,0,0,0,0,0,316
6449,KARNATAKA,2012,17,MARITAL ISSUES,0,37,44,15,2,98,0,51,32,5,2,90,0,0,0,0,0,0,188
6995,KARNATAKA,2012,17,MENTAL HEALTH,4,124,134,99,64,425,7,94,58,47,32,238,0,0,0,0,0,0,663
7541,KARNATAKA,2012,17,OTHERS,13,476,670,492,167,1818,12,281,311,175,66,845,0,0,0,0,0,0,2663
8125,KARNATAKA,2012,17,"PHYSICAL ABUSE (RAPE,INCEST ETC.)",0,2,0,0,0,2,0,0,0,0,0,0,0,0,0,0,0,0,2
8632,KARNATAKA,2012,17,SOCIETAL ISSUES,1,28,43,45,7,124,0,29,10,5,4,48,0,0,0,0,0,0,172
485,KARNATAKA,2013,17,CAUSES NOT KNOWN,33,522,590,317,95,1557,54,238,127,85,19,523,0,0,0,0,0,0,2080
1031,KARNATAKA,2013,17,DEATH OF DEAR PERSON,0,11,12,5,3,31,0,9,15,2,0,26,0,0,0,0,0,0,57
1577,KARNATAKA,2013,17,DOWRY DISPUTE,0,0,0,0,0,0,0,25,7,0,0,32,0,0,0,0,0,0,32
2123,KARNATAKA,2013,17,DRUG ABUSE,1,14,21,17,6,59,0,7,1,0,0,8,0,0,0,0,0,0,67
2669,KARNATAKA,2013,17,ECONOMIC ISSUES,0,115,234,148,24,521,1,33,33,58,44,169,0,0,0,0,0,0,690
3215,KARNATAKA,2013,17,EXAM FAILURE,13,80,3,0,0,96,3,75,4,0,0,82,0,0,0,0,0,0,178
3761,KARNATAKA,2013,17,FAMILY PROBLEMS,7,324,457,251,102,1141,9,251,200,66,20,546,0,0,0,0,0,0,1687
4307,KARNATAKA,2013,17,HEALTH ISSUES,8,353,592,494,210,1657,14,323,252,179,85,853,0,0,0,0,0,0,2510
4852,KARNATAKA,2013,17,HERO WORSHIP,0,1,2,1,0,4,0,1,1,0,0,2,0,0,0,0,0,0,6
5397,KARNATAKA,2013,17,ILLEGITIMATE PREGNANCY,0,0,0,0,0,0,0,2,0,0,0,2,0,0,0,0,0,0,2
5942,KARNATAKA,2013,17,LOVE AFFAIRS,0,93,18,1,0,112,0,66,4,1,0,71,0,0,0,0,0,0,183
6488,KARNATAKA,2013,17,MARITAL ISSUES,0,31,38,8,1,78,0,53,25,7,0,85,0,0,0,0,0,0,163
7034,KARNATAKA,2013,17,MENTAL HEALTH,6,102,119,95,26,348,5,86,62,28,18,199,0,0,0,0,0,0,547
7580,KARNATAKA,2013,17,OTHERS,44,536,706,547,230,2063,26,290,357,147,95,915,0,0,0,0,0,0,2978
8164,KARNATAKA,2013,17,"PHYSICAL ABUSE (RAPE,INCEST ETC.)",0,1,2,0,1,4,0,0,0,0,0,0,0,0,0,0,0,0,4
8671,KARNATAKA,2013,17,SOCIETAL ISSUES,0,16,21,23,2,62,1,12,5,2,0,20,0,0,0,0,0,0,82
524,KARNATAKA,2014,17,CAUSES NOT KNOWN,5,272,240,123,53,693,4,119,39,35,15,212,0,0,0,0,0,0,905
1070,KARNATAKA,2014,17,DEATH OF DEAR PERSON,0,26,23,19,4,72,0,19,16,2,2,39,0,0,0,0,0,0,111
1616,KARNATAKA,2014,17,DOWRY DISPUTE,0,0,0,0,0,0,0,6,5,0,0,11,0,0,0,0,0,0,11
2162,KARNATAKA,2014,17,DRUG ABUSE,0,12,21,34,11,78,0,0,3,2,0,5,0,0,0,0,0,0,83
2708,KARNATAKA,2014,17,ECONOMIC ISSUES,0,123,188,86,21,418,3,16,23,4,3,49,0,0,0,0,0,0,467
3254,KARNATAKA,2014,17,EXAM FAILURE,5,73,2,0,0,80,2,82,0,0,0,84,0,0,0,0,0,0,164
3800,KARNATAKA,2014,17,FAMILY PROBLEMS,4,350,457,273,44,1128,1,259,226,83,11,580,0,1,0,0,0,1,1709
4346,KARNATAKA,2014,17,HEALTH ISSUES,9,814,928,556,315,2622,9,619,352,228,146,1354,0,0,1,0,0,1,3977
4891,KARNATAKA,2014,17,HERO WORSHIP,0,0,1,0,0,1,0,0,0,0,0,0,0,0,0,0,0,0,1
5436,KARNATAKA,2014,17,ILLEGITIMATE PREGNANCY,0,0,0,0,0,0,0,1,0,0,0,1,0,0,0,0,0,0,1
5981,KARNATAKA,2014,17,LOVE AFFAIRS,2,242,47,22,9,322,1,87,10,4,0,102,0,0,0,0,0,0,424
6527,KARNATAKA,2014,17,MARITAL ISSUES,0,93,66,9,4,172,0,121,44,9,1,175,0,0,0,0,0,0,347
7073,KARNATAKA,2014,17,MENTAL HEALTH,1,162,144,76,27,410,3,85,58,38,24,208,0,0,1,0,0,1,619
7619,KARNATAKA,2014,17,OTHERS,33,1180,1177,731,162,3283,21,569,329,329,75,1323,0,0,0,0,0,0,4606
7658,KARNATAKA,2014,17,PHYSICAL ABUSE,0,2,0,0,0,2,0,0,0,0,0,0,0,0,0,0,0,0,2
8710,KARNATAKA,2014,17,SOCIETAL ISSUES,0,8,15,5,0,28,1,7,4,0,0,12,0,0,0,0,0,0,40
18,KERALA,2001,18,CAUSES NOT KNOWN,4,133,169,180,114,600,5,83,58,51,43,240,0,0,0,0,0,0,840
564,KERALA,2001,18,DEATH OF DEAR PERSON,1,7,16,13,12,49,1,6,10,7,10,34,0,0,0,0,0,0,83
1110,KERALA,2001,18,DOWRY DISPUTE,0,0,0,1,0,1,0,19,5,1,0,25,0,0,0,0,0,0,26
1656,KERALA,2001,18,DRUG ABUSE,0,15,35,27,5,82,0,1,0,0,0,1,0,0,0,0,0,0,83
2202,KERALA,2001,18,ECONOMIC ISSUES,1,160,649,591,173,1574,1,49,117,124,35,326,0,0,0,0,0,0,1900
2748,KERALA,2001,18,EXAM FAILURE,9,24,1,0,0,34,11,41,0,0,0,52,0,0,0,0,0,0,86
3294,KERALA,2001,18,FAMILY PROBLEMS,13,225,367,428,183,1216,13,179,176,125,79,572,0,0,0,0,0,0,1788
3840,KERALA,2001,18,HEALTH ISSUES,3,94,181,400,410,1088,1,56,97,137,150,441,0,0,0,0,0,0,1529
4386,KERALA,2001,18,HERO WORSHIP,0,0,0,0,0,0,0,0,0,0,0,0,0,0,0,0,0,0,0
4931,KERALA,2001,18,ILLEGITIMATE PREGNANCY,0,2,0,0,0,2,0,7,6,0,0,13,0,0,0,0,0,0,15
5476,KERALA,2001,18,LOVE AFFAIRS,0,74,10,2,1,87,0,46,15,2,0,63,0,0,0,0,0,0,150
6021,KERALA,2001,18,MARITAL ISSUES,0,5,14,10,0,29,0,26,29,18,2,75,0,0,0,0,0,0,104
6567,KERALA,2001,18,MENTAL HEALTH,1,100,188,206,120,615,1,78,104,89,67,339,0,0,0,0,0,0,954
7113,KERALA,2001,18,OTHERS,11,268,467,360,247,1353,15,202,169,108,79,573,0,0,0,0,0,0,1926
7698,KERALA,2001,18,"PHYSICAL ABUSE (RAPE,INCEST ETC.)",0,0,0,0,0,0,0,0,0,0,0,0,0,0,0,0,0,0,0
8204,KERALA,2001,18,SOCIETAL ISSUES,0,2,10,22,23,57,0,1,12,4,14,31,0,0,0,0,0,0,88
57,KERALA,2002,18,CAUSES NOT KNOWN,10,256,351,295,244,1156,10,125,131,85,54,405,0,0,0,0,0,0,1561
603,KERALA,2002,18,DEATH OF DEAR PERSON,0,7,14,9,21,51,0,12,9,8,13,42,0,0,0,0,0,0,93
1149,KERALA,2002,18,DOWRY DISPUTE,0,0,0,0,0,0,0,10,7,4,1,22,0,0,0,0,0,0,22
1695,KERALA,2002,18,DRUG ABUSE,0,28,61,83,8,180,0,1,0,0,0,1,0,0,0,0,0,0,181
2241,KERALA,2002,18,ECONOMIC ISSUES,2,153,455,406,178,1194,3,19,59,58,16,155,0,0,0,0,0,0,1349
2787,KERALA,2002,18,EXAM FAILURE,6,33,0,0,0,39,13,37,0,0,0,50,0,0,0,0,0,0,89
3333,KERALA,2002,18,FAMILY PROBLEMS,21,281,472,527,309,1610,22,173,220,172,103,690,0,0,0,0,0,0,2300
3879,KERALA,2002,18,HEALTH ISSUES,2,95,220,332,431,1080,4,59,102,126,132,423,0,0,0,0,0,0,1503
4425,KERALA,2002,18,HERO WORSHIP,0,3,4,6,8,21,0,2,2,2,1,7,0,0,0,0,0,0,28
4970,KERALA,2002,18,ILLEGITIMATE PREGNANCY,0,0,0,0,0,0,0,4,2,0,0,6,0,0,0,0,0,0,6
5515,KERALA,2002,18,LOVE AFFAIRS,0,37,11,0,0,48,0,27,9,1,0,37,0,0,0,0,0,0,85
6060,KERALA,2002,18,MARITAL ISSUES,0,8,18,6,3,35,0,35,43,11,0,89,0,0,0,0,0,0,124
6606,KERALA,2002,18,MENTAL HEALTH,2,127,225,203,137,694,0,89,107,85,38,319,0,0,0,0,0,0,1013
7152,KERALA,2002,18,OTHERS,11,230,361,305,131,1038,12,90,147,73,67,389,0,0,0,0,0,0,1427
7737,KERALA,2002,18,"PHYSICAL ABUSE (RAPE,INCEST ETC.)",0,2,0,0,0,2,0,4,0,0,0,4,0,0,0,0,0,0,6
8243,KERALA,2002,18,SOCIETAL ISSUES,0,4,4,5,4,17,1,2,2,0,1,6,0,0,0,0,0,0,23
96,KERALA,2003,18,CAUSES NOT KNOWN,17,207,319,293,164,1000,17,119,86,63,58,343,0,0,0,0,0,0,1343
642,KERALA,2003,18,DEATH OF DEAR PERSON,1,7,12,13,9,42,0,7,8,10,9,34,0,0,0,0,0,0,76
1188,KERALA,2003,18,DOWRY DISPUTE,0,2,0,1,0,3,0,6,1,0,0,7,0,0,0,0,0,0,10
1734,KERALA,2003,18,DRUG ABUSE,0,18,43,55,41,157,0,1,0,0,0,1,0,0,0,0,0,0,158
2280,KERALA,2003,18,ECONOMIC ISSUES,1,156,373,399,165,1094,1,26,41,37,21,126,0,0,0,0,0,0,1220
2826,KERALA,2003,18,EXAM FAILURE,7,28,0,0,0,35,6,47,0,0,0,53,0,0,0,0,0,0,88
3372,KERALA,2003,18,FAMILY PROBLEMS,10,227,449,497,263,1446,12,169,168,145,87,581,0,0,0,0,0,0,2027
3918,KERALA,2003,18,HEALTH ISSUES,2,103,219,286,370,980,1,66,89,98,152,406,0,0,0,0,0,0,1386
4464,KERALA,2003,18,HERO WORSHIP,0,0,0,0,0,0,0,0,0,0,0,0,0,0,0,0,0,0,0
5009,KERALA,2003,18,ILLEGITIMATE PREGNANCY,0,0,0,0,0,0,0,3,1,0,0,4,0,0,0,0,0,0,4
5554,KERALA,2003,18,LOVE AFFAIRS,0,34,10,1,0,45,0,40,14,1,0,55,0,0,0,0,0,0,100
6099,KERALA,2003,18,MARITAL ISSUES,0,8,21,9,5,43,0,30,23,9,1,63,0,0,0,0,0,0,106
6645,KERALA,2003,18,MENTAL HEALTH,0,182,272,284,172,910,0,133,121,118,70,442,0,0,0,0,0,0,1352
7191,KERALA,2003,18,OTHERS,12,216,280,361,233,1102,12,119,92,61,90,374,0,0,0,0,0,0,1476
7776,KERALA,2003,18,"PHYSICAL ABUSE (RAPE,INCEST ETC.)",0,0,0,0,0,0,0,0,0,0,0,0,0,0,0,0,0,0,0
8282,KERALA,2003,18,SOCIETAL ISSUES,0,12,34,17,15,78,0,8,3,2,1,14,0,0,0,0,0,0,92
135,KERALA,2004,18,CAUSES NOT KNOWN,7,167,274,279,182,909,5,77,73,66,59,280,0,0,0,0,0,0,1189
681,KERALA,2004,18,DEATH OF DEAR PERSON,1,10,15,13,15,54,1,9,13,5,8,36,0,0,0,0,0,0,90
1227,KERALA,2004,18,DOWRY DISPUTE,0,0,0,0,0,0,0,4,8,3,0,15,0,0,0,0,0,0,15
1773,KERALA,2004,18,DRUG ABUSE,0,19,28,27,6,80,0,0,0,0,0,0,0,0,0,0,0,0,80
2319,KERALA,2004,18,ECONOMIC ISSUES,1,178,339,353,118,989,1,38,73,28,12,152,0,0,0,0,0,0,1141
2865,KERALA,2004,18,EXAM FAILURE,8,24,0,0,0,32,5,34,0,0,0,39,0,0,0,0,0,0,71
3411,KERALA,2004,18,FAMILY PROBLEMS,13,234,578,446,211,1482,17,183,174,99,73,546,0,0,0,0,0,0,2028
3957,KERALA,2004,18,HEALTH ISSUES,2,64,196,334,400,996,7,52,71,143,171,444,0,0,0,0,0,0,1440
4503,KERALA,2004,18,HERO WORSHIP,0,0,0,0,0,0,0,2,0,0,0,2,0,0,0,0,0,0,2
5048,KERALA,2004,18,ILLEGITIMATE PREGNANCY,0,0,0,0,0,0,0,4,1,1,0,6,0,0,0,0,0,0,6
5593,KERALA,2004,18,LOVE AFFAIRS,0,35,10,0,0,45,0,44,1,0,0,45,0,0,0,0,0,0,90
6138,KERALA,2004,18,MARITAL ISSUES,0,3,19,7,5,34,0,39,29,7,1,76,0,0,0,0,0,0,110
6684,KERALA,2004,18,MENTAL HEALTH,6,194,296,314,161,971,7,90,124,112,77,410,0,0,0,0,0,0,1381
7230,KERALA,2004,18,OTHERS,10,179,310,328,168,995,10,147,87,72,82,398,0,0,0,0,0,0,1393
7815,KERALA,2004,18,"PHYSICAL ABUSE (RAPE,INCEST ETC.)",0,0,0,0,0,0,0,3,0,0,0,3,0,0,0,0,0,0,3
8321,KERALA,2004,18,SOCIETAL ISSUES,0,0,2,9,0,11,0,3,0,0,0,3,0,0,0,0,0,0,14
174,KERALA,2005,18,CAUSES NOT KNOWN,3,109,198,195,147,652,5,65,46,46,38,200,0,0,0,0,0,0,852
720,KERALA,2005,18,DEATH OF DEAR PERSON,1,13,14,13,14,55,1,6,9,15,8,39,0,0,0,0,0,0,94
1266,KERALA,2005,18,DOWRY DISPUTE,0,0,0,0,0,0,0,9,8,0,0,17,0,0,0,0,0,0,17
1812,KERALA,2005,18,DRUG ABUSE,0,21,20,19,3,63,0,0,0,0,0,0,0,0,0,0,0,0,63
2358,KERALA,2005,18,ECONOMIC ISSUES,1,122,301,398,89,911,1,21,37,41,14,114,0,0,0,0,0,0,1025
2904,KERALA,2005,18,EXAM FAILURE,10,28,0,0,0,38,13,18,0,0,0,31,0,0,0,0,0,0,69
3450,KERALA,2005,18,FAMILY PROBLEMS,14,372,708,619,269,1982,13,208,190,168,88,667,0,0,0,0,0,0,2649
3996,KERALA,2005,18,HEALTH ISSUES,2,69,170,306,387,934,2,54,74,100,182,412,0,0,0,0,0,0,1346
4542,KERALA,2005,18,HERO WORSHIP,2,10,28,24,18,82,1,10,10,5,4,30,0,0,0,0,0,0,112
5087,KERALA,2005,18,ILLEGITIMATE PREGNANCY,0,0,0,0,0,0,0,0,1,0,0,1,0,0,0,0,0,0,1
5632,KERALA,2005,18,LOVE AFFAIRS,0,27,9,1,0,37,1,39,4,0,0,44,0,0,0,0,0,0,81
6177,KERALA,2005,18,MARITAL ISSUES,2,6,18,23,4,53,0,36,21,5,1,63,0,0,0,0,0,0,116
6723,KERALA,2005,18,MENTAL HEALTH,0,197,291,305,136,929,4,113,128,131,90,466,0,0,0,0,0,0,1395
7269,KERALA,2005,18,OTHERS,11,264,360,298,151,1084,9,111,104,63,40,327,0,0,0,0,0,0,1411
7854,KERALA,2005,18,"PHYSICAL ABUSE (RAPE,INCEST ETC.)",0,0,0,0,0,0,0,0,0,0,1,1,0,0,0,0,0,0,1
8360,KERALA,2005,18,SOCIETAL ISSUES,0,0,2,6,2,10,0,0,0,2,0,2,0,0,0,0,0,0,12
213,KERALA,2006,18,CAUSES NOT KNOWN,9,101,149,121,88,468,4,42,35,37,26,144,0,0,0,0,0,0,612
759,KERALA,2006,18,DEATH OF DEAR PERSON,1,10,11,13,12,47,2,5,6,6,7,26,0,0,0,0,0,0,73
1305,KERALA,2006,18,DOWRY DISPUTE,0,0,0,1,0,1,0,6,11,1,0,18,0,0,0,0,0,0,19
1851,KERALA,2006,18,DRUG ABUSE,0,23,49,26,13,111,3,3,0,0,0,6,0,0,0,0,0,0,117
2397,KERALA,2006,18,ECONOMIC ISSUES,1,56,191,328,86,662,2,18,30,28,6,84,0,0,0,0,0,0,746
2943,KERALA,2006,18,EXAM FAILURE,5,17,0,0,0,22,15,23,0,0,0,38,0,0,0,0,0,0,60
3489,KERALA,2006,18,FAMILY PROBLEMS,20,435,819,802,391,2467,24,271,257,246,153,951,0,0,0,0,0,0,3418
4035,KERALA,2006,18,HEALTH ISSUES,2,61,170,339,398,970,1,61,70,120,141,393,0,0,0,0,0,0,1363
6216,KERALA,2006,18,MARITAL ISSUES,0,9,22,22,5,58,0,24,19,2,0,45,0,0,0,0,0,0,103
6762,KERALA,2006,18,MENTAL HEALTH,2,190,338,323,169,1022,0,124,148,120,97,489,0,0,0,0,0,0,1511
7308,KERALA,2006,18,OTHERS,13,106,157,176,101,553,6,55,47,31,27,166,0,0,0,0,0,0,719
8399,KERALA,2006,18,SOCIETAL ISSUES,1,11,25,8,8,53,2,10,8,5,1,26,0,0,0,0,0,0,79
252,KERALA,2007,18,CAUSES NOT KNOWN,5,138,191,183,81,598,3,70,66,36,33,208,0,0,0,0,0,0,806
798,KERALA,2007,18,DEATH OF DEAR PERSON,0,8,18,24,15,65,0,3,7,11,8,29,0,0,0,0,0,0,94
1344,KERALA,2007,18,DOWRY DISPUTE,0,0,0,0,0,0,0,16,6,0,0,22,0,0,0,0,0,0,22
1890,KERALA,2007,18,DRUG ABUSE,0,24,61,44,7,136,0,0,0,1,0,1,0,0,0,0,0,0,137
2436,KERALA,2007,18,ECONOMIC ISSUES,0,86,248,352,75,761,0,16,29,36,10,91,0,0,0,0,0,0,852
2982,KERALA,2007,18,EXAM FAILURE,7,17,0,0,0,24,7,16,0,0,0,23,0,0,0,0,0,0,47
3528,KERALA,2007,18,FAMILY PROBLEMS,32,522,959,906,403,2822,25,265,295,265,115,965,0,0,0,0,0,0,3787
4074,KERALA,2007,18,HEALTH ISSUES,1,69,184,394,353,1001,0,44,88,158,148,438,0,0,0,0,0,0,1439
4619,KERALA,2007,18,HERO WORSHIP,0,0,0,0,0,0,0,0,0,0,0,0,0,0,0,0,0,0,0
5164,KERALA,2007,18,ILLEGITIMATE PREGNANCY,0,0,0,0,0,0,0,4,0,0,0,4,0,0,0,0,0,0,4
5709,KERALA,2007,18,LOVE AFFAIRS,0,29,6,0,0,35,2,41,3,0,0,46,0,0,0,0,0,0,81
6255,KERALA,2007,18,MARITAL ISSUES,0,4,17,10,0,31,0,23,23,3,1,50,0,0,0,0,0,0,81
6801,KERALA,2007,18,MENTAL HEALTH,2,165,335,306,142,950,5,95,146,122,66,434,0,0,0,0,0,0,1384
7347,KERALA,2007,18,OTHERS,1,32,33,39,25,130,1,15,13,12,11,52,0,0,0,0,0,0,182
7931,KERALA,2007,18,"PHYSICAL ABUSE (RAPE,INCEST ETC.)",0,0,0,0,0,0,0,1,0,0,0,1,0,0,0,0,0,0,1
8438,KERALA,2007,18,SOCIETAL ISSUES,0,3,17,15,0,35,0,1,5,3,1,10,0,0,0,0,0,0,45
291,KERALA,2008,18,CAUSES NOT KNOWN,4,98,139,119,75,435,6,45,49,46,20,166,0,0,0,0,0,0,601
837,KERALA,2008,18,DEATH OF DEAR PERSON,1,9,18,17,18,63,0,8,12,8,10,38,0,0,0,0,0,0,101
1383,KERALA,2008,18,DOWRY DISPUTE,0,0,0,0,0,0,1,26,5,0,0,32,0,0,0,0,0,0,32
1929,KERALA,2008,18,DRUG ABUSE,0,25,94,88,28,235,0,0,0,0,0,0,0,0,0,0,0,0,235
2475,KERALA,2008,18,ECONOMIC ISSUES,0,33,215,261,70,579,0,10,26,33,8,77,0,0,0,0,0,0,656
3021,KERALA,2008,18,EXAM FAILURE,5,16,0,0,0,21,8,18,0,0,0,26,0,0,0,0,0,0,47
3567,KERALA,2008,18,FAMILY PROBLEMS,10,534,996,764,359,2663,22,319,319,264,150,1074,0,0,0,0,0,0,3737
4113,KERALA,2008,18,HEALTH ISSUES,0,68,211,396,326,1001,2,55,103,139,124,423,0,0,0,0,0,0,1424
4658,KERALA,2008,18,HERO WORSHIP,0,0,0,0,0,0,0,0,0,0,0,0,0,0,0,0,0,0,0
5203,KERALA,2008,18,ILLEGITIMATE PREGNANCY,0,0,0,0,0,0,0,4,0,0,0,4,0,0,0,0,0,0,4
5748,KERALA,2008,18,LOVE AFFAIRS,0,46,7,1,0,54,0,59,4,0,0,63,0,0,0,0,0,0,117
6294,KERALA,2008,18,MARITAL ISSUES,0,2,28,18,0,48,0,25,28,9,1,63,0,0,0,0,0,0,111
6840,KERALA,2008,18,MENTAL HEALTH,0,167,293,288,144,892,1,89,131,124,78,423,0,0,0,0,0,0,1315
7386,KERALA,2008,18,OTHERS,6,17,31,32,16,102,1,7,8,8,11,35,0,0,0,0,0,0,137
7970,KERALA,2008,18,"PHYSICAL ABUSE (RAPE,INCEST ETC.)",0,1,0,0,0,1,1,1,0,0,0,2,0,0,0,0,0,0,3
8477,KERALA,2008,18,SOCIETAL ISSUES,0,0,16,17,3,36,0,0,7,6,0,13,0,0,0,0,0,0,49
330,KERALA,2009,18,CAUSES NOT KNOWN,8,99,151,106,72,436,5,56,38,36,50,185,0,0,0,0,0,0,621
876,KERALA,2009,18,DEATH OF DEAR PERSON,0,11,26,13,13,63,1,13,17,11,4,46,0,0,0,0,0,0,109
1422,KERALA,2009,18,DOWRY DISPUTE,0,0,0,0,0,0,0,16,4,0,0,20,0,0,0,0,0,0,20
1968,KERALA,2009,18,DRUG ABUSE,0,44,102,87,27,260,0,0,0,0,0,0,0,0,0,0,0,0,260
2514,KERALA,2009,18,ECONOMIC ISSUES,0,48,218,271,76,613,1,16,24,24,6,71,0,0,0,0,0,0,684
3060,KERALA,2009,18,EXAM FAILURE,6,18,0,0,0,24,2,20,0,0,0,22,0,0,0,0,0,0,46
3606,KERALA,2009,18,FAMILY PROBLEMS,16,598,890,725,345,2574,11,328,230,254,119,942,0,0,0,0,0,0,3516
4152,KERALA,2009,18,HEALTH ISSUES,2,103,201,409,362,1077,1,52,102,143,162,460,0,0,0,0,0,0,1537
4697,KERALA,2009,18,HERO WORSHIP,0,0,0,0,0,0,0,0,1,0,0,1,0,0,0,0,0,0,1
5242,KERALA,2009,18,ILLEGITIMATE PREGNANCY,0,0,0,0,0,0,0,3,0,0,0,3,0,0,0,0,0,0,3
5787,KERALA,2009,18,LOVE AFFAIRS,0,54,11,0,0,65,1,49,3,1,0,54,0,0,0,0,0,0,119
6333,KERALA,2009,18,MARITAL ISSUES,0,13,26,12,3,54,0,30,23,4,2,59,0,0,0,0,0,0,113
6879,KERALA,2009,18,MENTAL HEALTH,4,173,291,349,148,965,4,94,139,131,92,460,0,0,0,0,0,0,1425
7425,KERALA,2009,18,OTHERS,2,27,45,40,22,136,1,23,11,13,7,55,0,0,0,0,0,0,191
8009,KERALA,2009,18,"PHYSICAL ABUSE (RAPE,INCEST ETC.)",0,0,0,0,0,0,0,1,0,0,0,1,0,0,0,0,0,0,1
8516,KERALA,2009,18,SOCIETAL ISSUES,0,3,18,30,4,55,3,4,24,16,7,54,0,0,0,0,0,0,109
369,KERALA,2010,18,CAUSES NOT KNOWN,8,120,160,129,75,492,4,57,46,37,27,171,0,0,0,0,0,0,663
915,KERALA,2010,18,DEATH OF DEAR PERSON,0,7,23,24,21,75,1,7,10,9,12,39,0,0,0,0,0,0,114
1461,KERALA,2010,18,DOWRY DISPUTE,0,0,0,0,0,0,0,16,4,1,0,21,0,0,0,0,0,0,21
2007,KERALA,2010,18,DRUG ABUSE,0,45,107,106,30,288,0,1,0,0,0,1,0,0,0,0,0,0,289
2553,KERALA,2010,18,ECONOMIC ISSUES,2,53,187,236,55,533,0,8,20,26,6,60,0,0,0,0,0,0,593
3099,KERALA,2010,18,EXAM FAILURE,9,18,3,0,0,30,8,18,0,0,0,26,0,0,0,0,0,0,56
3645,KERALA,2010,18,FAMILY PROBLEMS,36,446,950,877,347,2656,27,258,277,226,130,918,0,0,0,0,0,0,3574
4191,KERALA,2010,18,HEALTH ISSUES,2,65,178,389,352,986,1,21,82,123,135,362,0,0,0,0,0,0,1348
4736,KERALA,2010,18,HERO WORSHIP,0,0,0,0,0,0,0,0,0,0,0,0,0,0,0,0,0,0,0
5281,KERALA,2010,18,ILLEGITIMATE PREGNANCY,0,0,0,0,0,0,0,4,0,0,0,4,0,0,0,0,0,0,4
5826,KERALA,2010,18,LOVE AFFAIRS,0,48,11,0,0,59,1,65,15,0,0,81,0,0,0,0,0,0,140
6372,KERALA,2010,18,MARITAL ISSUES,0,12,26,21,4,63,0,20,20,7,2,49,0,0,0,0,0,0,112
6918,KERALA,2010,18,MENTAL HEALTH,1,175,246,290,169,881,2,101,111,89,86,389,0,0,0,0,0,0,1270
7464,KERALA,2010,18,OTHERS,5,47,74,76,41,243,2,29,32,20,18,101,0,0,0,0,0,0,344
8048,KERALA,2010,18,"PHYSICAL ABUSE (RAPE,INCEST ETC.)",0,0,0,0,0,0,0,3,1,0,0,4,0,0,0,0,0,0,4
8555,KERALA,2010,18,SOCIETAL ISSUES,1,4,8,23,4,40,0,0,8,6,0,14,0,0,0,0,0,0,54
408,KERALA,2011,18,CAUSES NOT KNOWN,4,123,227,176,79,609,10,62,75,48,30,225,0,0,0,0,0,0,834
954,KERALA,2011,18,DEATH OF DEAR PERSON,0,5,10,20,15,50,1,6,5,9,7,28,0,0,0,0,0,0,78
1500,KERALA,2011,18,DOWRY DISPUTE,0,1,0,0,0,1,0,7,6,1,0,14,0,0,0,0,0,0,15
2046,KERALA,2011,18,DRUG ABUSE,0,33,80,94,28,235,0,0,0,0,0,0,0,0,0,0,0,0,235
2592,KERALA,2011,18,ECONOMIC ISSUES,0,39,133,180,47,399,1,4,20,29,7,61,0,0,0,0,0,0,460
3138,KERALA,2011,18,EXAM FAILURE,4,6,0,0,0,10,2,20,0,0,0,22,0,0,0,0,0,0,32
3684,KERALA,2011,18,FAMILY PROBLEMS,15,467,875,948,455,2760,17,308,324,223,128,1000,0,0,0,0,0,0,3760
4230,KERALA,2011,18,HEALTH ISSUES,0,48,179,350,321,898,0,32,60,106,140,338,0,0,0,0,0,0,1236
4775,KERALA,2011,18,HERO WORSHIP,0,0,0,0,0,0,0,0,0,0,0,0,0,0,0,0,0,0,0
5320,KERALA,2011,18,ILLEGITIMATE PREGNANCY,0,0,0,0,0,0,0,2,0,0,0,2,0,0,0,0,0,0,2
5865,KERALA,2011,18,LOVE AFFAIRS,0,39,7,1,0,47,0,33,2,0,0,35,0,0,0,0,0,0,82
6411,KERALA,2011,18,MARITAL ISSUES,0,4,37,50,2,93,0,18,17,2,0,37,0,0,0,0,0,0,130
6957,KERALA,2011,18,MENTAL HEALTH,0,99,248,267,130,744,2,68,113,104,63,350,0,0,0,0,0,0,1094
7503,KERALA,2011,18,OTHERS,5,62,95,103,68,333,3,27,31,18,15,94,0,0,0,0,0,0,427
8087,KERALA,2011,18,"PHYSICAL ABUSE (RAPE,INCEST ETC.)",0,0,0,0,0,0,0,0,0,0,0,0,0,0,0,0,0,0,0
8594,KERALA,2011,18,SOCIETAL ISSUES,1,1,9,20,2,33,0,1,7,5,0,13,0,0,0,0,0,0,46
447,KERALA,2012,18,CAUSES NOT KNOWN,8,159,237,254,134,792,4,85,55,74,58,276,0,0,0,0,0,0,1068
993,KERALA,2012,18,DEATH OF DEAR PERSON,0,5,16,18,13,52,1,10,8,8,13,40,0,0,0,0,0,0,92
1539,KERALA,2012,18,DOWRY DISPUTE,0,0,4,2,0,6,1,24,2,0,0,27,0,0,0,0,0,0,33
2085,KERALA,2012,18,DRUG ABUSE,0,34,83,106,52,275,0,0,0,0,0,0,0,0,0,0,0,0,275
2631,KERALA,2012,18,ECONOMIC ISSUES,0,33,125,144,44,346,1,2,13,19,3,38,0,0,0,0,0,0,384
3177,KERALA,2012,18,EXAM FAILURE,3,7,1,0,0,11,5,21,0,0,0,26,0,0,0,0,0,0,37
3723,KERALA,2012,18,FAMILY PROBLEMS,18,412,967,1039,444,2880,14,239,245,232,133,863,0,0,0,0,0,0,3743
4269,KERALA,2012,18,HEALTH ISSUES,1,44,168,265,315,793,0,22,54,80,99,255,0,0,0,0,0,0,1048
4814,KERALA,2012,18,HERO WORSHIP,0,0,0,0,0,0,0,0,0,0,0,0,0,0,0,0,0,0,0
5359,KERALA,2012,18,ILLEGITIMATE PREGNANCY,0,0,0,0,0,0,0,4,1,0,0,5,0,0,0,0,0,0,5
5904,KERALA,2012,18,LOVE AFFAIRS,0,49,8,0,0,57,0,47,4,0,0,51,0,0,0,0,0,0,108
6450,KERALA,2012,18,MARITAL ISSUES,0,4,35,21,4,64,0,18,24,11,1,54,0,0,0,0,0,0,118
6996,KERALA,2012,18,MENTAL HEALTH,1,118,234,292,195,840,1,72,91,108,70,342,0,0,0,0,0,0,1182
7542,KERALA,2012,18,OTHERS,0,54,84,77,43,258,3,30,16,18,14,81,0,0,0,0,0,0,339
8126,KERALA,2012,18,"PHYSICAL ABUSE (RAPE,INCEST ETC.)",0,0,0,0,0,0,0,0,8,2,0,10,0,0,0,0,0,0,10
8633,KERALA,2012,18,SOCIETAL ISSUES,0,2,14,17,2,35,0,0,9,4,0,13,0,0,0,0,0,0,48
486,KERALA,2013,18,CAUSES NOT KNOWN,4,93,162,168,90,517,4,36,43,42,34,159,0,0,0,0,0,0,676
1032,KERALA,2013,18,DEATH OF DEAR PERSON,1,9,14,23,22,69,0,13,11,18,16,58,0,0,0,0,0,0,127
1578,KERALA,2013,18,DOWRY DISPUTE,0,0,0,0,0,0,0,20,5,0,0,25,0,0,0,0,0,0,25
2124,KERALA,2013,18,DRUG ABUSE,0,40,151,155,54,400,0,0,0,0,0,0,0,0,0,0,0,0,400
2670,KERALA,2013,18,ECONOMIC ISSUES,1,79,176,196,64,516,0,9,23,14,10,56,0,0,0,0,0,0,572
3216,KERALA,2013,18,EXAM FAILURE,6,13,0,0,0,19,7,13,0,0,0,20,0,0,0,0,0,0,39
3762,KERALA,2013,18,FAMILY PROBLEMS,21,649,1157,1089,615,3531,26,269,246,255,194,990,0,0,0,0,0,0,4521
4308,KERALA,2013,18,HEALTH ISSUES,0,52,183,332,286,853,1,22,53,63,120,259,0,0,0,0,0,0,1112
4853,KERALA,2013,18,HERO WORSHIP,0,0,0,0,0,0,0,0,0,0,0,0,0,0,0,0,0,0,0
5398,KERALA,2013,18,ILLEGITIMATE PREGNANCY,0,0,0,0,0,0,0,4,2,0,0,6,0,0,0,0,0,0,6
5943,KERALA,2013,18,LOVE AFFAIRS,0,61,9,0,0,70,1,46,4,0,0,51,0,0,0,0,0,0,121
6489,KERALA,2013,18,MARITAL ISSUES,0,12,27,20,4,63,0,21,21,7,2,51,0,0,0,0,0,0,114
7035,KERALA,2013,18,MENTAL HEALTH,2,67,131,138,102,440,2,37,51,49,35,174,0,0,0,0,0,0,614
7581,KERALA,2013,18,OTHERS,3,46,50,51,31,181,2,29,22,11,13,77,0,0,0,0,0,0,258
8165,KERALA,2013,18,"PHYSICAL ABUSE (RAPE,INCEST ETC.)",0,0,0,0,0,0,0,4,2,0,0,6,0,0,0,0,0,0,6
8672,KERALA,2013,18,SOCIETAL ISSUES,0,3,13,20,6,42,0,1,8,4,0,13,0,0,0,0,0,0,55
525,KERALA,2014,18,CAUSES NOT KNOWN,5,112,127,138,73,455,5,52,27,24,14,122,0,0,0,0,0,0,577
1071,KERALA,2014,18,DEATH OF DEAR PERSON,1,11,12,26,19,69,0,12,8,15,11,46,0,0,0,0,0,0,115
1617,KERALA,2014,18,DOWRY DISPUTE,0,0,0,0,0,0,0,15,3,2,0,20,0,0,0,0,0,0,20
2163,KERALA,2014,18,DRUG ABUSE,0,95,163,163,52,473,0,1,0,1,0,2,0,0,0,0,0,0,475
2709,KERALA,2014,18,ECONOMIC ISSUES,1,49,106,103,30,289,1,11,16,9,3,40,0,0,0,0,0,0,329
3255,KERALA,2014,18,EXAM FAILURE,3,27,1,0,0,31,2,28,0,0,0,30,0,0,0,0,0,0,61
3801,KERALA,2014,18,FAMILY PROBLEMS,13,365,785,756,466,2385,10,235,231,164,124,764,0,0,0,0,0,0,3149
4347,KERALA,2014,18,HEALTH ISSUES,0,245,509,843,954,2551,0,100,150,275,411,936,0,0,0,0,0,0,3487
4892,KERALA,2014,18,HERO WORSHIP,0,0,0,0,0,0,0,2,0,0,0,2,0,0,0,0,0,0,2
5437,KERALA,2014,18,ILLEGITIMATE PREGNANCY,0,0,0,0,0,0,0,1,0,0,0,1,0,0,0,0,0,0,1
5982,KERALA,2014,18,LOVE AFFAIRS,0,56,9,1,0,66,2,77,2,0,0,81,0,0,0,0,0,0,147
6528,KERALA,2014,18,MARITAL ISSUES,0,16,51,42,2,111,0,55,40,3,0,98,0,0,0,0,0,0,209
7074,KERALA,2014,18,MENTAL HEALTH,0,109,155,179,100,543,0,50,52,59,59,220,0,0,0,0,0,0,763
7620,KERALA,2014,18,OTHERS,7,222,357,261,157,1004,3,119,78,51,46,297,0,0,0,0,0,0,1301
7659,KERALA,2014,18,PHYSICAL ABUSE,0,0,0,1,0,1,0,0,0,0,0,0,0,0,0,0,0,0,1
8711,KERALA,2014,18,SOCIETAL ISSUES,0,5,14,14,7,40,0,4,5,1,2,12,0,0,0,0,0,0,52
19,LAKSHADWEEP,2001,19,CAUSES NOT KNOWN,0,0,0,0,0,0,0,0,0,0,0,0,0,0,0,0,0,0,0
565,LAKSHADWEEP,2001,19,DEATH OF DEAR PERSON,0,0,0,0,0,0,0,0,0,0,0,0,0,0,0,0,0,0,0
1111,LAKSHADWEEP,2001,19,DOWRY DISPUTE,0,0,0,0,0,0,0,0,0,0,0,0,0,0,0,0,0,0,0
1657,LAKSHADWEEP,2001,19,DRUG ABUSE,0,0,0,0,0,0,0,0,0,0,0,0,0,0,0,0,0,0,0
2203,LAKSHADWEEP,2001,19,ECONOMIC ISSUES,0,0,0,0,0,0,0,0,0,0,0,0,0,0,0,0,0,0,0
2749,LAKSHADWEEP,2001,19,EXAM FAILURE,0,0,0,0,0,0,0,0,0,0,0,0,0,0,0,0,0,0,0
3295,LAKSHADWEEP,2001,19,FAMILY PROBLEMS,0,0,0,0,0,0,0,0,0,0,0,0,0,0,0,0,0,0,0
3841,LAKSHADWEEP,2001,19,HEALTH ISSUES,0,0,0,0,0,0,0,0,0,0,0,0,0,0,0,0,0,0,0
4387,LAKSHADWEEP,2001,19,HERO WORSHIP,0,0,0,0,0,0,0,0,0,0,0,0,0,0,0,0,0,0,0
4932,LAKSHADWEEP,2001,19,ILLEGITIMATE PREGNANCY,0,0,0,0,0,0,0,0,0,0,0,0,0,0,0,0,0,0,0
5477,LAKSHADWEEP,2001,19,LOVE AFFAIRS,0,0,0,0,0,0,0,0,0,0,0,0,0,0,0,0,0,0,0
6022,LAKSHADWEEP,2001,19,MARITAL ISSUES,0,0,0,0,0,0,0,0,0,0,0,0,0,0,0,0,0,0,0
6568,LAKSHADWEEP,2001,19,MENTAL HEALTH,0,0,0,0,0,0,0,0,0,0,0,0,0,0,0,0,0,0,0
7114,LAKSHADWEEP,2001,19,OTHERS,0,0,0,0,0,0,0,0,0,0,0,0,0,0,0,0,0,0,0
7699,LAKSHADWEEP,2001,19,"PHYSICAL ABUSE (RAPE,INCEST ETC.)",0,0,0,0,0,0,0,0,0,0,0,0,0,0,0,0,0,0,0
8205,LAKSHADWEEP,2001,19,SOCIETAL ISSUES,0,0,0,0,0,0,0,0,0,0,0,0,0,0,0,0,0,0,0
58,LAKSHADWEEP,2002,19,CAUSES NOT KNOWN,0,0,0,0,0,0,0,0,0,0,0,0,0,0,0,0,0,0,0
604,LAKSHADWEEP,2002,19,DEATH OF DEAR PERSON,0,0,0,0,0,0,0,0,0,0,0,0,0,0,0,0,0,0,0
1150,LAKSHADWEEP,2002,19,DOWRY DISPUTE,0,0,0,0,0,0,0,0,0,0,0,0,0,0,0,0,0,0,0
1696,LAKSHADWEEP,2002,19,DRUG ABUSE,0,0,0,0,0,0,0,0,0,0,0,0,0,0,0,0,0,0,0
2242,LAKSHADWEEP,2002,19,ECONOMIC ISSUES,0,0,0,0,0,0,0,0,0,0,0,0,0,0,0,0,0,0,0
2788,LAKSHADWEEP,2002,19,EXAM FAILURE,0,0,0,0,0,0,0,0,0,0,0,0,0,0,0,0,0,0,0
3334,LAKSHADWEEP,2002,19,FAMILY PROBLEMS,0,0,0,0,0,0,0,0,0,0,0,0,0,0,0,0,0,0,0
3880,LAKSHADWEEP,2002,19,HEALTH ISSUES,0,0,0,0,0,0,0,0,0,0,0,0,0,0,0,0,0,0,0
4426,LAKSHADWEEP,2002,19,HERO WORSHIP,0,0,0,0,0,0,0,0,0,0,0,0,0,0,0,0,0,0,0
4971,LAKSHADWEEP,2002,19,ILLEGITIMATE PREGNANCY,0,0,0,0,0,0,0,0,0,0,0,0,0,0,0,0,0,0,0
5516,LAKSHADWEEP,2002,19,LOVE AFFAIRS,0,0,0,0,0,0,0,0,0,0,0,0,0,0,0,0,0,0,0
6061,LAKSHADWEEP,2002,19,MARITAL ISSUES,0,0,0,0,0,0,0,0,0,0,0,0,0,0,0,0,0,0,0
6607,LAKSHADWEEP,2002,19,MENTAL HEALTH,0,0,0,0,0,0,0,0,0,0,0,0,0,0,0,0,0,0,0
7153,LAKSHADWEEP,2002,19,OTHERS,0,0,0,0,0,0,0,0,0,0,0,0,0,0,0,0,0,0,0
7738,LAKSHADWEEP,2002,19,"PHYSICAL ABUSE (RAPE,INCEST ETC.)",0,0,0,0,0,0,0,0,0,0,0,0,0,0,0,0,0,0,0
8244,LAKSHADWEEP,2002,19,SOCIETAL ISSUES,0,0,0,0,0,0,0,0,0,0,0,0,0,0,0,0,0,0,0
97,LAKSHADWEEP,2003,19,CAUSES NOT KNOWN,0,0,0,0,0,0,0,0,0,0,0,0,0,0,0,0,0,0,0
643,LAKSHADWEEP,2003,19,DEATH OF DEAR PERSON,0,0,0,0,0,0,0,0,0,0,0,0,0,0,0,0,0,0,0
1189,LAKSHADWEEP,2003,19,DOWRY DISPUTE,0,0,0,0,0,0,0,0,0,0,0,0,0,0,0,0,0,0,0
1735,LAKSHADWEEP,2003,19,DRUG ABUSE,0,0,0,0,0,0,0,0,0,0,0,0,0,0,0,0,0,0,0
2281,LAKSHADWEEP,2003,19,ECONOMIC ISSUES,0,0,0,0,0,0,0,0,0,0,0,0,0,0,0,0,0,0,0
2827,LAKSHADWEEP,2003,19,EXAM FAILURE,0,0,0,0,0,0,0,0,0,0,0,0,0,0,0,0,0,0,0
3373,LAKSHADWEEP,2003,19,FAMILY PROBLEMS,0,0,0,0,0,0,0,1,0,0,0,1,0,0,0,0,0,0,1
3919,LAKSHADWEEP,2003,19,HEALTH ISSUES,0,0,0,0,1,1,0,0,0,0,0,0,0,0,0,0,0,0,1
4465,LAKSHADWEEP,2003,19,HERO WORSHIP,0,0,0,0,0,0,0,0,0,0,0,0,0,0,0,0,0,0,0
5010,LAKSHADWEEP,2003,19,ILLEGITIMATE PREGNANCY,0,0,0,0,0,0,0,0,0,0,0,0,0,0,0,0,0,0,0
5555,LAKSHADWEEP,2003,19,LOVE AFFAIRS,0,0,0,0,0,0,0,0,0,0,0,0,0,0,0,0,0,0,0
6100,LAKSHADWEEP,2003,19,MARITAL ISSUES,0,0,0,0,0,0,0,0,0,0,0,0,0,0,0,0,0,0,0
6646,LAKSHADWEEP,2003,19,MENTAL HEALTH,0,0,0,0,0,0,0,0,0,0,0,0,0,0,0,0,0,0,0
7192,LAKSHADWEEP,2003,19,OTHERS,0,0,0,0,0,0,0,0,0,0,0,0,0,0,0,0,0,0,0
7777,LAKSHADWEEP,2003,19,"PHYSICAL ABUSE (RAPE,INCEST ETC.)",0,0,0,0,0,0,0,0,0,0,0,0,0,0,0,0,0,0,0
8283,LAKSHADWEEP,2003,19,SOCIETAL ISSUES,0,0,0,0,0,0,0,0,0,0,0,0,0,0,0,0,0,0,0
136,LAKSHADWEEP,2004,19,CAUSES NOT KNOWN,0,0,0,0,0,0,0,0,0,0,0,0,0,0,0,0,0,0,0
682,LAKSHADWEEP,2004,19,DEATH OF DEAR PERSON,0,0,0,0,0,0,0,0,0,0,0,0,0,0,0,0,0,0,0
1228,LAKSHADWEEP,2004,19,DOWRY DISPUTE,0,0,0,0,0,0,0,0,0,0,0,0,0,0,0,0,0,0,0
1774,LAKSHADWEEP,2004,19,DRUG ABUSE,0,0,0,0,0,0,0,0,0,0,0,0,0,0,0,0,0,0,0
2320,LAKSHADWEEP,2004,19,ECONOMIC ISSUES,0,0,0,0,0,0,0,0,0,0,0,0,0,0,0,0,0,0,0
2866,LAKSHADWEEP,2004,19,EXAM FAILURE,0,0,0,0,0,0,0,0,0,0,0,0,0,0,0,0,0,0,0
3412,LAKSHADWEEP,2004,19,FAMILY PROBLEMS,0,0,0,0,0,0,0,0,0,0,0,0,0,0,0,0,0,0,0
3958,LAKSHADWEEP,2004,19,HEALTH ISSUES,0,0,0,0,0,0,0,0,0,0,0,0,0,0,0,0,0,0,0
4504,LAKSHADWEEP,2004,19,HERO WORSHIP,0,0,0,0,0,0,0,0,0,0,0,0,0,0,0,0,0,0,0
5049,LAKSHADWEEP,2004,19,ILLEGITIMATE PREGNANCY,0,0,0,0,0,0,0,0,0,0,0,0,0,0,0,0,0,0,0
5594,LAKSHADWEEP,2004,19,LOVE AFFAIRS,0,0,0,0,0,0,0,0,0,0,0,0,0,0,0,0,0,0,0
6139,LAKSHADWEEP,2004,19,MARITAL ISSUES,0,0,0,0,0,0,0,0,0,0,0,0,0,0,0,0,0,0,0
6685,LAKSHADWEEP,2004,19,MENTAL HEALTH,0,0,0,0,0,0,0,0,0,0,0,0,0,0,0,0,0,0,0
7231,LAKSHADWEEP,2004,19,OTHERS,0,0,0,0,0,0,0,0,0,0,0,0,0,0,0,0,0,0,0
7816,LAKSHADWEEP,2004,19,"PHYSICAL ABUSE (RAPE,INCEST ETC.)",0,0,0,0,0,0,0,0,0,0,0,0,0,0,0,0,0,0,0
8322,LAKSHADWEEP,2004,19,SOCIETAL ISSUES,0,0,0,0,0,0,0,0,0,0,0,0,0,0,0,0,0,0,0
175,LAKSHADWEEP,2005,19,CAUSES NOT KNOWN,0,0,0,0,0,0,0,0,0,0,0,0,0,0,0,0,0,0,0
721,LAKSHADWEEP,2005,19,DEATH OF DEAR PERSON,0,0,0,0,0,0,0,0,0,0,0,0,0,0,0,0,0,0,0
1267,LAKSHADWEEP,2005,19,DOWRY DISPUTE,0,0,0,0,0,0,0,0,0,0,0,0,0,0,0,0,0,0,0
1813,LAKSHADWEEP,2005,19,DRUG ABUSE,0,0,0,0,0,0,0,0,0,0,0,0,0,0,0,0,0,0,0
2359,LAKSHADWEEP,2005,19,ECONOMIC ISSUES,0,0,0,0,0,0,0,0,0,0,0,0,0,0,0,0,0,0,0
2905,LAKSHADWEEP,2005,19,EXAM FAILURE,0,0,0,0,0,0,0,0,0,0,0,0,0,0,0,0,0,0,0
3451,LAKSHADWEEP,2005,19,FAMILY PROBLEMS,0,0,0,0,0,0,0,0,0,0,0,0,0,0,0,0,0,0,0
3997,LAKSHADWEEP,2005,19,HEALTH ISSUES,0,0,0,0,0,0,0,0,0,0,0,0,0,0,0,0,0,0,0
4543,LAKSHADWEEP,2005,19,HERO WORSHIP,0,0,0,0,0,0,0,0,0,0,0,0,0,0,0,0,0,0,0
5088,LAKSHADWEEP,2005,19,ILLEGITIMATE PREGNANCY,0,0,0,0,0,0,0,0,0,0,0,0,0,0,0,0,0,0,0
5633,LAKSHADWEEP,2005,19,LOVE AFFAIRS,0,0,0,0,0,0,0,0,0,0,0,0,0,0,0,0,0,0,0
6178,LAKSHADWEEP,2005,19,MARITAL ISSUES,0,0,0,0,0,0,0,0,0,0,0,0,0,0,0,0,0,0,0
6724,LAKSHADWEEP,2005,19,MENTAL HEALTH,0,0,0,0,0,0,0,0,0,0,0,0,0,0,0,0,0,0,0
7270,LAKSHADWEEP,2005,19,OTHERS,0,0,0,0,0,0,0,0,0,0,0,0,0,0,0,0,0,0,0
7855,LAKSHADWEEP,2005,19,"PHYSICAL ABUSE (RAPE,INCEST ETC.)",0,0,0,0,0,0,0,0,0,0,0,0,0,0,0,0,0,0,0
8361,LAKSHADWEEP,2005,19,SOCIETAL ISSUES,0,0,0,0,0,0,0,0,0,0,0,0,0,0,0,0,0,0,0
214,LAKSHADWEEP,2006,19,CAUSES NOT KNOWN,0,0,0,0,0,0,0,0,0,0,0,0,0,0,0,0,0,0,0
760,LAKSHADWEEP,2006,19,DEATH OF DEAR PERSON,0,0,0,0,0,0,0,0,0,0,0,0,0,0,0,0,0,0,0
1306,LAKSHADWEEP,2006,19,DOWRY DISPUTE,0,0,0,0,0,0,0,0,0,0,0,0,0,0,0,0,0,0,0
1852,LAKSHADWEEP,2006,19,DRUG ABUSE,0,0,0,0,0,0,0,0,0,0,0,0,0,0,0,0,0,0,0
2398,LAKSHADWEEP,2006,19,ECONOMIC ISSUES,0,0,0,0,0,0,0,0,0,0,0,0,0,0,0,0,0,0,0
2944,LAKSHADWEEP,2006,19,EXAM FAILURE,0,0,0,0,0,0,0,0,0,0,0,0,0,0,0,0,0,0,0
3490,LAKSHADWEEP,2006,19,FAMILY PROBLEMS,0,0,0,0,0,0,0,0,0,0,0,0,0,0,0,0,0,0,0
4036,LAKSHADWEEP,2006,19,HEALTH ISSUES,0,0,0,0,0,0,0,0,0,0,0,0,0,0,0,0,0,0,0
4581,LAKSHADWEEP,2006,19,HERO WORSHIP,0,0,0,0,0,0,0,0,0,0,0,0,0,0,0,0,0,0,0
5126,LAKSHADWEEP,2006,19,ILLEGITIMATE PREGNANCY,0,0,0,0,0,0,0,0,0,0,0,0,0,0,0,0,0,0,0
5671,LAKSHADWEEP,2006,19,LOVE AFFAIRS,0,0,0,0,0,0,0,0,0,0,0,0,0,0,0,0,0,0,0
6217,LAKSHADWEEP,2006,19,MARITAL ISSUES,0,0,0,0,0,0,0,0,0,0,0,0,0,0,0,0,0,0,0
6763,LAKSHADWEEP,2006,19,MENTAL HEALTH,0,0,1,0,0,1,0,1,0,0,0,1,0,0,0,0,0,0,2
7309,LAKSHADWEEP,2006,19,OTHERS,0,0,0,0,0,0,0,0,0,0,0,0,0,0,0,0,0,0,0
7893,LAKSHADWEEP,2006,19,"PHYSICAL ABUSE (RAPE,INCEST ETC.)",0,0,0,0,0,0,0,0,0,0,0,0,0,0,0,0,0,0,0
8400,LAKSHADWEEP,2006,19,SOCIETAL ISSUES,0,0,0,0,0,0,0,0,0,0,0,0,0,0,0,0,0,0,0
253,LAKSHADWEEP,2007,19,CAUSES NOT KNOWN,0,0,1,0,0,1,0,0,0,2,0,2,0,0,0,0,0,0,3
799,LAKSHADWEEP,2007,19,DEATH OF DEAR PERSON,0,0,0,0,0,0,0,0,0,0,0,0,0,0,0,0,0,0,0
1345,LAKSHADWEEP,2007,19,DOWRY DISPUTE,0,0,0,0,0,0,0,0,0,0,0,0,0,0,0,0,0,0,0
1891,LAKSHADWEEP,2007,19,DRUG ABUSE,0,0,0,0,0,0,0,0,0,0,0,0,0,0,0,0,0,0,0
2437,LAKSHADWEEP,2007,19,ECONOMIC ISSUES,0,0,0,0,0,0,0,0,0,0,0,0,0,0,0,0,0,0,0
2983,LAKSHADWEEP,2007,19,EXAM FAILURE,0,0,0,0,0,0,0,0,0,0,0,0,0,0,0,0,0,0,0
3529,LAKSHADWEEP,2007,19,FAMILY PROBLEMS,0,0,0,0,0,0,0,0,0,0,0,0,0,0,0,0,0,0,0
4075,LAKSHADWEEP,2007,19,HEALTH ISSUES,0,0,0,0,0,0,0,0,0,0,0,0,0,0,0,0,0,0,0
4620,LAKSHADWEEP,2007,19,HERO WORSHIP,0,0,0,0,0,0,0,0,0,0,0,0,0,0,0,0,0,0,0
5165,LAKSHADWEEP,2007,19,ILLEGITIMATE PREGNANCY,0,0,0,0,0,0,0,0,0,0,0,0,0,0,0,0,0,0,0
5710,LAKSHADWEEP,2007,19,LOVE AFFAIRS,0,0,0,0,0,0,0,0,0,0,0,0,0,0,0,0,0,0,0
6256,LAKSHADWEEP,2007,19,MARITAL ISSUES,0,0,0,0,0,0,0,0,0,0,0,0,0,0,0,0,0,0,0
6802,LAKSHADWEEP,2007,19,MENTAL HEALTH,0,0,0,0,0,0,0,0,0,0,0,0,0,0,0,0,0,0,0
7348,LAKSHADWEEP,2007,19,OTHERS,0,0,0,0,0,0,0,0,0,0,0,0,0,0,0,0,0,0,0
7932,LAKSHADWEEP,2007,19,"PHYSICAL ABUSE (RAPE,INCEST ETC.)",0,0,0,0,0,0,0,0,0,0,0,0,0,0,0,0,0,0,0
8439,LAKSHADWEEP,2007,19,SOCIETAL ISSUES,0,0,0,0,0,0,0,0,0,0,0,0,0,0,0,0,0,0,0
292,LAKSHADWEEP,2008,19,CAUSES NOT KNOWN,0,0,0,0,0,0,0,0,0,0,0,0,0,0,0,0,0,0,0
838,LAKSHADWEEP,2008,19,DEATH OF DEAR PERSON,0,0,0,0,0,0,0,0,0,0,0,0,0,0,0,0,0,0,0
1384,LAKSHADWEEP,2008,19,DOWRY DISPUTE,0,0,0,0,0,0,0,0,0,0,0,0,0,0,0,0,0,0,0
1930,LAKSHADWEEP,2008,19,DRUG ABUSE,0,0,0,0,0,0,0,0,0,0,0,0,0,0,0,0,0,0,0
2476,LAKSHADWEEP,2008,19,ECONOMIC ISSUES,0,0,0,0,0,0,0,0,0,0,0,0,0,0,0,0,0,0,0
3022,LAKSHADWEEP,2008,19,EXAM FAILURE,0,0,0,0,0,0,0,0,0,0,0,0,0,0,0,0,0,0,0
3568,LAKSHADWEEP,2008,19,FAMILY PROBLEMS,0,0,0,0,0,0,0,0,0,0,0,0,0,0,0,0,0,0,0
4114,LAKSHADWEEP,2008,19,HEALTH ISSUES,0,0,0,0,0,0,0,0,0,0,0,0,0,0,0,0,0,0,0
4659,LAKSHADWEEP,2008,19,HERO WORSHIP,0,0,0,0,0,0,0,0,0,0,0,0,0,0,0,0,0,0,0
5204,LAKSHADWEEP,2008,19,ILLEGITIMATE PREGNANCY,0,0,0,0,0,0,0,0,0,0,0,0,0,0,0,0,0,0,0
5749,LAKSHADWEEP,2008,19,LOVE AFFAIRS,0,0,0,0,0,0,0,0,0,0,0,0,0,0,0,0,0,0,0
6295,LAKSHADWEEP,2008,19,MARITAL ISSUES,0,0,0,0,0,0,0,0,0,0,0,0,0,0,0,0,0,0,0
6841,LAKSHADWEEP,2008,19,MENTAL HEALTH,0,0,0,0,0,0,0,0,0,0,0,0,0,0,0,0,0,0,0
7387,LAKSHADWEEP,2008,19,OTHERS,0,0,0,0,0,0,0,0,0,0,0,0,0,0,0,0,0,0,0
7971,LAKSHADWEEP,2008,19,"PHYSICAL ABUSE (RAPE,INCEST ETC.)",0,0,0,0,0,0,0,0,0,0,0,0,0,0,0,0,0,0,0
8478,LAKSHADWEEP,2008,19,SOCIETAL ISSUES,0,0,0,0,0,0,0,0,0,0,0,0,0,0,0,0,0,0,0
331,LAKSHADWEEP,2009,19,CAUSES NOT KNOWN,0,0,0,0,0,0,0,0,0,0,0,0,0,0,0,0,0,0,0
877,LAKSHADWEEP,2009,19,DEATH OF DEAR PERSON,0,0,0,0,0,0,0,0,0,0,0,0,0,0,0,0,0,0,0
1423,LAKSHADWEEP,2009,19,DOWRY DISPUTE,0,0,0,0,0,0,0,0,0,0,0,0,0,0,0,0,0,0,0
1969,LAKSHADWEEP,2009,19,DRUG ABUSE,0,0,0,0,0,0,0,0,0,0,0,0,0,0,0,0,0,0,0
2515,LAKSHADWEEP,2009,19,ECONOMIC ISSUES,0,0,0,0,0,0,0,0,0,0,0,0,0,0,0,0,0,0,0
3061,LAKSHADWEEP,2009,19,EXAM FAILURE,0,0,0,0,0,0,0,0,0,0,0,0,0,0,0,0,0,0,0
3607,LAKSHADWEEP,2009,19,FAMILY PROBLEMS,0,0,0,0,0,0,0,0,0,0,0,0,0,0,0,0,0,0,0
4153,LAKSHADWEEP,2009,19,HEALTH ISSUES,0,0,0,0,0,0,0,0,0,0,0,0,0,0,0,0,0,0,0
4698,LAKSHADWEEP,2009,19,HERO WORSHIP,0,0,0,0,0,0,0,0,0,0,0,0,0,0,0,0,0,0,0
5243,LAKSHADWEEP,2009,19,ILLEGITIMATE PREGNANCY,0,0,0,0,0,0,0,0,0,0,0,0,0,0,0,0,0,0,0
5788,LAKSHADWEEP,2009,19,LOVE AFFAIRS,0,0,0,0,0,0,0,0,0,0,0,0,0,0,0,0,0,0,0
6334,LAKSHADWEEP,2009,19,MARITAL ISSUES,0,0,0,0,0,0,0,0,0,0,0,0,0,0,0,0,0,0,0
6880,LAKSHADWEEP,2009,19,MENTAL HEALTH,0,0,0,0,0,0,0,0,1,0,0,1,0,0,0,0,0,0,1
7426,LAKSHADWEEP,2009,19,OTHERS,0,0,0,0,0,0,0,0,0,0,0,0,0,0,0,0,0,0,0
8010,LAKSHADWEEP,2009,19,"PHYSICAL ABUSE (RAPE,INCEST ETC.)",0,0,0,0,0,0,0,0,0,0,0,0,0,0,0,0,0,0,0
8517,LAKSHADWEEP,2009,19,SOCIETAL ISSUES,0,0,0,0,0,0,0,0,0,0,0,0,0,0,0,0,0,0,0
370,LAKSHADWEEP,2010,19,CAUSES NOT KNOWN,0,0,0,0,0,0,0,0,0,0,0,0,0,0,0,0,0,0,0
916,LAKSHADWEEP,2010,19,DEATH OF DEAR PERSON,0,0,0,0,0,0,0,0,0,0,0,0,0,0,0,0,0,0,0
1462,LAKSHADWEEP,2010,19,DOWRY DISPUTE,0,0,0,0,0,0,0,0,0,0,0,0,0,0,0,0,0,0,0
2008,LAKSHADWEEP,2010,19,DRUG ABUSE,0,0,0,0,0,0,0,0,0,0,0,0,0,0,0,0,0,0,0
2554,LAKSHADWEEP,2010,19,ECONOMIC ISSUES,0,0,0,0,0,0,0,0,0,0,0,0,0,0,0,0,0,0,0
3100,LAKSHADWEEP,2010,19,EXAM FAILURE,0,0,0,0,0,0,0,0,0,0,0,0,0,0,0,0,0,0,0
3646,LAKSHADWEEP,2010,19,FAMILY PROBLEMS,0,0,0,0,0,0,0,0,0,0,0,0,0,0,0,0,0,0,0
4192,LAKSHADWEEP,2010,19,HEALTH ISSUES,0,0,0,0,0,0,0,0,1,0,0,1,0,0,0,0,0,0,1
4737,LAKSHADWEEP,2010,19,HERO WORSHIP,0,0,0,0,0,0,0,0,0,0,0,0,0,0,0,0,0,0,0
5282,LAKSHADWEEP,2010,19,ILLEGITIMATE PREGNANCY,0,0,0,0,0,0,0,0,0,0,0,0,0,0,0,0,0,0,0
5827,LAKSHADWEEP,2010,19,LOVE AFFAIRS,0,0,0,0,0,0,0,0,0,0,0,0,0,0,0,0,0,0,0
6373,LAKSHADWEEP,2010,19,MARITAL ISSUES,0,0,0,0,0,0,0,0,0,0,0,0,0,0,0,0,0,0,0
6919,LAKSHADWEEP,2010,19,MENTAL HEALTH,0,0,0,0,0,0,0,0,0,0,0,0,0,0,0,0,0,0,0
7465,LAKSHADWEEP,2010,19,OTHERS,0,0,0,0,0,0,0,0,0,0,0,0,0,0,0,0,0,0,0
8049,LAKSHADWEEP,2010,19,"PHYSICAL ABUSE (RAPE,INCEST ETC.)",0,0,0,0,0,0,0,0,0,0,0,0,0,0,0,0,0,0,0
8556,LAKSHADWEEP,2010,19,SOCIETAL ISSUES,0,0,0,0,0,0,0,0,0,0,0,0,0,0,0,0,0,0,0
409,LAKSHADWEEP,2011,19,CAUSES NOT KNOWN,0,0,0,0,0,0,0,0,0,0,0,0,0,0,0,0,0,0,0
955,LAKSHADWEEP,2011,19,DEATH OF DEAR PERSON,0,0,0,0,0,0,0,0,0,0,0,0,0,0,0,0,0,0,0
1501,LAKSHADWEEP,2011,19,DOWRY DISPUTE,0,0,0,0,0,0,0,0,0,0,0,0,0,0,0,0,0,0,0
2047,LAKSHADWEEP,2011,19,DRUG ABUSE,0,0,0,0,0,0,0,0,0,0,0,0,0,0,0,0,0,0,0
2593,LAKSHADWEEP,2011,19,ECONOMIC ISSUES,0,0,0,0,0,0,0,0,0,0,0,0,0,0,0,0,0,0,0
3139,LAKSHADWEEP,2011,19,EXAM FAILURE,0,0,0,0,0,0,0,0,0,0,0,0,0,0,0,0,0,0,0
3685,LAKSHADWEEP,2011,19,FAMILY PROBLEMS,0,0,0,0,0,0,0,0,0,0,0,0,0,0,0,0,0,0,0
4231,LAKSHADWEEP,2011,19,HEALTH ISSUES,0,0,0,0,0,0,0,0,0,0,0,0,0,0,0,0,0,0,0
4776,LAKSHADWEEP,2011,19,HERO WORSHIP,0,0,0,0,0,0,0,0,0,0,0,0,0,0,0,0,0,0,0
5321,LAKSHADWEEP,2011,19,ILLEGITIMATE PREGNANCY,0,0,0,0,0,0,0,0,0,0,0,0,0,0,0,0,0,0,0
5866,LAKSHADWEEP,2011,19,LOVE AFFAIRS,0,0,0,0,0,0,0,0,0,0,0,0,0,0,0,0,0,0,0
6412,LAKSHADWEEP,2011,19,MARITAL ISSUES,0,0,0,0,0,0,0,0,0,0,0,0,0,0,0,0,0,0,0
6958,LAKSHADWEEP,2011,19,MENTAL HEALTH,0,0,0,0,0,0,0,0,0,0,0,0,0,0,0,0,0,0,0
7504,LAKSHADWEEP,2011,19,OTHERS,0,0,0,0,0,0,0,0,0,0,0,0,0,0,0,0,0,0,0
8088,LAKSHADWEEP,2011,19,"PHYSICAL ABUSE (RAPE,INCEST ETC.)",0,0,0,0,0,0,0,0,0,0,0,0,0,0,0,0,0,0,0
8595,LAKSHADWEEP,2011,19,SOCIETAL ISSUES,0,0,0,0,0,0,0,0,0,0,0,0,0,0,0,0,0,0,0
448,LAKSHADWEEP,2012,19,CAUSES NOT KNOWN,0,0,0,0,0,0,0,0,0,0,0,0,0,0,0,0,0,0,0
994,LAKSHADWEEP,2012,19,DEATH OF DEAR PERSON,0,0,0,0,0,0,0,0,0,0,0,0,0,0,0,0,0,0,0
1540,LAKSHADWEEP,2012,19,DOWRY DISPUTE,0,0,0,0,0,0,0,0,0,0,0,0,0,0,0,0,0,0,0
2086,LAKSHADWEEP,2012,19,DRUG ABUSE,0,0,0,0,0,0,0,0,0,0,0,0,0,0,0,0,0,0,0
2632,LAKSHADWEEP,2012,19,ECONOMIC ISSUES,0,0,0,0,0,0,0,0,0,0,0,0,0,0,0,0,0,0,0
3178,LAKSHADWEEP,2012,19,EXAM FAILURE,0,0,0,0,0,0,0,0,0,0,0,0,0,0,0,0,0,0,0
3724,LAKSHADWEEP,2012,19,FAMILY PROBLEMS,0,0,0,0,0,0,0,0,0,0,0,0,0,0,0,0,0,0,0
4270,LAKSHADWEEP,2012,19,HEALTH ISSUES,0,0,1,0,0,1,0,0,0,0,0,0,0,0,0,0,0,0,1
4815,LAKSHADWEEP,2012,19,HERO WORSHIP,0,0,0,0,0,0,0,0,0,0,0,0,0,0,0,0,0,0,0
5360,LAKSHADWEEP,2012,19,ILLEGITIMATE PREGNANCY,0,0,0,0,0,0,0,0,0,0,0,0,0,0,0,0,0,0,0
5905,LAKSHADWEEP,2012,19,LOVE AFFAIRS,0,0,0,0,0,0,0,0,0,0,0,0,0,0,0,0,0,0,0
6451,LAKSHADWEEP,2012,19,MARITAL ISSUES,0,0,0,0,0,0,0,0,0,0,0,0,0,0,0,0,0,0,0
6997,LAKSHADWEEP,2012,19,MENTAL HEALTH,0,0,0,0,0,0,0,0,0,0,0,0,0,0,0,0,0,0,0
7543,LAKSHADWEEP,2012,19,OTHERS,0,0,0,0,0,0,0,0,0,0,0,0,0,0,0,0,0,0,0
8127,LAKSHADWEEP,2012,19,"PHYSICAL ABUSE (RAPE,INCEST ETC.)",0,0,0,0,0,0,0,0,0,0,0,0,0,0,0,0,0,0,0
8634,LAKSHADWEEP,2012,19,SOCIETAL ISSUES,0,0,0,0,0,0,0,0,0,0,0,0,0,0,0,0,0,0,0
487,LAKSHADWEEP,2013,19,CAUSES NOT KNOWN,0,0,0,0,0,0,0,0,0,0,0,0,0,0,0,0,0,0,0
1033,LAKSHADWEEP,2013,19,DEATH OF DEAR PERSON,0,0,0,0,0,0,0,0,0,0,0,0,0,0,0,0,0,0,0
1579,LAKSHADWEEP,2013,19,DOWRY DISPUTE,0,0,0,0,0,0,0,0,0,0,0,0,0,0,0,0,0,0,0
2125,LAKSHADWEEP,2013,19,DRUG ABUSE,0,0,0,0,0,0,0,0,0,0,0,0,0,0,0,0,0,0,0
2671,LAKSHADWEEP,2013,19,ECONOMIC ISSUES,0,0,0,0,0,0,0,0,0,0,0,0,0,0,0,0,0,0,0
3217,LAKSHADWEEP,2013,19,EXAM FAILURE,0,0,0,0,0,0,0,0,0,0,0,0,0,0,0,0,0,0,0
3763,LAKSHADWEEP,2013,19,FAMILY PROBLEMS,0,0,0,0,0,0,0,0,0,0,0,0,0,0,0,0,0,0,0
4309,LAKSHADWEEP,2013,19,HEALTH ISSUES,0,0,0,0,0,0,0,0,0,0,0,0,0,0,0,0,0,0,0
4854,LAKSHADWEEP,2013,19,HERO WORSHIP,0,0,0,0,0,0,0,0,0,0,0,0,0,0,0,0,0,0,0
5399,LAKSHADWEEP,2013,19,ILLEGITIMATE PREGNANCY,0,0,0,0,0,0,0,0,0,0,0,0,0,0,0,0,0,0,0
5944,LAKSHADWEEP,2013,19,LOVE AFFAIRS,0,0,0,0,0,0,0,0,0,0,0,0,0,0,0,0,0,0,0
6490,LAKSHADWEEP,2013,19,MARITAL ISSUES,0,0,0,0,0,0,0,0,0,0,0,0,0,0,0,0,0,0,0
7036,LAKSHADWEEP,2013,19,MENTAL HEALTH,0,0,0,0,0,0,0,0,1,0,0,1,0,0,0,0,0,0,1
7582,LAKSHADWEEP,2013,19,OTHERS,0,0,0,0,1,1,0,1,0,0,0,1,0,0,0,0,0,0,2
8166,LAKSHADWEEP,2013,19,"PHYSICAL ABUSE (RAPE,INCEST ETC.)",0,0,0,0,0,0,0,0,0,0,0,0,0,0,0,0,0,0,0
8673,LAKSHADWEEP,2013,19,SOCIETAL ISSUES,0,0,0,0,0,0,0,0,0,0,0,0,0,0,0,0,0,0,0
526,LAKSHADWEEP,2014,19,CAUSES NOT KNOWN,0,0,0,0,0,0,0,0,0,0,0,0,0,0,0,0,0,0,0
1072,LAKSHADWEEP,2014,19,DEATH OF DEAR PERSON,0,0,0,0,0,0,0,0,0,0,0,0,0,0,0,0,0,0,0
1618,LAKSHADWEEP,2014,19,DOWRY DISPUTE,0,0,0,0,0,0,0,0,0,0,0,0,0,0,0,0,0,0,0
2164,LAKSHADWEEP,2014,19,DRUG ABUSE,0,0,0,0,0,0,0,0,0,0,0,0,0,0,0,0,0,0,0
2710,LAKSHADWEEP,2014,19,ECONOMIC ISSUES,0,0,0,0,0,0,0,0,0,0,0,0,0,0,0,0,0,0,0
3256,LAKSHADWEEP,2014,19,EXAM FAILURE,0,0,0,0,0,0,0,0,0,0,0,0,0,0,0,0,0,0,0
3802,LAKSHADWEEP,2014,19,FAMILY PROBLEMS,0,0,0,0,0,0,0,0,0,0,0,0,0,0,0,0,0,0,0
4348,LAKSHADWEEP,2014,19,HEALTH ISSUES,0,0,0,0,0,0,0,0,0,0,0,0,0,0,0,0,0,0,0
4893,LAKSHADWEEP,2014,19,HERO WORSHIP,0,0,0,0,0,0,0,0,0,0,0,0,0,0,0,0,0,0,0
5438,LAKSHADWEEP,2014,19,ILLEGITIMATE PREGNANCY,0,0,0,0,0,0,0,0,0,0,0,0,0,0,0,0,0,0,0
5983,LAKSHADWEEP,2014,19,LOVE AFFAIRS,0,0,0,0,0,0,0,0,0,0,0,0,0,0,0,0,0,0,0
6529,LAKSHADWEEP,2014,19,MARITAL ISSUES,0,0,0,0,0,0,0,0,0,0,0,0,0,0,0,0,0,0,0
7075,LAKSHADWEEP,2014,19,MENTAL HEALTH,0,0,0,0,0,0,0,0,0,0,0,0,0,0,0,0,0,0,0
7621,LAKSHADWEEP,2014,19,OTHERS,0,1,1,0,0,2,0,0,1,0,0,1,0,0,0,0,0,0,3
7660,LAKSHADWEEP,2014,19,PHYSICAL ABUSE,0,0,0,0,0,0,0,0,0,0,0,0,0,0,0,0,0,0,0
8712,LAKSHADWEEP,2014,19,SOCIETAL ISSUES,0,0,0,0,0,0,0,0,0,0,0,0,0,0,0,0,0,0,0
20,MADHYA PRADESH,2001,20,CAUSES NOT KNOWN,82,483,412,207,95,1279,60,482,217,100,55,914,0,0,0,0,0,0,2193
566,MADHYA PRADESH,2001,20,DEATH OF DEAR PERSON,1,5,16,6,2,30,3,27,12,4,1,47,0,0,0,0,0,0,77
1112,MADHYA PRADESH,2001,20,DOWRY DISPUTE,0,0,0,0,0,0,0,378,89,3,0,470,0,0,0,0,0,0,470
1658,MADHYA PRADESH,2001,20,DRUG ABUSE,0,35,45,22,5,107,0,1,1,0,0,2,0,0,0,0,0,0,109
2204,MADHYA PRADESH,2001,20,ECONOMIC ISSUES,3,104,89,32,20,248,0,82,34,20,10,146,0,0,0,0,0,0,394
2750,MADHYA PRADESH,2001,20,EXAM FAILURE,15,43,1,0,0,59,14,48,5,0,0,67,0,0,0,0,0,0,126
3296,MADHYA PRADESH,2001,20,FAMILY PROBLEMS,4,379,257,121,52,813,8,393,187,70,31,689,0,0,0,0,0,0,1502
3842,MADHYA PRADESH,2001,20,HEALTH ISSUES,4,120,114,72,45,355,5,132,90,58,30,315,0,0,0,0,0,0,670
4388,MADHYA PRADESH,2001,20,HERO WORSHIP,0,0,0,0,0,0,0,2,0,0,0,2,0,0,0,0,0,0,2
4933,MADHYA PRADESH,2001,20,ILLEGITIMATE PREGNANCY,0,4,2,0,0,6,0,36,7,4,0,47,0,0,0,0,0,0,53
5478,MADHYA PRADESH,2001,20,LOVE AFFAIRS,0,45,21,0,0,66,2,46,6,3,0,57,0,0,0,0,0,0,123
6023,MADHYA PRADESH,2001,20,MARITAL ISSUES,6,38,12,2,0,58,1,113,39,5,0,158,0,0,0,0,0,0,216
6569,MADHYA PRADESH,2001,20,MENTAL HEALTH,6,63,67,32,23,191,2,36,30,13,6,87,0,0,0,0,0,0,278
7115,MADHYA PRADESH,2001,20,OTHERS,5,73,61,54,38,231,17,77,66,26,25,211,0,0,0,0,0,0,442
7700,MADHYA PRADESH,2001,20,"PHYSICAL ABUSE (RAPE,INCEST ETC.)",1,10,11,6,3,31,3,53,17,4,0,77,0,0,0,0,0,0,108
8206,MADHYA PRADESH,2001,20,SOCIETAL ISSUES,3,15,21,16,7,62,0,12,12,8,3,35,0,0,0,0,0,0,97
59,MADHYA PRADESH,2002,20,CAUSES NOT KNOWN,43,399,281,159,51,933,32,357,155,80,50,674,0,0,0,0,0,0,1607
605,MADHYA PRADESH,2002,20,DEATH OF DEAR PERSON,0,8,3,4,2,17,1,12,12,6,0,31,0,0,0,0,0,0,48
1151,MADHYA PRADESH,2002,20,DOWRY DISPUTE,0,0,0,2,0,2,1,417,116,1,1,536,0,0,0,0,0,0,538
1697,MADHYA PRADESH,2002,20,DRUG ABUSE,0,33,48,20,6,107,0,0,0,0,0,0,0,0,0,0,0,0,107
2243,MADHYA PRADESH,2002,20,ECONOMIC ISSUES,0,144,127,61,25,357,0,66,36,28,11,141,0,0,0,0,0,0,498
2789,MADHYA PRADESH,2002,20,EXAM FAILURE,14,79,4,0,0,97,12,43,0,0,0,55,0,0,0,0,0,0,152
3335,MADHYA PRADESH,2002,20,FAMILY PROBLEMS,6,388,259,147,49,849,11,418,215,100,25,769,0,0,0,0,0,0,1618
3881,MADHYA PRADESH,2002,20,HEALTH ISSUES,8,139,174,139,107,567,8,150,125,78,52,413,0,0,0,0,0,0,980
4427,MADHYA PRADESH,2002,20,HERO WORSHIP,0,0,0,1,0,1,0,0,0,0,0,0,0,0,0,0,0,0,1
4972,MADHYA PRADESH,2002,20,ILLEGITIMATE PREGNANCY,0,0,0,0,0,0,1,25,9,3,0,38,0,0,0,0,0,0,38
5517,MADHYA PRADESH,2002,20,LOVE AFFAIRS,0,49,11,0,0,60,7,70,11,2,0,90,0,0,0,0,0,0,150
6062,MADHYA PRADESH,2002,20,MARITAL ISSUES,3,42,27,8,0,80,1,110,59,2,1,173,0,0,0,0,0,0,253
6608,MADHYA PRADESH,2002,20,MENTAL HEALTH,2,57,55,21,19,154,0,35,35,13,6,89,0,0,0,0,0,0,243
7154,MADHYA PRADESH,2002,20,OTHERS,15,96,89,46,18,264,14,88,59,19,12,192,0,0,0,0,0,0,456
7739,MADHYA PRADESH,2002,20,"PHYSICAL ABUSE (RAPE,INCEST ETC.)",0,13,15,8,2,38,2,57,18,6,1,84,0,0,0,0,0,0,122
8245,MADHYA PRADESH,2002,20,SOCIETAL ISSUES,1,8,25,17,2,53,0,17,11,4,3,35,0,0,0,0,0,0,88
98,MADHYA PRADESH,2003,20,CAUSES NOT KNOWN,40,380,326,157,52,955,31,397,175,80,43,726,0,0,0,0,0,0,1681
644,MADHYA PRADESH,2003,20,DEATH OF DEAR PERSON,0,10,11,9,1,31,1,15,9,5,1,31,0,0,0,0,0,0,62
1190,MADHYA PRADESH,2003,20,DOWRY DISPUTE,0,0,0,0,0,0,0,422,91,2,1,516,0,0,0,0,0,0,516
1736,MADHYA PRADESH,2003,20,DRUG ABUSE,0,37,59,17,3,116,0,0,0,0,0,0,0,0,0,0,0,0,116
2282,MADHYA PRADESH,2003,20,ECONOMIC ISSUES,0,157,134,66,31,388,1,75,35,22,6,139,0,0,0,0,0,0,527
2828,MADHYA PRADESH,2003,20,EXAM FAILURE,11,51,2,0,0,64,7,35,0,0,0,42,0,0,0,0,0,0,106
3374,MADHYA PRADESH,2003,20,FAMILY PROBLEMS,11,331,288,127,52,809,14,448,265,71,23,821,0,0,0,0,0,0,1630
3920,MADHYA PRADESH,2003,20,HEALTH ISSUES,10,175,183,98,87,553,11,142,111,45,37,346,0,0,0,0,0,0,899
4466,MADHYA PRADESH,2003,20,HERO WORSHIP,0,0,0,0,0,0,0,0,0,0,0,0,0,0,0,0,0,0,0
5011,MADHYA PRADESH,2003,20,ILLEGITIMATE PREGNANCY,0,0,0,0,0,0,0,19,8,2,0,29,0,0,0,0,0,0,29
5556,MADHYA PRADESH,2003,20,LOVE AFFAIRS,0,62,17,1,0,80,4,61,9,3,0,77,0,0,0,0,0,0,157
6101,MADHYA PRADESH,2003,20,MARITAL ISSUES,0,42,29,11,6,88,0,90,39,2,0,131,0,0,0,0,0,0,219
6647,MADHYA PRADESH,2003,20,MENTAL HEALTH,9,46,66,24,10,155,5,21,27,14,4,71,0,0,0,0,0,0,226
7193,MADHYA PRADESH,2003,20,OTHERS,10,59,56,27,21,173,7,53,47,10,7,124,0,0,0,0,0,0,297
7778,MADHYA PRADESH,2003,20,"PHYSICAL ABUSE (RAPE,INCEST ETC.)",3,12,13,11,16,55,3,73,24,7,1,108,0,0,0,0,0,0,163
8284,MADHYA PRADESH,2003,20,SOCIETAL ISSUES,0,17,30,18,6,71,5,28,20,8,2,63,0,0,0,0,0,0,134
137,MADHYA PRADESH,2004,20,CAUSES NOT KNOWN,52,482,393,153,92,1172,48,388,225,77,45,783,0,0,0,0,0,0,1955
683,MADHYA PRADESH,2004,20,DEATH OF DEAR PERSON,0,4,4,3,3,14,1,6,8,6,2,23,0,0,0,0,0,0,37
1229,MADHYA PRADESH,2004,20,DOWRY DISPUTE,0,1,0,0,0,1,0,515,99,7,0,621,0,0,0,0,0,0,622
1775,MADHYA PRADESH,2004,20,DRUG ABUSE,1,40,55,35,9,140,0,4,0,0,0,4,0,0,0,0,0,0,144
2321,MADHYA PRADESH,2004,20,ECONOMIC ISSUES,3,113,135,59,37,347,2,37,44,35,22,140,0,0,0,0,0,0,487
2867,MADHYA PRADESH,2004,20,EXAM FAILURE,8,51,1,0,0,60,9,30,0,0,0,39,0,0,0,0,0,0,99
3413,MADHYA PRADESH,2004,20,FAMILY PROBLEMS,10,256,212,140,68,686,13,312,143,84,33,585,0,0,0,0,0,0,1271
3959,MADHYA PRADESH,2004,20,HEALTH ISSUES,10,176,174,116,69,545,5,115,106,53,32,311,0,0,0,0,0,0,856
4505,MADHYA PRADESH,2004,20,HERO WORSHIP,0,0,0,0,0,0,0,0,0,0,0,0,0,0,0,0,0,0,0
5050,MADHYA PRADESH,2004,20,ILLEGITIMATE PREGNANCY,0,0,0,0,0,0,0,13,14,3,0,30,0,0,0,0,0,0,30
5595,MADHYA PRADESH,2004,20,LOVE AFFAIRS,2,58,20,4,0,84,8,54,15,2,0,79,0,0,0,0,0,0,163
6140,MADHYA PRADESH,2004,20,MARITAL ISSUES,1,63,26,4,0,94,2,100,36,9,0,147,0,0,0,0,0,0,241
6686,MADHYA PRADESH,2004,20,MENTAL HEALTH,4,75,76,31,19,205,1,44,42,17,3,107,0,0,0,0,0,0,312
7232,MADHYA PRADESH,2004,20,OTHERS,16,74,82,36,11,219,20,76,45,16,17,174,0,0,0,0,0,0,393
7817,MADHYA PRADESH,2004,20,"PHYSICAL ABUSE (RAPE,INCEST ETC.)",0,4,8,6,8,26,0,47,29,9,3,88,0,0,0,0,0,0,114
8323,MADHYA PRADESH,2004,20,SOCIETAL ISSUES,2,11,16,8,4,41,1,12,13,3,1,30,0,0,0,0,0,0,71
176,MADHYA PRADESH,2005,20,CAUSES NOT KNOWN,38,341,299,147,69,894,35,312,169,43,25,584,0,0,0,0,0,0,1478
722,MADHYA PRADESH,2005,20,DEATH OF DEAR PERSON,0,5,5,0,2,12,0,3,10,1,0,14,0,0,0,0,0,0,26
1268,MADHYA PRADESH,2005,20,DOWRY DISPUTE,0,0,0,0,0,0,0,444,62,11,0,517,0,0,0,0,0,0,517
1814,MADHYA PRADESH,2005,20,DRUG ABUSE,0,34,45,28,2,109,0,0,1,0,0,1,0,0,0,0,0,0,110
2360,MADHYA PRADESH,2005,20,ECONOMIC ISSUES,0,55,74,34,10,173,2,18,11,8,2,41,0,0,0,0,0,0,214
2906,MADHYA PRADESH,2005,20,EXAM FAILURE,9,32,0,0,0,41,5,27,0,0,0,32,0,0,0,0,0,0,73
3452,MADHYA PRADESH,2005,20,FAMILY PROBLEMS,5,216,178,89,30,518,12,283,152,65,15,527,0,0,0,0,0,0,1045
3998,MADHYA PRADESH,2005,20,HEALTH ISSUES,10,118,130,82,72,412,8,71,92,44,32,247,0,0,0,0,0,0,659
4544,MADHYA PRADESH,2005,20,HERO WORSHIP,0,1,1,0,0,2,0,2,0,0,0,2,0,0,0,0,0,0,4
5089,MADHYA PRADESH,2005,20,ILLEGITIMATE PREGNANCY,0,0,0,0,0,0,0,15,3,0,0,18,0,0,0,0,0,0,18
5634,MADHYA PRADESH,2005,20,LOVE AFFAIRS,0,40,10,0,0,50,0,57,11,0,0,68,0,0,0,0,0,0,118
6179,MADHYA PRADESH,2005,20,MARITAL ISSUES,0,44,23,3,0,70,0,66,55,5,0,126,0,0,0,0,0,0,196
6725,MADHYA PRADESH,2005,20,MENTAL HEALTH,3,91,61,34,19,208,3,39,42,18,11,113,0,0,0,0,0,0,321
7271,MADHYA PRADESH,2005,20,OTHERS,17,114,104,44,18,297,12,140,58,15,11,236,0,0,0,0,0,0,533
7856,MADHYA PRADESH,2005,20,"PHYSICAL ABUSE (RAPE,INCEST ETC.)",1,9,1,0,0,11,1,31,12,0,0,44,0,0,0,0,0,0,55
8362,MADHYA PRADESH,2005,20,SOCIETAL ISSUES,0,24,18,11,1,54,0,19,6,2,0,27,0,0,0,0,0,0,81
215,MADHYA PRADESH,2006,20,CAUSES NOT KNOWN,47,351,338,181,54,971,24,281,180,51,16,552,0,0,0,0,0,0,1523
761,MADHYA PRADESH,2006,20,DEATH OF DEAR PERSON,0,4,9,6,2,21,0,8,14,5,0,27,0,0,0,0,0,0,48
1307,MADHYA PRADESH,2006,20,DOWRY DISPUTE,0,0,0,0,0,0,1,480,97,7,0,585,0,0,0,0,0,0,585
1853,MADHYA PRADESH,2006,20,DRUG ABUSE,0,22,62,37,11,132,0,0,0,0,0,0,0,0,0,0,0,0,132
2399,MADHYA PRADESH,2006,20,ECONOMIC ISSUES,0,49,94,70,20,233,1,18,23,14,3,59,0,0,0,0,0,0,292
2945,MADHYA PRADESH,2006,20,EXAM FAILURE,10,69,2,0,1,82,11,38,2,0,0,51,0,0,0,0,0,0,133
3491,MADHYA PRADESH,2006,20,FAMILY PROBLEMS,10,243,274,150,53,730,8,256,210,62,28,564,0,0,0,0,0,0,1294
4037,MADHYA PRADESH,2006,20,HEALTH ISSUES,5,118,127,103,106,459,5,110,93,68,46,322,0,0,0,0,0,0,781
4582,MADHYA PRADESH,2006,20,HERO WORSHIP,0,6,3,1,1,11,1,0,6,0,0,7,0,0,0,0,0,0,18
5127,MADHYA PRADESH,2006,20,ILLEGITIMATE PREGNANCY,0,1,0,0,0,1,8,23,5,0,0,36,0,0,0,0,0,0,37
5672,MADHYA PRADESH,2006,20,LOVE AFFAIRS,0,48,12,1,0,61,2,57,11,1,0,71,0,0,0,0,0,0,132
6218,MADHYA PRADESH,2006,20,MARITAL ISSUES,2,37,28,2,0,69,3,57,50,8,0,118,0,0,0,0,0,0,187
6764,MADHYA PRADESH,2006,20,MENTAL HEALTH,4,71,74,38,17,204,2,39,43,25,9,118,0,0,0,0,0,0,322
7310,MADHYA PRADESH,2006,20,OTHERS,15,109,159,99,21,403,12,131,124,36,12,315,0,0,0,0,0,0,718
7894,MADHYA PRADESH,2006,20,"PHYSICAL ABUSE (RAPE,INCEST ETC.)",1,13,13,9,0,36,2,44,21,3,1,71,0,0,0,0,0,0,107
8401,MADHYA PRADESH,2006,20,SOCIETAL ISSUES,2,26,32,17,13,90,3,17,11,5,0,36,0,0,0,0,0,0,126
254,MADHYA PRADESH,2007,20,CAUSES NOT KNOWN,55,447,302,222,77,1103,35,343,175,70,24,647,0,0,0,0,0,0,1750
800,MADHYA PRADESH,2007,20,DEATH OF DEAR PERSON,0,7,6,2,1,16,0,32,7,5,0,44,0,0,0,0,0,0,60
1346,MADHYA PRADESH,2007,20,DOWRY DISPUTE,0,0,0,0,0,0,1,477,104,6,0,588,0,0,0,0,0,0,588
1892,MADHYA PRADESH,2007,20,DRUG ABUSE,0,40,56,43,7,146,0,0,0,0,1,1,0,0,0,0,0,0,147
2438,MADHYA PRADESH,2007,20,ECONOMIC ISSUES,0,46,69,53,9,177,0,8,16,4,3,31,0,0,0,0,0,0,208
2984,MADHYA PRADESH,2007,20,EXAM FAILURE,5,46,1,0,0,52,8,33,0,0,0,41,0,0,0,0,0,0,93
3530,MADHYA PRADESH,2007,20,FAMILY PROBLEMS,6,261,274,129,23,693,14,292,149,49,24,528,0,0,0,0,0,0,1221
4076,MADHYA PRADESH,2007,20,HEALTH ISSUES,6,113,114,87,85,405,7,115,84,54,53,313,0,0,0,0,0,0,718
4621,MADHYA PRADESH,2007,20,HERO WORSHIP,0,2,4,0,0,6,0,5,0,0,0,5,0,0,0,0,0,0,11
5166,MADHYA PRADESH,2007,20,ILLEGITIMATE PREGNANCY,0,0,0,0,0,0,0,12,3,0,0,15,0,0,0,0,0,0,15
5711,MADHYA PRADESH,2007,20,LOVE AFFAIRS,0,52,14,1,0,67,13,64,9,1,0,87,0,0,0,0,0,0,154
6257,MADHYA PRADESH,2007,20,MARITAL ISSUES,0,40,27,5,0,72,3,74,39,6,0,122,0,0,0,0,0,0,194
6803,MADHYA PRADESH,2007,20,MENTAL HEALTH,2,82,70,47,20,221,0,35,34,8,6,83,0,0,0,0,0,0,304
7349,MADHYA PRADESH,2007,20,OTHERS,19,148,160,69,32,428,31,136,75,16,6,264,0,0,0,0,0,0,692
7933,MADHYA PRADESH,2007,20,"PHYSICAL ABUSE (RAPE,INCEST ETC.)",0,14,13,4,2,33,0,40,16,10,0,66,0,0,0,0,0,0,99
8440,MADHYA PRADESH,2007,20,SOCIETAL ISSUES,0,15,16,14,6,51,0,7,15,0,2,24,0,0,0,0,0,0,75
293,MADHYA PRADESH,2008,20,CAUSES NOT KNOWN,32,405,379,170,76,1062,39,295,201,62,28,625,0,0,0,0,0,0,1687
839,MADHYA PRADESH,2008,20,DEATH OF DEAR PERSON,2,18,28,28,4,80,1,38,15,3,2,59,0,0,0,0,0,0,139
1385,MADHYA PRADESH,2008,20,DOWRY DISPUTE,0,9,1,0,0,10,0,611,132,5,0,748,0,0,0,0,0,0,758
1931,MADHYA PRADESH,2008,20,DRUG ABUSE,0,77,124,78,21,300,0,2,8,3,0,13,0,0,0,0,0,0,313
2477,MADHYA PRADESH,2008,20,ECONOMIC ISSUES,0,123,189,112,41,465,0,9,22,12,6,49,0,0,0,0,0,0,514
3023,MADHYA PRADESH,2008,20,EXAM FAILURE,5,103,1,0,0,109,5,79,0,0,0,84,0,0,0,0,0,0,193
3569,MADHYA PRADESH,2008,20,FAMILY PROBLEMS,2,319,342,175,39,877,6,309,234,78,17,644,0,0,0,0,0,0,1521
4115,MADHYA PRADESH,2008,20,HEALTH ISSUES,6,129,138,144,141,558,8,86,103,73,37,307,0,0,0,0,0,0,865
4660,MADHYA PRADESH,2008,20,HERO WORSHIP,0,2,0,1,0,3,0,2,8,1,0,11,0,0,0,0,0,0,14
5205,MADHYA PRADESH,2008,20,ILLEGITIMATE PREGNANCY,0,10,10,0,0,20,0,21,29,3,0,53,0,0,0,0,0,0,73
5750,MADHYA PRADESH,2008,20,LOVE AFFAIRS,0,82,17,0,0,99,3,73,16,0,0,92,0,0,0,0,0,0,191
6296,MADHYA PRADESH,2008,20,MARITAL ISSUES,0,71,37,4,2,114,5,110,69,16,0,200,0,0,0,0,0,0,314
6842,MADHYA PRADESH,2008,20,MENTAL HEALTH,15,133,128,48,37,361,2,67,50,30,5,154,0,0,0,0,0,0,515
7388,MADHYA PRADESH,2008,20,OTHERS,10,63,72,48,6,199,9,37,26,8,5,85,0,0,0,0,0,0,284
7972,MADHYA PRADESH,2008,20,"PHYSICAL ABUSE (RAPE,INCEST ETC.)",1,10,26,0,0,37,2,68,27,5,0,102,0,0,0,0,0,0,139
8479,MADHYA PRADESH,2008,20,SOCIETAL ISSUES,2,38,9,7,15,71,0,26,5,6,1,38,0,0,0,0,0,0,109
332,MADHYA PRADESH,2009,20,CAUSES NOT KNOWN,64,462,403,268,66,1263,46,342,201,85,43,717,0,0,0,0,0,0,1980
878,MADHYA PRADESH,2009,20,DEATH OF DEAR PERSON,0,18,10,5,0,33,1,38,11,1,0,51,0,0,0,0,0,0,84
1424,MADHYA PRADESH,2009,20,DOWRY DISPUTE,0,0,0,0,0,0,0,509,156,1,0,666,0,0,0,0,0,0,666
1970,MADHYA PRADESH,2009,20,DRUG ABUSE,1,69,103,77,14,264,0,0,2,2,0,4,0,0,0,0,0,0,268
2516,MADHYA PRADESH,2009,20,ECONOMIC ISSUES,1,111,189,130,35,466,0,26,44,15,4,89,0,0,0,0,0,0,555
3062,MADHYA PRADESH,2009,20,EXAM FAILURE,9,62,15,0,0,86,15,59,0,0,0,74,0,0,0,0,0,0,160
3608,MADHYA PRADESH,2009,20,FAMILY PROBLEMS,16,304,283,130,44,777,9,355,228,72,28,692,0,0,0,0,0,0,1469
4154,MADHYA PRADESH,2009,20,HEALTH ISSUES,9,141,140,159,122,571,6,110,130,52,53,351,0,0,0,0,0,0,922
4699,MADHYA PRADESH,2009,20,HERO WORSHIP,0,0,0,0,0,0,0,0,0,0,0,0,0,0,0,0,0,0,0
5244,MADHYA PRADESH,2009,20,ILLEGITIMATE PREGNANCY,0,0,0,0,0,0,1,3,5,0,0,9,0,0,0,0,0,0,9
5789,MADHYA PRADESH,2009,20,LOVE AFFAIRS,3,83,25,0,0,111,7,73,17,0,0,97,0,0,0,0,0,0,208
6335,MADHYA PRADESH,2009,20,MARITAL ISSUES,0,69,18,3,2,92,2,107,43,7,0,159,0,0,0,0,0,0,251
6881,MADHYA PRADESH,2009,20,MENTAL HEALTH,15,94,89,46,18,262,5,50,41,19,6,121,0,0,0,0,0,0,383
7427,MADHYA PRADESH,2009,20,OTHERS,145,290,285,256,86,1062,143,348,223,114,23,851,0,0,0,0,0,0,1913
8011,MADHYA PRADESH,2009,20,"PHYSICAL ABUSE (RAPE,INCEST ETC.)",1,17,7,3,1,29,4,49,29,7,0,89,0,0,0,0,0,0,118
8518,MADHYA PRADESH,2009,20,SOCIETAL ISSUES,2,38,17,11,16,84,3,27,12,1,0,43,0,0,0,0,0,0,127
371,MADHYA PRADESH,2010,20,CAUSES NOT KNOWN,66,515,404,231,99,1315,62,374,225,119,68,848,0,0,0,0,0,0,2163
917,MADHYA PRADESH,2010,20,DEATH OF DEAR PERSON,0,11,12,4,2,29,0,56,28,3,4,91,0,0,0,0,0,0,120
1463,MADHYA PRADESH,2010,20,DOWRY DISPUTE,0,3,2,2,0,7,0,584,172,12,1,769,0,0,0,0,0,0,776
2009,MADHYA PRADESH,2010,20,DRUG ABUSE,2,90,196,124,40,452,0,4,11,8,1,24,0,0,0,0,0,0,476
2555,MADHYA PRADESH,2010,20,ECONOMIC ISSUES,10,84,101,57,19,271,8,12,12,7,2,41,0,0,0,0,0,0,312
3101,MADHYA PRADESH,2010,20,EXAM FAILURE,20,62,10,6,2,100,15,50,12,0,0,77,0,0,0,0,0,0,177
3647,MADHYA PRADESH,2010,20,FAMILY PROBLEMS,28,316,326,151,60,881,10,325,266,80,24,705,0,0,0,0,0,0,1586
4193,MADHYA PRADESH,2010,20,HEALTH ISSUES,5,138,179,144,82,548,13,91,89,80,35,308,0,0,0,0,0,0,856
4738,MADHYA PRADESH,2010,20,HERO WORSHIP,0,3,0,2,0,5,0,2,1,0,0,3,0,0,0,0,0,0,8
5283,MADHYA PRADESH,2010,20,ILLEGITIMATE PREGNANCY,0,0,0,0,0,0,2,7,0,0,0,9,0,0,0,0,0,0,9
5828,MADHYA PRADESH,2010,20,LOVE AFFAIRS,7,82,26,0,0,115,10,105,24,0,0,139,0,0,0,0,0,0,254
6374,MADHYA PRADESH,2010,20,MARITAL ISSUES,1,79,40,6,7,133,4,120,51,5,0,180,0,0,0,0,0,0,313
6920,MADHYA PRADESH,2010,20,MENTAL HEALTH,9,105,110,87,36,347,7,83,61,29,7,187,0,0,0,0,0,0,534
7466,MADHYA PRADESH,2010,20,OTHERS,62,200,209,150,67,688,22,142,91,40,36,331,0,0,0,0,0,0,1019
8050,MADHYA PRADESH,2010,20,"PHYSICAL ABUSE (RAPE,INCEST ETC.)",1,26,10,6,0,43,6,66,36,3,0,111,0,0,0,0,0,0,154
8557,MADHYA PRADESH,2010,20,SOCIETAL ISSUES,4,76,43,20,10,153,2,54,26,6,5,93,0,0,0,0,0,0,246
410,MADHYA PRADESH,2011,20,CAUSES NOT KNOWN,53,570,381,185,86,1275,61,435,209,85,47,837,0,0,0,0,0,0,2112
956,MADHYA PRADESH,2011,20,DEATH OF DEAR PERSON,0,15,13,3,1,32,1,24,11,5,2,43,0,0,0,0,0,0,75
1502,MADHYA PRADESH,2011,20,DOWRY DISPUTE,0,2,3,3,0,8,1,496,182,14,0,693,0,0,0,0,0,0,701
2048,MADHYA PRADESH,2011,20,DRUG ABUSE,2,144,226,86,42,500,1,10,8,8,1,28,0,0,0,0,0,0,528
2594,MADHYA PRADESH,2011,20,ECONOMIC ISSUES,0,110,132,63,27,332,1,21,25,26,2,75,0,0,0,0,0,0,407
3140,MADHYA PRADESH,2011,20,EXAM FAILURE,19,60,8,1,0,88,17,50,1,0,0,68,0,0,0,0,0,0,156
3686,MADHYA PRADESH,2011,20,FAMILY PROBLEMS,12,281,280,164,57,794,24,358,260,103,24,769,0,0,0,0,0,0,1563
4232,MADHYA PRADESH,2011,20,HEALTH ISSUES,12,197,239,181,139,768,10,129,146,87,65,437,0,0,0,0,0,0,1205
4777,MADHYA PRADESH,2011,20,HERO WORSHIP,0,0,0,0,0,0,0,1,0,0,0,1,0,0,0,0,0,0,1
5322,MADHYA PRADESH,2011,20,ILLEGITIMATE PREGNANCY,0,0,0,0,0,0,6,7,3,0,0,16,0,0,0,0,0,0,16
5867,MADHYA PRADESH,2011,20,LOVE AFFAIRS,4,126,22,1,0,153,10,97,30,8,0,145,0,0,0,0,0,0,298
6413,MADHYA PRADESH,2011,20,MARITAL ISSUES,0,83,45,5,0,133,1,84,48,4,0,137,0,0,0,0,0,0,270
6959,MADHYA PRADESH,2011,20,MENTAL HEALTH,11,129,151,74,34,399,11,88,80,36,18,233,0,0,0,0,0,0,632
7505,MADHYA PRADESH,2011,20,OTHERS,43,217,218,136,45,659,18,164,110,45,22,359,0,0,0,0,0,0,1018
8089,MADHYA PRADESH,2011,20,"PHYSICAL ABUSE (RAPE,INCEST ETC.)",0,30,19,1,0,50,0,62,54,3,2,121,0,0,0,0,0,0,171
8596,MADHYA PRADESH,2011,20,SOCIETAL ISSUES,0,13,22,13,1,49,1,30,20,5,1,57,0,0,0,0,0,0,106
449,MADHYA PRADESH,2012,20,CAUSES NOT KNOWN,56,394,349,242,71,1112,41,305,153,98,50,647,0,0,0,0,0,0,1759
995,MADHYA PRADESH,2012,20,DEATH OF DEAR PERSON,1,6,16,6,8,37,1,16,13,3,5,38,0,0,0,0,0,0,75
1541,MADHYA PRADESH,2012,20,DOWRY DISPUTE,0,1,0,0,0,1,0,475,137,18,0,630,0,0,0,0,0,0,631
2087,MADHYA PRADESH,2012,20,DRUG ABUSE,0,137,259,149,27,572,0,1,4,4,0,9,0,0,0,0,0,0,581
2633,MADHYA PRADESH,2012,20,ECONOMIC ISSUES,2,113,154,65,20,354,1,22,41,25,0,89,0,0,0,0,0,0,443
3179,MADHYA PRADESH,2012,20,EXAM FAILURE,18,69,15,0,0,102,15,75,1,0,0,91,0,0,0,0,0,0,193
3725,MADHYA PRADESH,2012,20,FAMILY PROBLEMS,20,552,522,262,98,1454,28,531,361,145,42,1107,0,0,0,0,0,0,2561
4271,MADHYA PRADESH,2012,20,HEALTH ISSUES,12,163,236,186,185,782,9,144,116,88,58,415,0,0,0,0,0,0,1197
4816,MADHYA PRADESH,2012,20,HERO WORSHIP,0,0,1,0,0,1,0,2,0,0,0,2,0,0,0,0,0,0,3
5361,MADHYA PRADESH,2012,20,ILLEGITIMATE PREGNANCY,0,0,0,0,0,0,0,6,0,0,0,6,0,0,0,0,0,0,6
5906,MADHYA PRADESH,2012,20,LOVE AFFAIRS,4,142,29,12,0,187,9,122,25,12,0,168,0,0,0,0,0,0,355
6452,MADHYA PRADESH,2012,20,MARITAL ISSUES,0,82,38,11,9,140,0,91,47,4,0,142,0,0,0,0,0,0,282
6998,MADHYA PRADESH,2012,20,MENTAL HEALTH,5,130,143,71,35,384,5,84,67,34,26,216,0,0,0,0,0,0,600
7544,MADHYA PRADESH,2012,20,OTHERS,25,180,197,121,42,565,20,125,102,41,24,312,0,0,0,0,0,0,877
8128,MADHYA PRADESH,2012,20,"PHYSICAL ABUSE (RAPE,INCEST ETC.)",0,5,4,3,0,12,2,38,29,5,0,74,0,0,0,0,0,0,86
8635,MADHYA PRADESH,2012,20,SOCIETAL ISSUES,1,22,25,20,3,71,3,23,18,9,2,55,0,0,0,0,0,0,126
488,MADHYA PRADESH,2013,20,CAUSES NOT KNOWN,74,440,317,194,62,1087,27,299,174,57,41,598,0,0,0,0,0,0,1685
1034,MADHYA PRADESH,2013,20,DEATH OF DEAR PERSON,0,24,16,9,9,58,1,58,33,10,2,104,0,0,0,0,0,0,162
1580,MADHYA PRADESH,2013,20,DOWRY DISPUTE,0,1,1,0,0,2,0,440,74,2,0,516,0,0,0,0,0,0,518
2126,MADHYA PRADESH,2013,20,DRUG ABUSE,1,161,251,135,52,600,0,8,10,5,5,28,0,0,0,0,0,0,628
2672,MADHYA PRADESH,2013,20,ECONOMIC ISSUES,7,122,104,47,12,292,5,35,22,10,2,74,0,0,0,0,0,0,366
3218,MADHYA PRADESH,2013,20,EXAM FAILURE,17,84,25,0,1,127,16,71,4,0,0,91,0,0,0,0,0,0,218
3764,MADHYA PRADESH,2013,20,FAMILY PROBLEMS,13,478,425,250,87,1253,10,405,246,111,39,811,0,0,0,0,0,0,2064
4310,MADHYA PRADESH,2013,20,HEALTH ISSUES,4,157,226,182,151,720,13,108,111,60,45,337,0,0,0,0,0,0,1057
4855,MADHYA PRADESH,2013,20,HERO WORSHIP,0,0,0,0,0,0,0,2,0,0,0,2,0,0,0,0,0,0,2
5400,MADHYA PRADESH,2013,20,ILLEGITIMATE PREGNANCY,0,0,0,0,0,0,1,11,2,0,0,14,0,0,0,0,0,0,14
5945,MADHYA PRADESH,2013,20,LOVE AFFAIRS,3,82,29,9,0,123,9,118,19,6,0,152,0,0,0,0,0,0,275
6491,MADHYA PRADESH,2013,20,MARITAL ISSUES,0,101,38,21,8,168,1,90,45,3,0,139,0,0,0,0,0,0,307
7037,MADHYA PRADESH,2013,20,MENTAL HEALTH,12,163,181,100,51,507,11,76,78,36,16,217,0,0,0,0,0,0,724
7583,MADHYA PRADESH,2013,20,OTHERS,59,218,194,115,60,646,61,257,137,70,26,551,0,0,0,0,0,0,1197
8167,MADHYA PRADESH,2013,20,"PHYSICAL ABUSE (RAPE,INCEST ETC.)",0,15,9,5,1,30,2,48,39,9,1,99,0,0,0,0,0,0,129
8674,MADHYA PRADESH,2013,20,SOCIETAL ISSUES,1,17,18,15,6,57,1,22,17,2,1,43,0,0,0,0,0,0,100
527,MADHYA PRADESH,2014,20,CAUSES NOT KNOWN,24,398,279,113,44,858,20,273,113,41,21,468,0,0,0,0,0,0,1326
1073,MADHYA PRADESH,2014,20,DEATH OF DEAR PERSON,0,19,25,7,3,54,1,19,2,4,1,27,0,0,0,0,0,0,81
1619,MADHYA PRADESH,2014,20,DOWRY DISPUTE,0,1,0,0,0,1,0,543,114,10,1,668,0,0,0,0,0,0,669
2165,MADHYA PRADESH,2014,20,DRUG ABUSE,1,113,108,59,4,285,0,8,10,1,1,20,0,0,0,0,0,0,305
2711,MADHYA PRADESH,2014,20,ECONOMIC ISSUES,0,104,101,63,14,282,0,29,33,21,7,90,0,0,0,0,0,0,372
3257,MADHYA PRADESH,2014,20,EXAM FAILURE,3,95,3,0,0,101,6,113,3,0,0,122,0,0,0,0,0,0,223
3803,MADHYA PRADESH,2014,20,FAMILY PROBLEMS,19,488,304,109,41,961,2,423,268,74,38,805,0,0,0,0,0,0,1766
4349,MADHYA PRADESH,2014,20,HEALTH ISSUES,10,697,551,365,196,1819,10,305,229,149,76,769,0,0,0,0,0,0,2588
4894,MADHYA PRADESH,2014,20,HERO WORSHIP,0,0,0,0,0,0,0,1,0,0,0,1,0,0,0,0,0,0,1
5439,MADHYA PRADESH,2014,20,ILLEGITIMATE PREGNANCY,0,0,0,0,0,0,0,1,0,0,0,1,0,0,0,0,0,0,1
5984,MADHYA PRADESH,2014,20,LOVE AFFAIRS,0,119,18,0,0,137,3,93,8,0,0,104,0,0,0,0,0,0,241
6530,MADHYA PRADESH,2014,20,MARITAL ISSUES,2,170,107,17,1,297,5,668,168,28,1,870,0,0,0,0,0,0,1167
7076,MADHYA PRADESH,2014,20,MENTAL HEALTH,2,153,121,81,20,377,4,65,55,27,10,161,0,0,0,0,0,0,538
7622,MADHYA PRADESH,2014,20,OTHERS,33,603,423,263,78,1400,13,509,182,82,23,809,0,0,0,0,0,0,2209
7661,MADHYA PRADESH,2014,20,PHYSICAL ABUSE,0,1,0,0,0,1,1,11,0,0,1,13,0,0,0,0,0,0,14
8713,MADHYA PRADESH,2014,20,SOCIETAL ISSUES,0,15,18,11,5,49,3,8,3,0,0,14,0,0,0,0,0,0,63
21,MAHARASHTRA,2001,21,CAUSES NOT KNOWN,45,414,543,240,113,1355,38,262,194,85,37,616,0,0,0,0,0,0,1971
567,MAHARASHTRA,2001,21,DEATH OF DEAR PERSON,0,15,18,15,13,61,1,19,14,3,2,39,0,0,0,0,0,0,100
1113,MAHARASHTRA,2001,21,DOWRY DISPUTE,0,1,0,0,0,1,0,340,65,1,0,406,0,0,0,0,0,0,407
1659,MAHARASHTRA,2001,21,DRUG ABUSE,0,113,224,126,29,492,0,2,1,3,0,6,0,0,0,0,0,0,498
2205,MAHARASHTRA,2001,21,ECONOMIC ISSUES,1,368,528,235,42,1174,0,56,80,41,15,192,0,0,0,0,0,0,1366
2751,MAHARASHTRA,2001,21,EXAM FAILURE,13,117,8,0,0,138,17,78,3,0,0,98,0,0,0,0,0,0,236
3297,MAHARASHTRA,2001,21,FAMILY PROBLEMS,45,956,1122,564,185,2872,44,1069,740,227,64,2144,0,0,0,0,0,0,5016
3843,MAHARASHTRA,2001,21,HEALTH ISSUES,14,420,795,541,339,2109,18,306,268,179,133,904,0,0,0,0,0,0,3013
4389,MAHARASHTRA,2001,21,HERO WORSHIP,0,0,0,0,0,0,0,0,0,0,0,0,0,0,0,0,0,0,0
4934,MAHARASHTRA,2001,21,ILLEGITIMATE PREGNANCY,0,0,0,0,0,0,0,3,0,0,0,3,0,0,0,0,0,0,3
5479,MAHARASHTRA,2001,21,LOVE AFFAIRS,0,72,35,3,0,110,2,116,12,1,0,131,0,0,0,0,0,0,241
6024,MAHARASHTRA,2001,21,MARITAL ISSUES,0,52,68,14,1,135,0,168,70,10,2,250,0,0,0,0,0,0,385
6570,MAHARASHTRA,2001,21,MENTAL HEALTH,8,219,265,166,65,723,12,134,123,61,34,364,0,0,0,0,0,0,1087
7116,MAHARASHTRA,2001,21,OTHERS,2,34,43,18,6,103,1,25,14,5,3,48,0,0,0,0,0,0,151
7701,MAHARASHTRA,2001,21,"PHYSICAL ABUSE (RAPE,INCEST ETC.)",0,3,1,0,1,5,0,31,13,1,0,45,0,0,0,0,0,0,50
8207,MAHARASHTRA,2001,21,SOCIETAL ISSUES,0,21,20,16,3,60,0,24,10,0,0,34,0,0,0,0,0,0,94
60,MAHARASHTRA,2002,21,CAUSES NOT KNOWN,15,310,393,211,99,1028,22,212,106,42,16,398,0,0,0,0,0,0,1426
606,MAHARASHTRA,2002,21,DEATH OF DEAR PERSON,0,16,24,17,4,61,0,17,15,5,9,46,0,0,0,0,0,0,107
1152,MAHARASHTRA,2002,21,DOWRY DISPUTE,0,0,0,0,0,0,0,246,53,0,0,299,0,0,0,0,0,0,299
1698,MAHARASHTRA,2002,21,DRUG ABUSE,0,127,316,140,36,619,0,0,4,4,0,8,0,0,0,0,0,0,627
2244,MAHARASHTRA,2002,21,ECONOMIC ISSUES,1,382,513,234,45,1175,0,97,87,22,7,213,0,0,0,0,0,0,1388
2790,MAHARASHTRA,2002,21,EXAM FAILURE,12,93,7,0,0,112,6,91,1,0,0,98,0,0,0,0,0,0,210
3336,MAHARASHTRA,2002,21,FAMILY PROBLEMS,47,955,1189,511,203,2905,48,1161,628,163,68,2068,0,0,0,0,0,0,4973
3882,MAHARASHTRA,2002,21,HEALTH ISSUES,5,452,758,508,458,2181,8,316,274,187,149,934,0,0,0,0,0,0,3115
4428,MAHARASHTRA,2002,21,HERO WORSHIP,0,2,0,0,1,3,0,1,0,0,0,1,0,0,0,0,0,0,4
4973,MAHARASHTRA,2002,21,ILLEGITIMATE PREGNANCY,0,0,0,0,0,0,0,10,3,0,0,13,0,0,0,0,0,0,13
5518,MAHARASHTRA,2002,21,LOVE AFFAIRS,0,106,23,2,0,131,7,101,24,0,0,132,0,0,0,0,0,0,263
6063,MAHARASHTRA,2002,21,MARITAL ISSUES,0,76,45,15,2,138,0,147,83,6,0,236,0,0,0,0,0,0,374
6609,MAHARASHTRA,2002,21,MENTAL HEALTH,12,254,309,175,96,846,11,168,127,95,48,449,0,0,0,0,0,0,1295
7155,MAHARASHTRA,2002,21,OTHERS,10,40,52,31,12,145,6,34,45,11,8,104,0,0,0,0,0,0,249
7740,MAHARASHTRA,2002,21,"PHYSICAL ABUSE (RAPE,INCEST ETC.)",0,8,10,2,0,20,2,30,20,3,1,56,0,0,0,0,0,0,76
8246,MAHARASHTRA,2002,21,SOCIETAL ISSUES,0,23,31,20,9,83,0,14,13,0,0,27,0,0,0,0,0,0,110
99,MAHARASHTRA,2003,21,CAUSES NOT KNOWN,1,135,117,62,21,336,2,81,48,17,8,156,0,0,0,0,0,0,492
645,MAHARASHTRA,2003,21,DEATH OF DEAR PERSON,0,24,25,15,8,72,2,23,20,11,2,58,0,0,0,0,0,0,130
1191,MAHARASHTRA,2003,21,DOWRY DISPUTE,3,1,0,0,0,4,0,252,53,5,0,310,0,0,0,0,0,0,314
1737,MAHARASHTRA,2003,21,DRUG ABUSE,0,130,361,227,45,763,0,1,2,2,0,5,0,0,0,0,0,0,768
2283,MAHARASHTRA,2003,21,ECONOMIC ISSUES,1,456,623,245,50,1375,1,94,54,17,5,171,0,0,0,0,0,0,1546
2829,MAHARASHTRA,2003,21,EXAM FAILURE,8,122,4,0,0,134,11,91,0,0,0,102,0,0,0,0,0,0,236
3375,MAHARASHTRA,2003,21,FAMILY PROBLEMS,55,1128,1274,681,184,3322,40,1186,669,206,68,2169,0,0,0,0,0,0,5491
3921,MAHARASHTRA,2003,21,HEALTH ISSUES,8,573,824,645,394,2444,17,315,413,212,137,1094,0,0,0,0,0,0,3538
4467,MAHARASHTRA,2003,21,HERO WORSHIP,0,5,4,9,0,18,0,2,0,4,0,6,0,0,0,0,0,0,24
5012,MAHARASHTRA,2003,21,ILLEGITIMATE PREGNANCY,0,0,0,0,0,0,1,14,1,0,0,16,0,0,0,0,0,0,16
5557,MAHARASHTRA,2003,21,LOVE AFFAIRS,0,108,20,2,0,130,4,87,11,0,0,102,0,0,0,0,0,0,232
6102,MAHARASHTRA,2003,21,MARITAL ISSUES,0,53,55,8,1,117,0,127,73,7,0,207,0,0,0,0,0,0,324
6648,MAHARASHTRA,2003,21,MENTAL HEALTH,9,231,305,144,71,760,4,127,153,66,31,381,0,0,0,0,0,0,1141
7194,MAHARASHTRA,2003,21,OTHERS,13,81,97,49,15,255,7,44,11,7,3,72,0,0,0,0,0,0,327
7779,MAHARASHTRA,2003,21,"PHYSICAL ABUSE (RAPE,INCEST ETC.)",1,1,2,1,0,5,0,23,25,5,4,57,0,0,0,0,0,0,62
8285,MAHARASHTRA,2003,21,SOCIETAL ISSUES,0,18,36,18,3,75,3,19,19,2,1,44,0,0,0,0,0,0,119
138,MAHARASHTRA,2004,21,CAUSES NOT KNOWN,4,96,141,86,20,347,3,40,12,5,1,61,0,0,0,0,0,0,408
684,MAHARASHTRA,2004,21,DEATH OF DEAR PERSON,2,25,23,21,8,79,1,17,18,12,5,53,0,0,0,0,0,0,132
1230,MAHARASHTRA,2004,21,DOWRY DISPUTE,0,0,2,2,0,4,0,269,61,2,0,332,0,0,0,0,0,0,336
1776,MAHARASHTRA,2004,21,DRUG ABUSE,0,166,469,271,58,964,0,0,7,1,0,8,0,0,0,0,0,0,972
2322,MAHARASHTRA,2004,21,ECONOMIC ISSUES,0,521,630,300,56,1507,1,53,78,32,10,174,0,0,0,0,0,0,1681
2868,MAHARASHTRA,2004,21,EXAM FAILURE,18,147,2,0,0,167,10,122,2,0,0,134,0,0,0,0,0,0,301
3414,MAHARASHTRA,2004,21,FAMILY PROBLEMS,41,1029,1149,598,178,2995,40,1175,557,148,42,1962,0,0,0,0,0,0,4957
3960,MAHARASHTRA,2004,21,HEALTH ISSUES,10,559,840,642,438,2489,20,411,321,240,164,1156,0,0,0,0,0,0,3645
4506,MAHARASHTRA,2004,21,HERO WORSHIP,0,4,10,2,3,19,0,1,0,0,0,1,0,0,0,0,0,0,20
5051,MAHARASHTRA,2004,21,ILLEGITIMATE PREGNANCY,0,0,0,0,0,0,0,6,0,0,0,6,0,0,0,0,0,0,6
5596,MAHARASHTRA,2004,21,LOVE AFFAIRS,0,94,18,3,0,115,2,85,7,1,0,95,0,0,0,0,0,0,210
6141,MAHARASHTRA,2004,21,MARITAL ISSUES,0,80,75,17,1,173,0,138,80,10,0,228,0,0,0,0,0,0,401
6687,MAHARASHTRA,2004,21,MENTAL HEALTH,5,275,302,150,77,809,8,192,174,76,44,494,0,0,0,0,0,0,1303
7233,MAHARASHTRA,2004,21,OTHERS,7,40,46,24,11,128,5,32,14,4,3,58,0,0,0,0,0,0,186
7818,MAHARASHTRA,2004,21,"PHYSICAL ABUSE (RAPE,INCEST ETC.)",0,3,2,1,0,6,1,14,8,1,0,24,0,0,0,0,0,0,30
8324,MAHARASHTRA,2004,21,SOCIETAL ISSUES,0,41,29,21,10,101,2,18,14,4,2,40,0,0,0,0,0,0,141
177,MAHARASHTRA,2005,21,CAUSES NOT KNOWN,3,109,133,72,30,347,4,90,38,15,3,150,0,0,0,0,0,0,497
723,MAHARASHTRA,2005,21,DEATH OF DEAR PERSON,0,29,28,23,9,89,1,14,23,6,6,50,0,0,0,0,0,0,139
1269,MAHARASHTRA,2005,21,DOWRY DISPUTE,0,0,0,0,0,0,0,254,46,0,0,300,0,0,0,0,0,0,300
1815,MAHARASHTRA,2005,21,DRUG ABUSE,0,203,502,252,59,1016,0,1,3,1,0,5,0,0,0,0,0,0,1021
2361,MAHARASHTRA,2005,21,ECONOMIC ISSUES,0,426,572,309,75,1382,0,81,64,33,6,184,0,0,0,0,0,0,1566
2907,MAHARASHTRA,2005,21,EXAM FAILURE,14,129,2,0,0,145,11,129,0,0,0,140,0,0,0,0,0,0,285
3453,MAHARASHTRA,2005,21,FAMILY PROBLEMS,38,922,1122,594,173,2849,32,1150,600,156,39,1977,0,0,0,0,0,0,4826
3999,MAHARASHTRA,2005,21,HEALTH ISSUES,6,401,704,583,443,2137,14,343,288,236,196,1077,0,0,0,0,0,0,3214
4545,MAHARASHTRA,2005,21,HERO WORSHIP,0,5,1,4,0,10,0,1,0,0,0,1,0,0,0,0,0,0,11
5090,MAHARASHTRA,2005,21,ILLEGITIMATE PREGNANCY,0,0,0,0,0,0,0,9,3,0,0,12,0,0,0,0,0,0,12
5635,MAHARASHTRA,2005,21,LOVE AFFAIRS,0,129,23,5,0,157,3,76,4,1,0,84,0,0,0,0,0,0,241
6180,MAHARASHTRA,2005,21,MARITAL ISSUES,0,81,54,26,0,161,0,159,46,7,0,212,0,0,0,0,0,0,373
6726,MAHARASHTRA,2005,21,MENTAL HEALTH,7,314,325,150,91,887,6,180,145,85,32,448,0,0,0,0,0,0,1335
7272,MAHARASHTRA,2005,21,OTHERS,7,95,120,66,32,320,6,91,20,7,4,128,0,0,0,0,0,0,448
7857,MAHARASHTRA,2005,21,"PHYSICAL ABUSE (RAPE,INCEST ETC.)",0,2,7,2,0,11,1,16,4,1,0,22,0,0,0,0,0,0,33
8363,MAHARASHTRA,2005,21,SOCIETAL ISSUES,0,32,38,15,7,92,1,19,12,1,0,33,0,0,0,0,0,0,125
216,MAHARASHTRA,2006,21,CAUSES NOT KNOWN,2,114,97,37,5,255,4,68,10,7,2,91,0,0,0,0,0,0,346
762,MAHARASHTRA,2006,21,DEATH OF DEAR PERSON,2,25,32,15,9,83,3,30,25,7,0,65,0,0,0,0,0,0,148
1308,MAHARASHTRA,2006,21,DOWRY DISPUTE,0,0,0,0,0,0,0,200,42,1,0,243,0,0,0,0,0,0,243
1854,MAHARASHTRA,2006,21,DRUG ABUSE,0,167,483,269,51,970,0,1,3,0,0,4,0,0,0,0,0,0,974
2400,MAHARASHTRA,2006,21,ECONOMIC ISSUES,0,487,884,443,141,1955,0,80,80,31,13,204,0,0,0,0,0,0,2159
2946,MAHARASHTRA,2006,21,EXAM FAILURE,10,131,5,2,0,148,11,122,0,0,0,133,0,0,0,0,0,0,281
3492,MAHARASHTRA,2006,21,FAMILY PROBLEMS,27,1034,1192,652,210,3115,36,1318,658,187,66,2265,0,0,0,0,0,0,5380
4038,MAHARASHTRA,2006,21,HEALTH ISSUES,11,496,772,588,454,2321,12,351,281,201,184,1029,0,0,0,0,0,0,3350
4583,MAHARASHTRA,2006,21,HERO WORSHIP,0,4,4,1,0,9,0,3,1,0,0,4,0,0,0,0,0,0,13
5128,MAHARASHTRA,2006,21,ILLEGITIMATE PREGNANCY,0,0,0,0,0,0,1,14,3,0,0,18,0,0,0,0,0,0,18
5673,MAHARASHTRA,2006,21,LOVE AFFAIRS,0,96,16,4,0,116,0,94,14,1,0,109,0,0,0,0,0,0,225
6219,MAHARASHTRA,2006,21,MARITAL ISSUES,0,91,58,26,2,177,1,135,43,2,2,183,0,0,0,0,0,0,360
6765,MAHARASHTRA,2006,21,MENTAL HEALTH,12,274,311,183,72,852,10,163,171,76,52,472,0,0,0,0,0,0,1324
7311,MAHARASHTRA,2006,21,OTHERS,1,138,157,90,35,421,5,76,24,6,6,117,0,0,0,0,0,0,538
7895,MAHARASHTRA,2006,21,"PHYSICAL ABUSE (RAPE,INCEST ETC.)",0,2,1,2,1,6,1,8,1,1,0,11,0,0,0,0,0,0,17
8402,MAHARASHTRA,2006,21,SOCIETAL ISSUES,3,29,30,14,6,82,1,20,10,5,0,36,0,0,0,0,0,0,118
255,MAHARASHTRA,2007,21,CAUSES NOT KNOWN,2,80,110,44,14,250,7,63,41,15,3,129,0,0,0,0,0,0,379
801,MAHARASHTRA,2007,21,DEATH OF DEAR PERSON,0,23,25,17,8,73,0,37,26,3,8,74,0,0,0,0,0,0,147
1347,MAHARASHTRA,2007,21,DOWRY DISPUTE,0,2,4,0,2,8,0,266,68,0,0,334,0,0,0,0,0,0,342
1893,MAHARASHTRA,2007,21,DRUG ABUSE,0,224,483,282,73,1062,0,4,3,5,0,12,0,0,0,0,0,0,1074
2439,MAHARASHTRA,2007,21,ECONOMIC ISSUES,1,478,777,538,168,1962,1,72,59,17,2,151,0,0,0,0,0,0,2113
2985,MAHARASHTRA,2007,21,EXAM FAILURE,6,110,4,0,0,120,1,109,0,0,0,110,0,0,0,0,0,0,230
3531,MAHARASHTRA,2007,21,FAMILY PROBLEMS,20,1021,1225,641,185,3092,29,1258,558,211,59,2115,0,0,0,0,0,0,5207
4077,MAHARASHTRA,2007,21,HEALTH ISSUES,3,426,656,596,426,2107,20,312,264,167,155,918,0,0,0,0,0,0,3025
4622,MAHARASHTRA,2007,21,HERO WORSHIP,0,1,2,0,1,4,0,0,0,0,0,0,0,0,0,0,0,0,4
5167,MAHARASHTRA,2007,21,ILLEGITIMATE PREGNANCY,0,0,0,0,0,0,0,6,4,0,0,10,0,0,0,0,0,0,10
5712,MAHARASHTRA,2007,21,LOVE AFFAIRS,0,108,18,4,0,130,1,83,7,1,0,92,0,0,0,0,0,0,222
6258,MAHARASHTRA,2007,21,MARITAL ISSUES,0,79,55,20,5,159,0,127,50,4,0,181,0,0,0,0,0,0,340
6804,MAHARASHTRA,2007,21,MENTAL HEALTH,5,293,356,189,94,937,8,173,145,80,63,469,0,0,0,0,0,0,1406
7350,MAHARASHTRA,2007,21,OTHERS,5,126,144,68,39,382,6,69,17,6,5,103,0,0,0,0,0,0,485
7934,MAHARASHTRA,2007,21,"PHYSICAL ABUSE (RAPE,INCEST ETC.)",0,4,1,0,0,5,1,12,1,0,0,14,0,0,0,0,0,0,19
8441,MAHARASHTRA,2007,21,SOCIETAL ISSUES,0,47,48,26,8,129,0,27,18,6,1,52,0,0,0,0,0,0,181
294,MAHARASHTRA,2008,21,CAUSES NOT KNOWN,3,121,127,63,12,326,4,69,39,11,3,126,0,0,0,0,0,0,452
840,MAHARASHTRA,2008,21,DEATH OF DEAR PERSON,0,15,29,18,5,67,1,29,11,5,2,48,0,0,0,0,0,0,115
1386,MAHARASHTRA,2008,21,DOWRY DISPUTE,0,1,0,0,0,1,0,217,36,0,0,253,0,0,0,0,0,0,254
1932,MAHARASHTRA,2008,21,DRUG ABUSE,0,252,464,253,53,1022,0,4,3,3,0,10,0,0,0,0,0,0,1032
2478,MAHARASHTRA,2008,21,ECONOMIC ISSUES,0,448,704,477,129,1758,0,40,33,20,5,98,0,0,0,0,0,0,1856
3024,MAHARASHTRA,2008,21,EXAM FAILURE,11,119,1,0,0,131,7,98,0,0,0,105,0,0,0,0,0,0,236
3570,MAHARASHTRA,2008,21,FAMILY PROBLEMS,25,1102,1249,679,166,3221,33,1183,644,144,67,2071,0,0,0,0,0,0,5292
4116,MAHARASHTRA,2008,21,HEALTH ISSUES,2,388,624,507,380,1901,7,256,238,163,165,829,0,0,0,0,0,0,2730
4661,MAHARASHTRA,2008,21,HERO WORSHIP,0,0,0,0,0,0,0,0,0,0,0,0,0,0,0,0,0,0,0
5206,MAHARASHTRA,2008,21,ILLEGITIMATE PREGNANCY,0,0,0,0,0,0,0,3,2,0,0,5,0,0,0,0,0,0,5
5751,MAHARASHTRA,2008,21,LOVE AFFAIRS,0,88,20,4,0,112,4,83,5,1,0,93,0,0,0,0,0,0,205
6297,MAHARASHTRA,2008,21,MARITAL ISSUES,0,73,55,12,1,141,1,143,51,7,0,202,0,0,0,0,0,0,343
6843,MAHARASHTRA,2008,21,MENTAL HEALTH,3,283,301,143,71,801,9,168,152,91,42,462,0,0,0,0,0,0,1263
7389,MAHARASHTRA,2008,21,OTHERS,3,112,122,69,11,317,7,95,32,10,5,149,0,0,0,0,0,0,466
7973,MAHARASHTRA,2008,21,"PHYSICAL ABUSE (RAPE,INCEST ETC.)",0,7,1,1,2,11,1,11,3,1,1,17,0,0,0,0,0,0,28
8480,MAHARASHTRA,2008,21,SOCIETAL ISSUES,0,27,28,21,4,80,0,13,2,2,0,17,0,0,0,0,0,0,97
333,MAHARASHTRA,2009,21,CAUSES NOT KNOWN,2,104,111,36,14,267,5,51,16,3,3,78,0,0,0,0,0,0,345
879,MAHARASHTRA,2009,21,DEATH OF DEAR PERSON,0,22,40,21,9,92,0,20,15,5,2,42,0,0,0,0,0,0,134
1425,MAHARASHTRA,2009,21,DOWRY DISPUTE,0,0,0,0,0,0,0,181,30,0,0,211,0,0,0,0,0,0,211
1971,MAHARASHTRA,2009,21,DRUG ABUSE,0,257,556,314,64,1191,0,1,2,4,1,8,0,0,0,0,0,0,1199
2517,MAHARASHTRA,2009,21,ECONOMIC ISSUES,0,406,677,392,112,1587,1,57,52,27,3,140,0,0,0,0,0,0,1727
3063,MAHARASHTRA,2009,21,EXAM FAILURE,6,106,2,1,0,115,9,101,2,0,0,112,0,0,0,0,0,0,227
3609,MAHARASHTRA,2009,21,FAMILY PROBLEMS,21,1063,1240,648,192,3164,22,1196,662,190,45,2115,0,0,0,0,0,0,5279
4155,MAHARASHTRA,2009,21,HEALTH ISSUES,3,394,602,555,462,2016,4,269,291,179,177,920,0,0,0,0,0,0,2936
4700,MAHARASHTRA,2009,21,HERO WORSHIP,1,1,4,0,0,6,0,4,0,1,0,5,0,0,0,0,0,0,11
5245,MAHARASHTRA,2009,21,ILLEGITIMATE PREGNANCY,0,0,0,0,0,0,1,5,1,1,0,8,0,0,0,0,0,0,8
5790,MAHARASHTRA,2009,21,LOVE AFFAIRS,0,92,9,1,0,102,1,88,12,0,0,101,0,0,0,0,0,0,203
6336,MAHARASHTRA,2009,21,MARITAL ISSUES,0,77,57,17,1,152,1,130,38,4,0,173,0,0,0,0,0,0,325
6882,MAHARASHTRA,2009,21,MENTAL HEALTH,7,262,247,135,80,731,4,152,139,80,43,418,0,0,0,0,0,0,1149
7428,MAHARASHTRA,2009,21,OTHERS,8,107,129,63,25,332,6,102,26,6,2,142,0,0,0,0,0,0,474
8012,MAHARASHTRA,2009,21,"PHYSICAL ABUSE (RAPE,INCEST ETC.)",0,0,2,0,0,2,0,19,5,2,0,26,0,0,0,0,0,0,28
8519,MAHARASHTRA,2009,21,SOCIETAL ISSUES,0,10,10,7,1,28,1,11,3,1,0,16,0,0,0,0,0,0,44
372,MAHARASHTRA,2010,21,CAUSES NOT KNOWN,2,136,153,92,40,423,5,88,23,10,2,128,0,0,0,0,0,0,551
918,MAHARASHTRA,2010,21,DEATH OF DEAR PERSON,0,26,28,15,12,81,1,25,16,9,7,58,0,0,0,0,0,0,139
1464,MAHARASHTRA,2010,21,DOWRY DISPUTE,0,0,0,0,0,0,0,180,61,0,0,241,0,0,0,0,0,0,241
2010,MAHARASHTRA,2010,21,DRUG ABUSE,0,341,613,343,89,1386,0,1,5,5,3,14,0,0,0,0,0,0,1400
2556,MAHARASHTRA,2010,21,ECONOMIC ISSUES,0,401,508,331,107,1347,2,63,35,12,6,118,0,0,0,0,0,0,1465
3102,MAHARASHTRA,2010,21,EXAM FAILURE,11,159,5,1,0,176,14,198,0,0,0,212,0,0,0,0,0,0,388
3648,MAHARASHTRA,2010,21,FAMILY PROBLEMS,24,1306,1493,715,189,3727,40,1354,664,215,57,2330,0,0,0,0,0,0,6057
4194,MAHARASHTRA,2010,21,HEALTH ISSUES,4,395,617,573,447,2036,11,336,281,177,169,974,0,0,0,0,0,0,3010
4739,MAHARASHTRA,2010,21,HERO WORSHIP,0,0,1,1,0,2,1,1,0,0,0,2,0,0,0,0,0,0,4
5284,MAHARASHTRA,2010,21,ILLEGITIMATE PREGNANCY,0,0,0,0,0,0,0,9,6,0,0,15,0,0,0,0,0,0,15
5829,MAHARASHTRA,2010,21,LOVE AFFAIRS,0,114,23,1,0,138,3,97,14,0,0,114,0,0,0,0,0,0,252
6375,MAHARASHTRA,2010,21,MARITAL ISSUES,0,95,63,11,0,169,0,119,45,6,0,170,0,0,0,0,0,0,339
6921,MAHARASHTRA,2010,21,MENTAL HEALTH,5,311,284,161,78,839,7,176,128,77,48,436,0,0,0,0,0,0,1275
7467,MAHARASHTRA,2010,21,OTHERS,3,152,146,94,25,420,7,98,28,7,5,145,0,0,0,0,0,0,565
8051,MAHARASHTRA,2010,21,"PHYSICAL ABUSE (RAPE,INCEST ETC.)",0,0,0,0,0,0,1,14,4,1,0,20,0,0,0,0,0,0,20
8558,MAHARASHTRA,2010,21,SOCIETAL ISSUES,0,49,38,25,2,114,3,45,24,5,4,81,0,0,0,0,0,0,195
411,MAHARASHTRA,2011,21,CAUSES NOT KNOWN,5,173,152,86,44,460,9,80,34,11,3,137,0,0,0,0,0,0,597
957,MAHARASHTRA,2011,21,DEATH OF DEAR PERSON,0,31,28,12,10,81,1,29,12,5,4,51,0,0,0,0,0,0,132
1503,MAHARASHTRA,2011,21,DOWRY DISPUTE,0,0,2,0,0,2,0,171,41,3,0,215,0,0,0,0,0,0,217
2049,MAHARASHTRA,2011,21,DRUG ABUSE,0,353,606,359,85,1403,0,2,7,2,3,14,0,0,0,0,0,0,1417
2595,MAHARASHTRA,2011,21,ECONOMIC ISSUES,0,347,486,358,97,1288,3,40,29,14,7,93,0,0,0,0,0,0,1381
3141,MAHARASHTRA,2011,21,EXAM FAILURE,4,147,3,0,0,154,6,146,2,0,0,154,0,0,0,0,0,0,308
3687,MAHARASHTRA,2011,21,FAMILY PROBLEMS,21,1354,1530,757,210,3872,37,1406,784,212,56,2495,0,0,0,0,0,0,6367
4233,MAHARASHTRA,2011,21,HEALTH ISSUES,7,375,616,504,472,1974,4,296,263,186,180,929,0,0,0,0,0,0,2903
4778,MAHARASHTRA,2011,21,HERO WORSHIP,2,2,7,0,0,11,0,1,3,0,0,4,0,0,0,0,0,0,15
5323,MAHARASHTRA,2011,21,ILLEGITIMATE PREGNANCY,0,0,0,0,0,0,0,4,4,1,0,9,0,0,0,0,0,0,9
5868,MAHARASHTRA,2011,21,LOVE AFFAIRS,0,128,26,1,0,155,7,108,11,0,0,126,0,0,0,0,0,0,281
6414,MAHARASHTRA,2011,21,MARITAL ISSUES,0,101,62,12,4,179,0,126,65,5,0,196,0,0,0,0,0,0,375
6960,MAHARASHTRA,2011,21,MENTAL HEALTH,2,265,264,151,83,765,5,162,130,85,38,420,0,0,0,0,0,0,1185
7506,MAHARASHTRA,2011,21,OTHERS,5,187,152,91,48,483,6,126,30,5,4,171,0,0,0,0,0,0,654
8090,MAHARASHTRA,2011,21,"PHYSICAL ABUSE (RAPE,INCEST ETC.)",0,0,0,0,0,0,1,16,1,0,0,18,0,0,0,0,0,0,18
8597,MAHARASHTRA,2011,21,SOCIETAL ISSUES,0,14,26,18,2,60,1,15,6,5,1,28,0,0,0,0,0,0,88
450,MAHARASHTRA,2012,21,CAUSES NOT KNOWN,9,179,152,107,37,484,2,76,37,5,3,123,0,0,0,0,0,0,607
996,MAHARASHTRA,2012,21,DEATH OF DEAR PERSON,0,27,35,19,15,96,2,27,23,7,7,66,0,0,0,0,0,0,162
1542,MAHARASHTRA,2012,21,DOWRY DISPUTE,0,2,0,0,0,2,0,139,64,22,0,225,0,0,0,0,0,0,227
2088,MAHARASHTRA,2012,21,DRUG ABUSE,0,439,693,453,92,1677,0,1,4,7,0,12,0,0,0,0,0,0,1689
2634,MAHARASHTRA,2012,21,ECONOMIC ISSUES,0,329,446,318,90,1183,1,38,24,14,4,81,0,0,0,0,0,0,1264
3180,MAHARASHTRA,2012,21,EXAM FAILURE,15,148,3,0,0,166,15,156,9,0,0,180,0,0,0,0,0,0,346
3726,MAHARASHTRA,2012,21,FAMILY PROBLEMS,27,1362,1557,873,255,4074,41,1320,740,259,62,2422,0,0,0,0,0,0,6496
4272,MAHARASHTRA,2012,21,HEALTH ISSUES,4,385,581,588,450,2008,8,271,251,182,183,895,0,0,0,0,0,0,2903
4817,MAHARASHTRA,2012,21,HERO WORSHIP,1,0,0,0,0,1,0,1,0,0,0,1,0,0,0,0,0,0,2
5362,MAHARASHTRA,2012,21,ILLEGITIMATE PREGNANCY,0,0,0,0,0,0,0,5,1,0,0,6,0,0,0,0,0,0,6
5907,MAHARASHTRA,2012,21,LOVE AFFAIRS,1,145,27,0,0,173,1,117,6,0,0,124,0,0,0,0,0,0,297
6453,MAHARASHTRA,2012,21,MARITAL ISSUES,0,87,67,15,0,169,0,122,36,8,0,166,0,0,0,0,0,0,335
6999,MAHARASHTRA,2012,21,MENTAL HEALTH,7,218,267,175,71,738,5,164,91,62,36,358,0,0,0,0,0,0,1096
7545,MAHARASHTRA,2012,21,OTHERS,8,164,157,120,42,491,8,74,21,7,10,120,0,0,0,0,0,0,611
8129,MAHARASHTRA,2012,21,"PHYSICAL ABUSE (RAPE,INCEST ETC.)",0,0,0,0,0,0,0,11,1,1,0,13,0,0,0,0,0,0,13
8636,MAHARASHTRA,2012,21,SOCIETAL ISSUES,1,11,13,11,6,42,0,9,5,0,2,16,0,0,0,0,0,0,58
489,MAHARASHTRA,2013,21,CAUSES NOT KNOWN,13,228,215,117,42,615,13,127,46,12,9,207,0,0,0,0,0,0,822
1035,MAHARASHTRA,2013,21,DEATH OF DEAR PERSON,0,26,33,22,12,93,2,14,18,10,5,49,0,0,0,0,0,0,142
1581,MAHARASHTRA,2013,21,DOWRY DISPUTE,0,0,0,0,0,0,0,150,41,0,0,191,0,0,0,0,0,0,191
2127,MAHARASHTRA,2013,21,DRUG ABUSE,2,427,800,452,100,1781,0,3,3,6,1,13,0,0,0,0,0,0,1794
2673,MAHARASHTRA,2013,21,ECONOMIC ISSUES,0,371,574,336,78,1359,0,44,34,26,9,113,0,0,0,0,0,0,1472
3219,MAHARASHTRA,2013,21,EXAM FAILURE,21,160,3,1,0,185,18,145,1,0,0,164,0,0,0,0,0,0,349
3765,MAHARASHTRA,2013,21,FAMILY PROBLEMS,28,1344,1543,902,277,4094,39,1163,758,227,72,2259,0,0,0,0,0,0,6353
4311,MAHARASHTRA,2013,21,HEALTH ISSUES,7,345,621,599,540,2112,15,257,228,168,192,860,0,0,0,0,0,0,2972
4856,MAHARASHTRA,2013,21,HERO WORSHIP,1,7,3,0,1,12,1,11,1,0,0,13,0,0,0,0,0,0,25
5401,MAHARASHTRA,2013,21,ILLEGITIMATE PREGNANCY,0,0,0,0,0,0,0,5,0,0,0,5,0,0,0,0,0,0,5
5946,MAHARASHTRA,2013,21,LOVE AFFAIRS,0,138,17,1,0,156,1,91,8,1,0,101,0,0,0,0,0,0,257
6492,MAHARASHTRA,2013,21,MARITAL ISSUES,0,96,70,22,10,198,0,121,53,8,1,183,0,0,0,0,0,0,381
7038,MAHARASHTRA,2013,21,MENTAL HEALTH,7,224,290,147,64,732,5,125,134,73,36,373,0,0,0,0,0,0,1105
7584,MAHARASHTRA,2013,21,OTHERS,12,178,174,99,30,493,11,100,29,9,7,156,0,0,0,0,0,0,649
8168,MAHARASHTRA,2013,21,"PHYSICAL ABUSE (RAPE,INCEST ETC.)",0,0,0,0,0,0,1,17,3,3,0,24,0,0,0,0,0,0,24
8675,MAHARASHTRA,2013,21,SOCIETAL ISSUES,0,17,24,12,9,62,0,12,6,1,0,19,0,0,0,0,0,0,81
528,MAHARASHTRA,2014,21,CAUSES NOT KNOWN,8,266,272,146,75,767,5,145,53,16,15,234,0,1,0,0,0,1,1002
1074,MAHARASHTRA,2014,21,DEATH OF DEAR PERSON,0,22,36,23,16,97,0,24,21,9,3,57,0,0,0,0,0,0,154
1620,MAHARASHTRA,2014,21,DOWRY DISPUTE,0,0,0,0,1,1,0,150,29,6,0,185,0,0,0,0,0,0,186
2166,MAHARASHTRA,2014,21,DRUG ABUSE,1,385,585,309,87,1367,0,2,0,1,2,5,0,0,0,0,0,0,1372
2712,MAHARASHTRA,2014,21,ECONOMIC ISSUES,0,436,604,388,109,1537,1,62,53,26,5,147,0,0,0,0,0,0,1684
3258,MAHARASHTRA,2014,21,EXAM FAILURE,8,186,3,0,0,197,12,149,1,0,0,162,0,0,0,0,0,0,359
3804,MAHARASHTRA,2014,21,FAMILY PROBLEMS,17,1335,1351,670,191,3564,29,1001,541,155,46,1772,0,0,0,0,0,0,5336
4350,MAHARASHTRA,2014,21,HEALTH ISSUES,3,886,1354,1072,836,4151,6,608,512,344,363,1833,0,1,2,0,0,3,5987
4895,MAHARASHTRA,2014,21,HERO WORSHIP,1,2,5,4,1,13,2,2,2,0,0,6,0,0,0,0,0,0,19
5440,MAHARASHTRA,2014,21,ILLEGITIMATE PREGNANCY,0,0,0,0,0,0,0,7,4,0,0,11,0,0,0,0,0,0,11
5985,MAHARASHTRA,2014,21,LOVE AFFAIRS,0,155,20,2,0,177,3,118,13,0,0,134,0,0,0,0,0,0,311
6531,MAHARASHTRA,2014,21,MARITAL ISSUES,0,230,207,49,16,502,5,461,157,39,1,663,0,0,0,0,0,0,1165
7077,MAHARASHTRA,2014,21,MENTAL HEALTH,1,222,242,128,58,651,4,146,120,74,41,385,0,1,0,0,0,1,1037
7623,MAHARASHTRA,2014,21,OTHERS,8,526,512,318,99,1463,8,215,104,42,28,397,0,0,0,0,0,0,1860
7662,MAHARASHTRA,2014,21,PHYSICAL ABUSE,0,0,0,2,0,2,2,19,4,2,0,27,0,0,0,0,0,0,29
8714,MAHARASHTRA,2014,21,SOCIETAL ISSUES,0,14,16,19,4,53,0,5,1,2,1,9,0,0,0,0,0,0,62
22,MANIPUR,2001,22,CAUSES NOT KNOWN,1,11,4,5,1,22,0,10,5,1,0,16,0,0,0,0,0,0,38
568,MANIPUR,2001,22,DEATH OF DEAR PERSON,0,0,0,0,0,0,0,0,0,0,0,0,0,0,0,0,0,0,0
1114,MANIPUR,2001,22,DOWRY DISPUTE,0,0,0,0,0,0,0,0,0,0,0,0,0,0,0,0,0,0,0
1660,MANIPUR,2001,22,DRUG ABUSE,0,1,1,0,0,2,0,0,0,0,0,0,0,0,0,0,0,0,2
2206,MANIPUR,2001,22,ECONOMIC ISSUES,0,0,0,0,0,0,0,0,0,0,0,0,0,0,0,0,0,0,0
2752,MANIPUR,2001,22,EXAM FAILURE,0,0,0,0,0,0,0,0,0,0,0,0,0,0,0,0,0,0,0
3298,MANIPUR,2001,22,FAMILY PROBLEMS,0,0,0,0,0,0,0,1,0,0,0,1,0,0,0,0,0,0,1
3844,MANIPUR,2001,22,HEALTH ISSUES,0,0,0,0,0,0,0,0,0,0,0,0,0,0,0,0,0,0,0
4390,MANIPUR,2001,22,HERO WORSHIP,0,0,0,0,0,0,0,0,0,0,0,0,0,0,0,0,0,0,0
4935,MANIPUR,2001,22,ILLEGITIMATE PREGNANCY,0,0,0,0,0,0,0,0,0,0,0,0,0,0,0,0,0,0,0
5480,MANIPUR,2001,22,LOVE AFFAIRS,0,0,0,0,0,0,0,0,0,0,0,0,0,0,0,0,0,0,0
6025,MANIPUR,2001,22,MARITAL ISSUES,0,0,0,0,0,0,0,0,0,0,0,0,0,0,0,0,0,0,0
6571,MANIPUR,2001,22,MENTAL HEALTH,0,0,0,0,0,0,0,0,0,0,0,0,0,0,0,0,0,0,0
7117,MANIPUR,2001,22,OTHERS,0,0,0,0,0,0,0,0,0,0,0,0,0,0,0,0,0,0,0
7702,MANIPUR,2001,22,"PHYSICAL ABUSE (RAPE,INCEST ETC.)",0,0,0,0,0,0,0,0,0,0,0,0,0,0,0,0,0,0,0
8208,MANIPUR,2001,22,SOCIETAL ISSUES,0,0,0,0,0,0,0,0,0,0,0,0,0,0,0,0,0,0,0
61,MANIPUR,2002,22,CAUSES NOT KNOWN,0,9,8,9,4,30,0,7,1,1,0,9,0,0,0,0,0,0,39
607,MANIPUR,2002,22,DEATH OF DEAR PERSON,0,0,0,0,0,0,0,0,0,0,0,0,0,0,0,0,0,0,0
1153,MANIPUR,2002,22,DOWRY DISPUTE,0,0,0,0,0,0,0,0,0,0,0,0,0,0,0,0,0,0,0
1699,MANIPUR,2002,22,DRUG ABUSE,0,0,0,0,0,0,0,0,0,0,0,0,0,0,0,0,0,0,0
2245,MANIPUR,2002,22,ECONOMIC ISSUES,0,0,0,0,0,0,0,0,0,0,0,0,0,0,0,0,0,0,0
2791,MANIPUR,2002,22,EXAM FAILURE,0,0,0,0,0,0,0,0,0,0,0,0,0,0,0,0,0,0,0
3337,MANIPUR,2002,22,FAMILY PROBLEMS,0,0,0,0,0,0,0,0,0,0,0,0,0,0,0,0,0,0,0
3883,MANIPUR,2002,22,HEALTH ISSUES,0,0,0,0,0,0,0,0,0,0,0,0,0,0,0,0,0,0,0
4429,MANIPUR,2002,22,HERO WORSHIP,0,0,0,0,0,0,0,0,0,0,0,0,0,0,0,0,0,0,0
4974,MANIPUR,2002,22,ILLEGITIMATE PREGNANCY,0,0,0,0,0,0,0,0,0,0,0,0,0,0,0,0,0,0,0
5519,MANIPUR,2002,22,LOVE AFFAIRS,0,0,0,0,0,0,0,0,0,0,0,0,0,0,0,0,0,0,0
6064,MANIPUR,2002,22,MARITAL ISSUES,0,0,0,0,0,0,0,0,0,0,0,0,0,0,0,0,0,0,0
6610,MANIPUR,2002,22,MENTAL HEALTH,0,0,0,0,0,0,0,0,0,0,0,0,0,0,0,0,0,0,0
7156,MANIPUR,2002,22,OTHERS,0,0,0,0,0,0,0,0,0,0,0,0,0,0,0,0,0,0,0
7741,MANIPUR,2002,22,"PHYSICAL ABUSE (RAPE,INCEST ETC.)",0,0,0,0,0,0,0,0,0,0,0,0,0,0,0,0,0,0,0
8247,MANIPUR,2002,22,SOCIETAL ISSUES,0,0,0,0,0,0,0,0,0,0,0,0,0,0,0,0,0,0,0
100,MANIPUR,2003,22,CAUSES NOT KNOWN,0,9,6,3,3,21,0,4,0,0,1,5,0,0,0,0,0,0,26
646,MANIPUR,2003,22,DEATH OF DEAR PERSON,0,0,0,0,0,0,0,0,0,0,0,0,0,0,0,0,0,0,0
1192,MANIPUR,2003,22,DOWRY DISPUTE,0,0,0,0,0,0,0,0,0,0,0,0,0,0,0,0,0,0,0
1738,MANIPUR,2003,22,DRUG ABUSE,0,0,0,0,0,0,0,0,0,0,0,0,0,0,0,0,0,0,0
2284,MANIPUR,2003,22,ECONOMIC ISSUES,0,0,0,0,0,0,0,0,0,0,0,0,0,0,0,0,0,0,0
2830,MANIPUR,2003,22,EXAM FAILURE,0,0,0,0,0,0,0,0,0,0,0,0,0,0,0,0,0,0,0
3376,MANIPUR,2003,22,FAMILY PROBLEMS,0,0,0,0,0,0,0,0,0,0,0,0,0,0,0,0,0,0,0
3922,MANIPUR,2003,22,HEALTH ISSUES,0,0,0,0,0,0,0,0,0,0,0,0,0,0,0,0,0,0,0
4468,MANIPUR,2003,22,HERO WORSHIP,0,0,0,0,0,0,0,0,0,0,0,0,0,0,0,0,0,0,0
5013,MANIPUR,2003,22,ILLEGITIMATE PREGNANCY,0,0,0,0,0,0,0,0,0,0,0,0,0,0,0,0,0,0,0
5558,MANIPUR,2003,22,LOVE AFFAIRS,0,0,0,0,0,0,0,0,0,0,0,0,0,0,0,0,0,0,0
6103,MANIPUR,2003,22,MARITAL ISSUES,0,0,0,0,0,0,0,0,0,0,0,0,0,0,0,0,0,0,0
6649,MANIPUR,2003,22,MENTAL HEALTH,0,0,0,0,0,0,0,0,0,0,0,0,0,0,0,0,0,0,0
7195,MANIPUR,2003,22,OTHERS,0,0,0,0,0,0,0,0,0,0,0,0,0,0,0,0,0,0,0
7780,MANIPUR,2003,22,"PHYSICAL ABUSE (RAPE,INCEST ETC.)",0,0,0,0,0,0,0,0,0,0,0,0,0,0,0,0,0,0,0
8286,MANIPUR,2003,22,SOCIETAL ISSUES,0,0,0,0,0,0,0,0,0,0,0,0,0,0,0,0,0,0,0
139,MANIPUR,2004,22,CAUSES NOT KNOWN,0,11,12,3,0,26,1,4,3,0,0,8,0,0,0,0,0,0,34
685,MANIPUR,2004,22,DEATH OF DEAR PERSON,0,0,0,0,0,0,0,0,0,0,0,0,0,0,0,0,0,0,0
1231,MANIPUR,2004,22,DOWRY DISPUTE,0,0,0,0,0,0,0,0,0,0,0,0,0,0,0,0,0,0,0
1777,MANIPUR,2004,22,DRUG ABUSE,0,4,0,0,0,4,0,0,0,0,0,0,0,0,0,0,0,0,4
2323,MANIPUR,2004,22,ECONOMIC ISSUES,0,0,0,0,0,0,0,0,0,0,0,0,0,0,0,0,0,0,0
2869,MANIPUR,2004,22,EXAM FAILURE,0,0,0,0,0,0,0,0,0,0,0,0,0,0,0,0,0,0,0
3415,MANIPUR,2004,22,FAMILY PROBLEMS,0,0,0,0,0,0,0,0,0,0,0,0,0,0,0,0,0,0,0
3961,MANIPUR,2004,22,HEALTH ISSUES,0,0,0,0,0,0,0,0,0,0,0,0,0,0,0,0,0,0,0
4507,MANIPUR,2004,22,HERO WORSHIP,0,0,0,0,0,0,0,0,0,0,0,0,0,0,0,0,0,0,0
5052,MANIPUR,2004,22,ILLEGITIMATE PREGNANCY,0,0,0,0,0,0,0,0,0,0,0,0,0,0,0,0,0,0,0
5597,MANIPUR,2004,22,LOVE AFFAIRS,0,1,0,0,0,1,0,1,0,0,0,1,0,0,0,0,0,0,2
6142,MANIPUR,2004,22,MARITAL ISSUES,0,0,0,0,0,0,0,0,0,0,0,0,0,0,0,0,0,0,0
6688,MANIPUR,2004,22,MENTAL HEALTH,0,0,0,0,0,0,0,0,0,0,0,0,0,0,0,0,0,0,0
7234,MANIPUR,2004,22,OTHERS,0,1,0,0,0,1,0,0,0,0,0,0,0,0,0,0,0,0,1
7819,MANIPUR,2004,22,"PHYSICAL ABUSE (RAPE,INCEST ETC.)",0,0,0,0,0,0,0,0,0,0,0,0,0,0,0,0,0,0,0
8325,MANIPUR,2004,22,SOCIETAL ISSUES,0,0,0,0,0,0,0,0,0,0,0,0,0,0,0,0,0,0,0
178,MANIPUR,2005,22,CAUSES NOT KNOWN,0,5,13,1,0,19,0,0,1,0,0,1,0,0,0,0,0,0,20
724,MANIPUR,2005,22,DEATH OF DEAR PERSON,0,0,0,0,0,0,0,0,0,0,0,0,0,0,0,0,0,0,0
1270,MANIPUR,2005,22,DOWRY DISPUTE,0,0,0,0,0,0,0,0,0,0,0,0,0,0,0,0,0,0,0
1816,MANIPUR,2005,22,DRUG ABUSE,0,0,0,0,0,0,0,0,0,0,0,0,0,0,0,0,0,0,0
2362,MANIPUR,2005,22,ECONOMIC ISSUES,0,0,3,0,0,3,0,0,0,0,0,0,0,0,0,0,0,0,3
2908,MANIPUR,2005,22,EXAM FAILURE,0,0,0,0,0,0,0,0,0,0,0,0,0,0,0,0,0,0,0
3454,MANIPUR,2005,22,FAMILY PROBLEMS,0,0,0,0,0,0,0,0,0,0,0,0,0,0,0,0,0,0,0
4000,MANIPUR,2005,22,HEALTH ISSUES,0,0,0,0,0,0,0,0,0,0,0,0,0,0,0,0,0,0,0
4546,MANIPUR,2005,22,HERO WORSHIP,0,0,0,0,0,0,0,0,0,0,0,0,0,0,0,0,0,0,0
5091,MANIPUR,2005,22,ILLEGITIMATE PREGNANCY,0,0,0,0,0,0,0,0,0,0,0,0,0,0,0,0,0,0,0
5636,MANIPUR,2005,22,LOVE AFFAIRS,0,0,1,0,0,1,0,2,0,0,0,2,0,0,0,0,0,0,3
6181,MANIPUR,2005,22,MARITAL ISSUES,0,0,0,0,0,0,0,0,0,0,0,0,0,0,0,0,0,0,0
6727,MANIPUR,2005,22,MENTAL HEALTH,0,0,0,0,0,0,0,0,0,0,0,0,0,0,0,0,0,0,0
7273,MANIPUR,2005,22,OTHERS,0,0,0,0,0,0,0,0,1,0,0,1,0,0,0,0,0,0,1
7858,MANIPUR,2005,22,"PHYSICAL ABUSE (RAPE,INCEST ETC.)",0,0,0,0,0,0,0,0,0,0,0,0,0,0,0,0,0,0,0
8364,MANIPUR,2005,22,SOCIETAL ISSUES,0,0,0,0,0,0,0,0,0,0,0,0,0,0,0,0,0,0,0
217,MANIPUR,2006,22,CAUSES NOT KNOWN,0,4,9,3,0,16,0,4,0,0,0,4,0,0,0,0,0,0,20
763,MANIPUR,2006,22,DEATH OF DEAR PERSON,0,0,0,0,0,0,0,0,0,0,0,0,0,0,0,0,0,0,0
1309,MANIPUR,2006,22,DOWRY DISPUTE,0,0,0,0,0,0,0,0,0,0,0,0,0,0,0,0,0,0,0
1855,MANIPUR,2006,22,DRUG ABUSE,0,0,0,0,0,0,0,0,0,0,0,0,0,0,0,0,0,0,0
2401,MANIPUR,2006,22,ECONOMIC ISSUES,0,0,0,0,0,0,0,0,0,0,0,0,0,0,0,0,0,0,0
2947,MANIPUR,2006,22,EXAM FAILURE,0,0,0,0,0,0,0,0,0,0,0,0,0,0,0,0,0,0,0
3493,MANIPUR,2006,22,FAMILY PROBLEMS,0,0,0,0,0,0,0,1,0,0,0,1,0,0,0,0,0,0,1
4039,MANIPUR,2006,22,HEALTH ISSUES,0,0,0,0,0,0,0,0,0,0,0,0,0,0,0,0,0,0,0
4584,MANIPUR,2006,22,HERO WORSHIP,0,0,0,0,0,0,0,0,0,0,0,0,0,0,0,0,0,0,0
5129,MANIPUR,2006,22,ILLEGITIMATE PREGNANCY,0,0,0,0,0,0,0,0,0,0,0,0,0,0,0,0,0,0,0
5674,MANIPUR,2006,22,LOVE AFFAIRS,0,0,0,0,0,0,0,0,0,0,0,0,0,0,0,0,0,0,0
6220,MANIPUR,2006,22,MARITAL ISSUES,0,0,0,0,0,0,0,0,0,0,0,0,0,0,0,0,0,0,0
6766,MANIPUR,2006,22,MENTAL HEALTH,0,0,0,0,0,0,0,0,0,0,0,0,0,0,0,0,0,0,0
7312,MANIPUR,2006,22,OTHERS,0,3,2,2,1,8,0,6,1,0,0,7,0,0,0,0,0,0,15
7896,MANIPUR,2006,22,"PHYSICAL ABUSE (RAPE,INCEST ETC.)",0,0,0,0,0,0,0,0,0,0,0,0,0,0,0,0,0,0,0
8403,MANIPUR,2006,22,SOCIETAL ISSUES,0,0,0,0,0,0,0,0,0,0,0,0,0,0,0,0,0,0,0
256,MANIPUR,2007,22,CAUSES NOT KNOWN,1,4,17,3,0,25,0,4,6,1,0,11,0,0,0,0,0,0,36
802,MANIPUR,2007,22,DEATH OF DEAR PERSON,0,0,0,0,0,0,0,0,0,0,0,0,0,0,0,0,0,0,0
1348,MANIPUR,2007,22,DOWRY DISPUTE,0,0,0,0,0,0,0,0,0,0,0,0,0,0,0,0,0,0,0
1894,MANIPUR,2007,22,DRUG ABUSE,0,2,0,0,0,2,0,0,0,0,0,0,0,0,0,0,0,0,2
2440,MANIPUR,2007,22,ECONOMIC ISSUES,0,0,0,0,0,0,0,0,0,0,0,0,0,0,0,0,0,0,0
2986,MANIPUR,2007,22,EXAM FAILURE,0,0,0,0,0,0,0,0,0,0,0,0,0,0,0,0,0,0,0
3532,MANIPUR,2007,22,FAMILY PROBLEMS,0,0,0,0,0,0,0,0,0,0,0,0,0,0,0,0,0,0,0
4078,MANIPUR,2007,22,HEALTH ISSUES,0,0,0,0,0,0,0,0,0,0,0,0,0,0,0,0,0,0,0
4623,MANIPUR,2007,22,HERO WORSHIP,0,0,0,0,0,0,0,0,0,0,0,0,0,0,0,0,0,0,0
5168,MANIPUR,2007,22,ILLEGITIMATE PREGNANCY,0,0,0,0,0,0,0,0,0,0,0,0,0,0,0,0,0,0,0
5713,MANIPUR,2007,22,LOVE AFFAIRS,0,1,0,0,0,1,0,0,0,0,0,0,0,0,0,0,0,0,1
6259,MANIPUR,2007,22,MARITAL ISSUES,0,0,0,0,0,0,0,0,0,0,0,0,0,0,0,0,0,0,0
6805,MANIPUR,2007,22,MENTAL HEALTH,0,0,0,0,0,0,0,0,0,0,0,0,0,0,0,0,0,0,0
7351,MANIPUR,2007,22,OTHERS,0,0,0,0,0,0,0,0,0,0,0,0,0,0,0,0,0,0,0
7935,MANIPUR,2007,22,"PHYSICAL ABUSE (RAPE,INCEST ETC.)",0,0,0,0,0,0,0,0,0,0,0,0,0,0,0,0,0,0,0
8442,MANIPUR,2007,22,SOCIETAL ISSUES,0,0,0,0,0,0,0,0,0,0,0,0,0,0,0,0,0,0,0
295,MANIPUR,2008,22,CAUSES NOT KNOWN,0,10,12,0,0,22,1,7,2,1,0,11,0,0,0,0,0,0,33
841,MANIPUR,2008,22,DEATH OF DEAR PERSON,0,0,0,0,0,0,0,0,0,0,0,0,0,0,0,0,0,0,0
1387,MANIPUR,2008,22,DOWRY DISPUTE,0,0,0,0,0,0,0,0,0,0,0,0,0,0,0,0,0,0,0
1933,MANIPUR,2008,22,DRUG ABUSE,0,1,0,0,0,1,0,0,0,0,0,0,0,0,0,0,0,0,1
2479,MANIPUR,2008,22,ECONOMIC ISSUES,0,0,0,0,0,0,0,0,0,0,0,0,0,0,0,0,0,0,0
3025,MANIPUR,2008,22,EXAM FAILURE,0,0,0,0,0,0,0,0,0,0,0,0,0,0,0,0,0,0,0
3571,MANIPUR,2008,22,FAMILY PROBLEMS,0,0,0,0,0,0,0,0,0,0,0,0,0,0,0,0,0,0,0
4117,MANIPUR,2008,22,HEALTH ISSUES,0,0,0,0,0,0,0,0,0,0,0,0,0,0,0,0,0,0,0
4662,MANIPUR,2008,22,HERO WORSHIP,0,0,0,0,0,0,0,0,0,0,0,0,0,0,0,0,0,0,0
5207,MANIPUR,2008,22,ILLEGITIMATE PREGNANCY,0,0,0,0,0,0,0,0,0,0,0,0,0,0,0,0,0,0,0
5752,MANIPUR,2008,22,LOVE AFFAIRS,0,0,0,0,0,0,0,0,0,0,0,0,0,0,0,0,0,0,0
6298,MANIPUR,2008,22,MARITAL ISSUES,0,0,0,0,0,0,0,0,0,0,0,0,0,0,0,0,0,0,0
6844,MANIPUR,2008,22,MENTAL HEALTH,0,0,0,0,0,0,0,0,0,0,0,0,0,0,0,0,0,0,0
7390,MANIPUR,2008,22,OTHERS,0,0,0,0,0,0,0,0,0,0,0,0,0,0,0,0,0,0,0
7974,MANIPUR,2008,22,"PHYSICAL ABUSE (RAPE,INCEST ETC.)",0,0,0,0,0,0,0,0,0,0,0,0,0,0,0,0,0,0,0
8481,MANIPUR,2008,22,SOCIETAL ISSUES,0,0,0,0,0,0,0,0,0,0,0,0,0,0,0,0,0,0,0
334,MANIPUR,2009,22,CAUSES NOT KNOWN,0,5,8,1,0,14,0,3,3,0,0,6,0,0,0,0,0,0,20
880,MANIPUR,2009,22,DEATH OF DEAR PERSON,0,0,0,0,0,0,0,0,0,0,0,0,0,0,0,0,0,0,0
1426,MANIPUR,2009,22,DOWRY DISPUTE,0,0,0,0,0,0,0,0,0,0,0,0,0,0,0,0,0,0,0
1972,MANIPUR,2009,22,DRUG ABUSE,0,0,0,0,0,0,0,0,0,0,0,0,0,0,0,0,0,0,0
2518,MANIPUR,2009,22,ECONOMIC ISSUES,0,0,0,0,0,0,0,0,0,0,0,0,0,0,0,0,0,0,0
3064,MANIPUR,2009,22,EXAM FAILURE,0,0,0,0,0,0,0,0,0,0,0,0,0,0,0,0,0,0,0
3610,MANIPUR,2009,22,FAMILY PROBLEMS,0,0,0,0,0,0,0,0,0,0,0,0,0,0,0,0,0,0,0
4156,MANIPUR,2009,22,HEALTH ISSUES,0,0,0,0,0,0,0,0,0,0,0,0,0,0,0,0,0,0,0
4701,MANIPUR,2009,22,HERO WORSHIP,0,0,0,0,0,0,0,0,0,0,0,0,0,0,0,0,0,0,0
5246,MANIPUR,2009,22,ILLEGITIMATE PREGNANCY,0,0,0,0,0,0,0,0,0,0,0,0,0,0,0,0,0,0,0
5791,MANIPUR,2009,22,LOVE AFFAIRS,0,0,0,0,0,0,0,1,0,0,0,1,0,0,0,0,0,0,1
6337,MANIPUR,2009,22,MARITAL ISSUES,0,0,0,0,0,0,0,0,0,0,0,0,0,0,0,0,0,0,0
6883,MANIPUR,2009,22,MENTAL HEALTH,0,0,0,0,0,0,0,0,0,0,0,0,0,0,0,0,0,0,0
7429,MANIPUR,2009,22,OTHERS,0,1,3,0,0,4,0,2,0,0,0,2,0,0,0,0,0,0,6
8013,MANIPUR,2009,22,"PHYSICAL ABUSE (RAPE,INCEST ETC.)",0,0,0,0,0,0,0,0,0,0,0,0,0,0,0,0,0,0,0
8520,MANIPUR,2009,22,SOCIETAL ISSUES,0,0,0,0,0,0,0,0,0,0,0,0,0,0,0,0,0,0,0
373,MANIPUR,2010,22,CAUSES NOT KNOWN,0,0,2,0,0,2,0,0,0,0,0,0,0,0,0,0,0,0,2
919,MANIPUR,2010,22,DEATH OF DEAR PERSON,0,0,0,0,0,0,0,0,0,0,0,0,0,0,0,0,0,0,0
1465,MANIPUR,2010,22,DOWRY DISPUTE,0,0,0,0,0,0,0,0,0,0,0,0,0,0,0,0,0,0,0
2011,MANIPUR,2010,22,DRUG ABUSE,0,0,0,0,0,0,0,0,0,0,0,0,0,0,0,0,0,0,0
2557,MANIPUR,2010,22,ECONOMIC ISSUES,0,0,0,0,0,0,0,0,0,0,0,0,0,0,0,0,0,0,0
3103,MANIPUR,2010,22,EXAM FAILURE,0,0,0,0,0,0,0,0,0,0,0,0,0,0,0,0,0,0,0
3649,MANIPUR,2010,22,FAMILY PROBLEMS,0,0,1,0,0,1,0,3,4,1,0,8,0,0,0,0,0,0,9
4195,MANIPUR,2010,22,HEALTH ISSUES,0,0,0,0,0,0,0,0,0,0,0,0,0,0,0,0,0,0,0
4740,MANIPUR,2010,22,HERO WORSHIP,0,0,0,0,0,0,0,0,0,0,0,0,0,0,0,0,0,0,0
5285,MANIPUR,2010,22,ILLEGITIMATE PREGNANCY,0,0,0,0,0,0,0,0,0,0,0,0,0,0,0,0,0,0,0
5830,MANIPUR,2010,22,LOVE AFFAIRS,0,1,0,0,0,1,0,0,0,0,0,0,0,0,0,0,0,0,1
6376,MANIPUR,2010,22,MARITAL ISSUES,0,0,0,0,0,0,0,0,0,0,0,0,0,0,0,0,0,0,0
6922,MANIPUR,2010,22,MENTAL HEALTH,0,0,0,0,0,0,0,0,0,0,0,0,0,0,0,0,0,0,0
7468,MANIPUR,2010,22,OTHERS,0,6,10,4,0,20,0,5,0,0,0,5,0,0,0,0,0,0,25
8052,MANIPUR,2010,22,"PHYSICAL ABUSE (RAPE,INCEST ETC.)",0,0,0,0,0,0,0,0,0,0,0,0,0,0,0,0,0,0,0
8559,MANIPUR,2010,22,SOCIETAL ISSUES,0,0,0,0,0,0,0,0,0,0,0,0,0,0,0,0,0,0,0
412,MANIPUR,2011,22,CAUSES NOT KNOWN,0,1,0,0,0,1,0,0,0,0,0,0,0,0,0,0,0,0,1
958,MANIPUR,2011,22,DEATH OF DEAR PERSON,0,0,0,0,0,0,0,0,0,0,0,0,0,0,0,0,0,0,0
1504,MANIPUR,2011,22,DOWRY DISPUTE,0,0,0,0,0,0,0,0,0,0,0,0,0,0,0,0,0,0,0
2050,MANIPUR,2011,22,DRUG ABUSE,0,0,0,0,0,0,0,0,0,0,0,0,0,0,0,0,0,0,0
2596,MANIPUR,2011,22,ECONOMIC ISSUES,0,0,0,0,0,0,0,0,0,0,0,0,0,0,0,0,0,0,0
3142,MANIPUR,2011,22,EXAM FAILURE,0,0,0,0,0,0,0,0,0,0,0,0,0,0,0,0,0,0,0
3688,MANIPUR,2011,22,FAMILY PROBLEMS,0,0,0,0,0,0,0,3,1,1,0,5,0,0,0,0,0,0,5
4234,MANIPUR,2011,22,HEALTH ISSUES,0,0,0,0,0,0,0,0,0,0,0,0,0,0,0,0,0,0,0
4779,MANIPUR,2011,22,HERO WORSHIP,0,0,0,0,0,0,0,0,0,0,0,0,0,0,0,0,0,0,0
5324,MANIPUR,2011,22,ILLEGITIMATE PREGNANCY,0,0,0,0,0,0,0,0,0,0,0,0,0,0,0,0,0,0,0
5869,MANIPUR,2011,22,LOVE AFFAIRS,0,0,0,0,0,0,0,4,0,0,0,4,0,0,0,0,0,0,4
6415,MANIPUR,2011,22,MARITAL ISSUES,0,0,0,0,0,0,0,0,0,0,0,0,0,0,0,0,0,0,0
6961,MANIPUR,2011,22,MENTAL HEALTH,0,0,0,0,0,0,0,0,0,0,0,0,0,0,0,0,0,0,0
7507,MANIPUR,2011,22,OTHERS,0,5,9,3,0,17,0,5,1,0,0,6,0,0,0,0,0,0,23
8091,MANIPUR,2011,22,"PHYSICAL ABUSE (RAPE,INCEST ETC.)",0,0,0,0,0,0,0,0,0,0,0,0,0,0,0,0,0,0,0
8598,MANIPUR,2011,22,SOCIETAL ISSUES,0,0,0,0,0,0,0,0,0,0,0,0,0,0,0,0,0,0,0
451,MANIPUR,2012,22,CAUSES NOT KNOWN,0,0,0,0,0,0,0,0,0,0,0,0,0,0,0,0,0,0,0
997,MANIPUR,2012,22,DEATH OF DEAR PERSON,0,0,0,0,0,0,0,0,0,0,0,0,0,0,0,0,0,0,0
1543,MANIPUR,2012,22,DOWRY DISPUTE,0,0,0,0,0,0,0,0,0,0,0,0,0,0,0,0,0,0,0
2089,MANIPUR,2012,22,DRUG ABUSE,0,0,0,0,0,0,0,0,0,0,0,0,0,0,0,0,0,0,0
2635,MANIPUR,2012,22,ECONOMIC ISSUES,0,0,1,0,0,1,0,1,0,0,0,1,0,0,0,0,0,0,2
3181,MANIPUR,2012,22,EXAM FAILURE,0,0,0,0,0,0,0,0,0,0,0,0,0,0,0,0,0,0,0
3727,MANIPUR,2012,22,FAMILY PROBLEMS,0,0,3,0,0,3,0,2,3,1,1,7,0,0,0,0,0,0,10
4273,MANIPUR,2012,22,HEALTH ISSUES,0,0,0,0,0,0,0,0,0,0,0,0,0,0,0,0,0,0,0
4818,MANIPUR,2012,22,HERO WORSHIP,0,0,0,0,0,0,0,0,0,0,0,0,0,0,0,0,0,0,0
5363,MANIPUR,2012,22,ILLEGITIMATE PREGNANCY,0,0,0,0,0,0,0,0,0,0,0,0,0,0,0,0,0,0,0
5908,MANIPUR,2012,22,LOVE AFFAIRS,0,4,0,0,0,4,1,2,0,0,0,3,0,0,0,0,0,0,7
6454,MANIPUR,2012,22,MARITAL ISSUES,0,0,0,0,0,0,0,0,0,0,0,0,0,0,0,0,0,0,0
7000,MANIPUR,2012,22,MENTAL HEALTH,0,0,0,0,0,0,0,0,0,0,0,0,0,0,0,0,0,0,0
7546,MANIPUR,2012,22,OTHERS,0,10,5,0,0,15,0,6,1,0,0,7,0,0,0,0,0,0,22
8130,MANIPUR,2012,22,"PHYSICAL ABUSE (RAPE,INCEST ETC.)",0,0,0,0,0,0,0,0,0,0,0,0,0,0,0,0,0,0,0
8637,MANIPUR,2012,22,SOCIETAL ISSUES,0,0,0,0,0,0,0,0,0,0,0,0,0,0,0,0,0,0,0
490,MANIPUR,2013,22,CAUSES NOT KNOWN,0,6,8,2,1,17,2,4,2,0,0,8,0,0,0,0,0,0,25
1036,MANIPUR,2013,22,DEATH OF DEAR PERSON,0,0,0,0,0,0,0,0,0,0,0,0,0,0,0,0,0,0,0
1582,MANIPUR,2013,22,DOWRY DISPUTE,0,0,0,0,0,0,0,0,0,0,0,0,0,0,0,0,0,0,0
2128,MANIPUR,2013,22,DRUG ABUSE,0,0,0,0,0,0,0,0,0,0,0,0,0,0,0,0,0,0,0
2674,MANIPUR,2013,22,ECONOMIC ISSUES,0,0,0,0,0,0,0,0,0,0,0,0,0,0,0,0,0,0,0
3220,MANIPUR,2013,22,EXAM FAILURE,0,0,0,0,0,0,0,0,0,0,0,0,0,0,0,0,0,0,0
3766,MANIPUR,2013,22,FAMILY PROBLEMS,0,0,0,0,0,0,0,0,0,0,0,0,0,0,0,0,0,0,0
4312,MANIPUR,2013,22,HEALTH ISSUES,0,0,0,0,0,0,0,0,0,0,0,0,0,0,0,0,0,0,0
4857,MANIPUR,2013,22,HERO WORSHIP,0,0,0,0,0,0,0,0,0,0,0,0,0,0,0,0,0,0,0
5402,MANIPUR,2013,22,ILLEGITIMATE PREGNANCY,0,0,0,0,0,0,0,0,0,0,0,0,0,0,0,0,0,0,0
5947,MANIPUR,2013,22,LOVE AFFAIRS,0,0,0,0,0,0,0,0,0,0,0,0,0,0,0,0,0,0,0
6493,MANIPUR,2013,22,MARITAL ISSUES,0,0,0,0,0,0,0,0,0,0,0,0,0,0,0,0,0,0,0
7039,MANIPUR,2013,22,MENTAL HEALTH,0,0,0,0,0,0,0,0,0,0,0,0,0,0,0,0,0,0,0
7585,MANIPUR,2013,22,OTHERS,1,1,2,1,0,5,0,6,0,1,0,7,0,0,0,0,0,0,12
8169,MANIPUR,2013,22,"PHYSICAL ABUSE (RAPE,INCEST ETC.)",0,0,0,0,0,0,0,0,0,0,0,0,0,0,0,0,0,0,0
8676,MANIPUR,2013,22,SOCIETAL ISSUES,0,0,0,0,0,0,0,0,0,0,0,0,0,0,0,0,0,0,0
529,MANIPUR,2014,22,CAUSES NOT KNOWN,2,6,3,1,1,13,1,3,0,0,0,4,0,0,0,0,0,0,17
1075,MANIPUR,2014,22,DEATH OF DEAR PERSON,0,0,0,0,0,0,0,0,0,0,0,0,0,0,0,0,0,0,0
1621,MANIPUR,2014,22,DOWRY DISPUTE,0,0,0,0,0,0,0,0,0,0,0,0,0,0,0,0,0,0,0
2167,MANIPUR,2014,22,DRUG ABUSE,0,0,0,0,0,0,0,0,0,0,0,0,0,0,0,0,0,0,0
2713,MANIPUR,2014,22,ECONOMIC ISSUES,0,0,0,0,0,0,0,0,0,0,0,0,0,0,0,0,0,0,0
3259,MANIPUR,2014,22,EXAM FAILURE,0,0,0,0,0,0,0,0,0,0,0,0,0,0,0,0,0,0,0
3805,MANIPUR,2014,22,FAMILY PROBLEMS,0,0,1,1,0,2,0,6,4,0,0,10,0,0,0,0,0,0,12
4351,MANIPUR,2014,22,HEALTH ISSUES,0,0,0,0,0,0,0,0,0,0,0,0,0,0,0,0,0,0,0
4896,MANIPUR,2014,22,HERO WORSHIP,0,0,0,0,0,0,0,0,0,0,0,0,0,0,0,0,0,0,0
5441,MANIPUR,2014,22,ILLEGITIMATE PREGNANCY,0,0,0,0,0,0,0,0,0,0,0,0,0,0,0,0,0,0,0
5986,MANIPUR,2014,22,LOVE AFFAIRS,0,0,0,0,0,0,0,0,0,0,0,0,0,0,0,0,0,0,0
6532,MANIPUR,2014,22,MARITAL ISSUES,0,0,0,0,0,0,0,2,0,0,0,2,0,0,0,0,0,0,2
7078,MANIPUR,2014,22,MENTAL HEALTH,0,0,0,0,0,0,0,0,0,0,0,0,0,0,0,0,0,0,0
7624,MANIPUR,2014,22,OTHERS,0,6,5,5,0,16,0,4,1,0,0,5,0,0,0,0,0,0,21
7663,MANIPUR,2014,22,PHYSICAL ABUSE,0,0,0,0,0,0,0,0,0,0,0,0,0,0,0,0,0,0,0
8715,MANIPUR,2014,22,SOCIETAL ISSUES,0,0,0,0,0,0,0,0,0,0,0,0,0,0,0,0,0,0,0
23,MEGHALAYA,2001,23,CAUSES NOT KNOWN,1,13,18,0,3,35,0,2,1,0,0,3,0,0,0,0,0,0,38
569,MEGHALAYA,2001,23,DEATH OF DEAR PERSON,0,0,0,0,0,0,0,0,0,0,0,0,0,0,0,0,0,0,0
1115,MEGHALAYA,2001,23,DOWRY DISPUTE,0,0,0,0,0,0,0,0,0,0,0,0,0,0,0,0,0,0,0
1661,MEGHALAYA,2001,23,DRUG ABUSE,0,0,0,0,0,0,0,0,0,0,0,0,0,0,0,0,0,0,0
2207,MEGHALAYA,2001,23,ECONOMIC ISSUES,0,0,0,1,1,2,0,1,0,0,0,1,0,0,0,0,0,0,3
2753,MEGHALAYA,2001,23,EXAM FAILURE,0,0,0,0,0,0,0,0,0,0,0,0,0,0,0,0,0,0,0
3299,MEGHALAYA,2001,23,FAMILY PROBLEMS,0,2,1,0,0,3,0,1,0,0,1,2,0,0,0,0,0,0,5
3845,MEGHALAYA,2001,23,HEALTH ISSUES,0,0,8,3,1,12,0,3,0,0,0,3,0,0,0,0,0,0,15
4391,MEGHALAYA,2001,23,HERO WORSHIP,0,0,0,0,0,0,0,0,0,0,0,0,0,0,0,0,0,0,0
4936,MEGHALAYA,2001,23,ILLEGITIMATE PREGNANCY,0,0,0,0,0,0,0,0,0,0,0,0,0,0,0,0,0,0,0
5481,MEGHALAYA,2001,23,LOVE AFFAIRS,0,0,0,0,0,0,0,0,0,0,0,0,0,0,0,0,0,0,0
6026,MEGHALAYA,2001,23,MARITAL ISSUES,0,0,0,0,0,0,0,0,0,0,0,0,0,0,0,0,0,0,0
6572,MEGHALAYA,2001,23,MENTAL HEALTH,0,1,1,0,0,2,0,1,0,0,0,1,0,0,0,0,0,0,3
7118,MEGHALAYA,2001,23,OTHERS,0,6,8,1,0,15,0,3,1,3,1,8,0,0,0,0,0,0,23
7703,MEGHALAYA,2001,23,"PHYSICAL ABUSE (RAPE,INCEST ETC.)",0,0,0,0,0,0,0,0,0,0,0,0,0,0,0,0,0,0,0
8209,MEGHALAYA,2001,23,SOCIETAL ISSUES,0,0,0,0,0,0,0,0,0,0,0,0,0,0,0,0,0,0,0
62,MEGHALAYA,2002,23,CAUSES NOT KNOWN,1,5,12,6,0,24,0,8,2,1,0,11,0,0,0,0,0,0,35
608,MEGHALAYA,2002,23,DEATH OF DEAR PERSON,0,0,0,0,0,0,0,0,0,0,0,0,0,0,0,0,0,0,0
1154,MEGHALAYA,2002,23,DOWRY DISPUTE,0,0,0,0,0,0,0,0,0,0,0,0,0,0,0,0,0,0,0
1700,MEGHALAYA,2002,23,DRUG ABUSE,0,0,1,1,0,2,0,0,0,0,0,0,0,0,0,0,0,0,2
2246,MEGHALAYA,2002,23,ECONOMIC ISSUES,0,0,1,0,0,1,1,0,0,1,0,2,0,0,0,0,0,0,3
2792,MEGHALAYA,2002,23,EXAM FAILURE,1,0,0,0,0,1,1,0,0,0,0,1,0,0,0,0,0,0,2
3338,MEGHALAYA,2002,23,FAMILY PROBLEMS,0,2,2,2,3,9,0,0,2,0,0,2,0,0,0,0,0,0,11
3884,MEGHALAYA,2002,23,HEALTH ISSUES,0,0,1,4,0,5,0,0,0,0,0,0,0,0,0,0,0,0,5
4430,MEGHALAYA,2002,23,HERO WORSHIP,0,0,0,0,0,0,0,0,0,0,0,0,0,0,0,0,0,0,0
4975,MEGHALAYA,2002,23,ILLEGITIMATE PREGNANCY,0,0,0,0,0,0,0,0,0,0,0,0,0,0,0,0,0,0,0
5520,MEGHALAYA,2002,23,LOVE AFFAIRS,0,1,1,0,0,2,0,0,0,0,0,0,0,0,0,0,0,0,2
6065,MEGHALAYA,2002,23,MARITAL ISSUES,0,0,1,0,0,1,0,0,0,0,0,0,0,0,0,0,0,0,1
6611,MEGHALAYA,2002,23,MENTAL HEALTH,1,1,2,0,0,4,0,0,2,0,0,2,0,0,0,0,0,0,6
7157,MEGHALAYA,2002,23,OTHERS,0,0,0,0,0,0,0,0,0,0,0,0,0,0,0,0,0,0,0
7742,MEGHALAYA,2002,23,"PHYSICAL ABUSE (RAPE,INCEST ETC.)",0,0,0,0,0,0,0,0,0,0,0,0,0,0,0,0,0,0,0
8248,MEGHALAYA,2002,23,SOCIETAL ISSUES,0,0,0,0,0,0,0,0,0,0,0,0,0,0,0,0,0,0,0
101,MEGHALAYA,2003,23,CAUSES NOT KNOWN,2,5,8,5,1,21,0,1,2,0,1,4,0,0,0,0,0,0,25
647,MEGHALAYA,2003,23,DEATH OF DEAR PERSON,0,0,0,0,0,0,0,0,0,0,0,0,0,0,0,0,0,0,0
1193,MEGHALAYA,2003,23,DOWRY DISPUTE,0,0,0,0,0,0,0,0,0,0,0,0,0,0,0,0,0,0,0
1739,MEGHALAYA,2003,23,DRUG ABUSE,0,0,0,0,0,0,0,0,0,0,0,0,0,0,0,0,0,0,0
2285,MEGHALAYA,2003,23,ECONOMIC ISSUES,0,1,1,1,0,3,0,0,0,0,0,0,0,0,0,0,0,0,3
2831,MEGHALAYA,2003,23,EXAM FAILURE,0,0,0,0,0,0,0,0,0,0,0,0,0,0,0,0,0,0,0
3377,MEGHALAYA,2003,23,FAMILY PROBLEMS,0,0,1,0,0,1,0,1,0,0,0,1,0,0,0,0,0,0,2
3923,MEGHALAYA,2003,23,HEALTH ISSUES,0,0,0,0,0,0,0,0,0,0,0,0,0,0,0,0,0,0,0
4469,MEGHALAYA,2003,23,HERO WORSHIP,0,0,0,0,0,0,0,0,0,0,0,0,0,0,0,0,0,0,0
5014,MEGHALAYA,2003,23,ILLEGITIMATE PREGNANCY,0,0,0,0,0,0,0,0,0,0,0,0,0,0,0,0,0,0,0
5559,MEGHALAYA,2003,23,LOVE AFFAIRS,1,0,0,0,0,1,0,1,0,0,0,1,0,0,0,0,0,0,2
6104,MEGHALAYA,2003,23,MARITAL ISSUES,0,0,0,0,0,0,0,1,0,0,0,1,0,0,0,0,0,0,1
6650,MEGHALAYA,2003,23,MENTAL HEALTH,0,1,1,0,0,2,1,0,0,0,0,1,0,0,0,0,0,0,3
7196,MEGHALAYA,2003,23,OTHERS,0,0,3,1,0,4,0,1,0,0,0,1,0,0,0,0,0,0,5
7781,MEGHALAYA,2003,23,"PHYSICAL ABUSE (RAPE,INCEST ETC.)",0,0,0,0,0,0,0,0,0,0,0,0,0,0,0,0,0,0,0
8287,MEGHALAYA,2003,23,SOCIETAL ISSUES,0,0,0,0,0,0,0,0,0,0,0,0,0,0,0,0,0,0,0
140,MEGHALAYA,2004,23,CAUSES NOT KNOWN,0,5,9,3,1,18,0,5,1,0,0,6,0,0,0,0,0,0,24
686,MEGHALAYA,2004,23,DEATH OF DEAR PERSON,0,0,0,0,0,0,0,0,0,0,0,0,0,0,0,0,0,0,0
1232,MEGHALAYA,2004,23,DOWRY DISPUTE,0,0,0,0,0,0,0,0,0,0,0,0,0,0,0,0,0,0,0
1778,MEGHALAYA,2004,23,DRUG ABUSE,0,0,0,0,0,0,0,0,0,0,0,0,0,0,0,0,0,0,0
2324,MEGHALAYA,2004,23,ECONOMIC ISSUES,0,1,3,0,1,5,0,0,0,0,0,0,0,0,0,0,0,0,5
2870,MEGHALAYA,2004,23,EXAM FAILURE,0,1,0,0,0,1,0,1,0,0,0,1,0,0,0,0,0,0,2
3416,MEGHALAYA,2004,23,FAMILY PROBLEMS,0,2,3,0,0,5,0,4,1,0,0,5,0,0,0,0,0,0,10
3962,MEGHALAYA,2004,23,HEALTH ISSUES,0,0,1,4,0,5,0,0,0,0,0,0,0,0,0,0,0,0,5
4508,MEGHALAYA,2004,23,HERO WORSHIP,0,0,0,0,0,0,0,0,0,0,0,0,0,0,0,0,0,0,0
5053,MEGHALAYA,2004,23,ILLEGITIMATE PREGNANCY,0,0,0,0,0,0,0,0,0,0,0,0,0,0,0,0,0,0,0
5598,MEGHALAYA,2004,23,LOVE AFFAIRS,0,2,1,1,0,4,0,4,0,0,0,4,0,0,0,0,0,0,8
6143,MEGHALAYA,2004,23,MARITAL ISSUES,0,0,0,0,0,0,0,0,0,0,0,0,0,0,0,0,0,0,0
6689,MEGHALAYA,2004,23,MENTAL HEALTH,0,0,1,0,0,1,0,0,0,0,0,0,0,0,0,0,0,0,1
7235,MEGHALAYA,2004,23,OTHERS,0,0,0,0,0,0,0,0,0,0,0,0,0,0,0,0,0,0,0
7820,MEGHALAYA,2004,23,"PHYSICAL ABUSE (RAPE,INCEST ETC.)",0,0,0,0,0,0,0,0,0,0,0,0,0,0,0,0,0,0,0
8326,MEGHALAYA,2004,23,SOCIETAL ISSUES,0,0,0,0,0,0,0,0,0,0,0,0,0,0,0,0,0,0,0
179,MEGHALAYA,2005,23,CAUSES NOT KNOWN,2,12,8,5,4,31,0,7,3,1,0,11,0,0,0,0,0,0,42
725,MEGHALAYA,2005,23,DEATH OF DEAR PERSON,0,0,0,0,0,0,0,0,0,0,0,0,0,0,0,0,0,0,0
1271,MEGHALAYA,2005,23,DOWRY DISPUTE,0,0,0,0,0,0,0,0,0,0,0,0,0,0,0,0,0,0,0
1817,MEGHALAYA,2005,23,DRUG ABUSE,0,0,0,0,0,0,0,0,0,0,0,0,0,0,0,0,0,0,0
2363,MEGHALAYA,2005,23,ECONOMIC ISSUES,0,0,0,0,0,0,0,0,0,0,0,0,0,0,0,0,0,0,0
2909,MEGHALAYA,2005,23,EXAM FAILURE,0,0,0,0,0,0,0,0,0,0,0,0,0,0,0,0,0,0,0
3455,MEGHALAYA,2005,23,FAMILY PROBLEMS,0,0,2,2,3,7,0,2,0,1,0,3,0,0,0,0,0,0,10
4001,MEGHALAYA,2005,23,HEALTH ISSUES,0,0,0,0,0,0,0,0,0,0,0,0,0,0,0,0,0,0,0
4547,MEGHALAYA,2005,23,HERO WORSHIP,0,1,0,1,0,2,0,0,0,0,0,0,0,0,0,0,0,0,2
5092,MEGHALAYA,2005,23,ILLEGITIMATE PREGNANCY,0,0,0,0,0,0,0,1,0,0,0,1,0,0,0,0,0,0,1
5637,MEGHALAYA,2005,23,LOVE AFFAIRS,0,0,0,0,0,0,0,1,0,0,1,2,0,0,0,0,0,0,2
6182,MEGHALAYA,2005,23,MARITAL ISSUES,0,0,2,1,0,3,0,1,0,0,0,1,0,0,0,0,0,0,4
6728,MEGHALAYA,2005,23,MENTAL HEALTH,0,0,0,0,0,0,0,0,0,0,0,0,0,0,0,0,0,0,0
7274,MEGHALAYA,2005,23,OTHERS,1,3,2,1,0,7,0,1,2,0,0,3,0,0,0,0,0,0,10
7859,MEGHALAYA,2005,23,"PHYSICAL ABUSE (RAPE,INCEST ETC.)",0,0,0,0,0,0,0,0,0,0,0,0,0,0,0,0,0,0,0
8365,MEGHALAYA,2005,23,SOCIETAL ISSUES,0,0,0,0,0,0,0,0,0,0,0,0,0,0,0,0,0,0,0
218,MEGHALAYA,2006,23,CAUSES NOT KNOWN,1,15,12,2,3,33,1,8,4,0,0,13,0,0,0,0,0,0,46
764,MEGHALAYA,2006,23,DEATH OF DEAR PERSON,0,0,0,0,0,0,0,0,0,0,0,0,0,0,0,0,0,0,0
1310,MEGHALAYA,2006,23,DOWRY DISPUTE,0,0,0,0,0,0,0,0,0,0,0,0,0,0,0,0,0,0,0
1856,MEGHALAYA,2006,23,DRUG ABUSE,0,1,0,0,0,1,0,0,0,0,0,0,0,0,0,0,0,0,1
2402,MEGHALAYA,2006,23,ECONOMIC ISSUES,0,0,0,0,0,0,0,0,0,0,0,0,0,0,0,0,0,0,0
2948,MEGHALAYA,2006,23,EXAM FAILURE,0,0,0,0,0,0,0,0,0,0,0,0,0,0,0,0,0,0,0
3494,MEGHALAYA,2006,23,FAMILY PROBLEMS,0,13,6,3,1,23,0,8,1,0,0,9,0,0,0,0,0,0,32
4040,MEGHALAYA,2006,23,HEALTH ISSUES,0,4,0,0,0,4,0,0,0,0,0,0,0,0,0,0,0,0,4
4585,MEGHALAYA,2006,23,HERO WORSHIP,0,0,0,0,0,0,0,0,0,0,0,0,0,0,0,0,0,0,0
5130,MEGHALAYA,2006,23,ILLEGITIMATE PREGNANCY,0,0,0,0,0,0,0,0,0,0,0,0,0,0,0,0,0,0,0
5675,MEGHALAYA,2006,23,LOVE AFFAIRS,0,1,0,0,0,1,0,1,0,0,0,1,0,0,0,0,0,0,2
6221,MEGHALAYA,2006,23,MARITAL ISSUES,0,0,0,0,0,0,0,0,0,0,0,0,0,0,0,0,0,0,0
6767,MEGHALAYA,2006,23,MENTAL HEALTH,0,2,0,0,0,2,0,0,0,0,0,0,0,0,0,0,0,0,2
7313,MEGHALAYA,2006,23,OTHERS,0,3,1,0,0,4,0,0,0,0,0,0,0,0,0,0,0,0,4
7897,MEGHALAYA,2006,23,"PHYSICAL ABUSE (RAPE,INCEST ETC.)",0,0,0,0,0,0,0,0,0,0,0,0,0,0,0,0,0,0,0
8404,MEGHALAYA,2006,23,SOCIETAL ISSUES,0,1,0,0,0,1,0,0,0,0,0,0,0,0,0,0,0,0,1
257,MEGHALAYA,2007,23,CAUSES NOT KNOWN,0,6,10,4,2,22,0,3,3,0,0,6,0,0,0,0,0,0,28
803,MEGHALAYA,2007,23,DEATH OF DEAR PERSON,0,0,0,0,0,0,0,0,0,0,0,0,0,0,0,0,0,0,0
1349,MEGHALAYA,2007,23,DOWRY DISPUTE,0,0,0,0,0,0,0,0,0,0,0,0,0,0,0,0,0,0,0
1895,MEGHALAYA,2007,23,DRUG ABUSE,0,0,0,0,0,0,0,0,0,0,0,0,0,0,0,0,0,0,0
2441,MEGHALAYA,2007,23,ECONOMIC ISSUES,0,4,0,0,0,4,0,3,0,0,0,3,0,0,0,0,0,0,7
2987,MEGHALAYA,2007,23,EXAM FAILURE,1,1,0,0,0,2,0,0,0,0,0,0,0,0,0,0,0,0,2
3533,MEGHALAYA,2007,23,FAMILY PROBLEMS,0,10,9,0,0,19,0,5,6,0,0,11,0,0,0,0,0,0,30
4079,MEGHALAYA,2007,23,HEALTH ISSUES,0,0,1,3,0,4,0,0,0,0,0,0,0,0,0,0,0,0,4
4624,MEGHALAYA,2007,23,HERO WORSHIP,0,0,0,0,0,0,0,0,0,0,0,0,0,0,0,0,0,0,0
5169,MEGHALAYA,2007,23,ILLEGITIMATE PREGNANCY,0,0,0,0,0,0,0,0,0,0,0,0,0,0,0,0,0,0,0
5714,MEGHALAYA,2007,23,LOVE AFFAIRS,0,3,0,0,0,3,0,3,0,0,0,3,0,0,0,0,0,0,6
6260,MEGHALAYA,2007,23,MARITAL ISSUES,0,0,0,0,0,0,0,0,0,0,0,0,0,0,0,0,0,0,0
6806,MEGHALAYA,2007,23,MENTAL HEALTH,0,0,0,0,1,1,0,0,1,0,0,1,0,0,0,0,0,0,2
7352,MEGHALAYA,2007,23,OTHERS,0,4,1,0,0,5,0,1,2,0,0,3,0,0,0,0,0,0,8
7936,MEGHALAYA,2007,23,"PHYSICAL ABUSE (RAPE,INCEST ETC.)",0,0,0,0,0,0,0,0,0,0,0,0,0,0,0,0,0,0,0
8443,MEGHALAYA,2007,23,SOCIETAL ISSUES,0,0,0,0,0,0,0,0,0,0,0,0,0,0,0,0,0,0,0
296,MEGHALAYA,2008,23,CAUSES NOT KNOWN,0,14,17,6,1,38,1,5,7,2,2,17,0,0,0,0,0,0,55
842,MEGHALAYA,2008,23,DEATH OF DEAR PERSON,0,0,0,0,0,0,0,0,0,0,0,0,0,0,0,0,0,0,0
1388,MEGHALAYA,2008,23,DOWRY DISPUTE,0,0,0,0,0,0,0,0,0,0,0,0,0,0,0,0,0,0,0
1934,MEGHALAYA,2008,23,DRUG ABUSE,0,0,0,0,0,0,0,0,0,0,0,0,0,0,0,0,0,0,0
2480,MEGHALAYA,2008,23,ECONOMIC ISSUES,0,2,0,3,0,5,0,0,2,0,0,2,0,0,0,0,0,0,7
3026,MEGHALAYA,2008,23,EXAM FAILURE,0,0,0,0,0,0,0,0,0,0,0,0,0,0,0,0,0,0,0
3572,MEGHALAYA,2008,23,FAMILY PROBLEMS,0,0,5,0,0,5,0,1,3,0,0,4,0,0,0,0,0,0,9
4118,MEGHALAYA,2008,23,HEALTH ISSUES,0,1,1,0,0,2,0,0,0,0,0,0,0,0,0,0,0,0,2
4663,MEGHALAYA,2008,23,HERO WORSHIP,0,0,0,0,0,0,0,0,0,0,0,0,0,0,0,0,0,0,0
5208,MEGHALAYA,2008,23,ILLEGITIMATE PREGNANCY,0,0,0,0,0,0,0,0,0,0,0,0,0,0,0,0,0,0,0
5753,MEGHALAYA,2008,23,LOVE AFFAIRS,0,1,2,0,0,3,0,2,0,0,0,2,0,0,0,0,0,0,5
6299,MEGHALAYA,2008,23,MARITAL ISSUES,0,0,0,0,0,0,0,0,0,0,0,0,0,0,0,0,0,0,0
6845,MEGHALAYA,2008,23,MENTAL HEALTH,0,1,0,0,0,1,0,2,0,0,0,2,0,0,0,0,0,0,3
7391,MEGHALAYA,2008,23,OTHERS,0,0,2,1,0,3,0,1,0,0,0,1,0,0,0,0,0,0,4
7975,MEGHALAYA,2008,23,"PHYSICAL ABUSE (RAPE,INCEST ETC.)",0,0,0,0,0,0,0,0,0,0,0,0,0,0,0,0,0,0,0
8482,MEGHALAYA,2008,23,SOCIETAL ISSUES,0,0,0,0,0,0,0,0,0,0,0,0,0,0,0,0,0,0,0
335,MEGHALAYA,2009,23,CAUSES NOT KNOWN,0,8,6,15,3,32,1,12,1,12,3,29,0,0,0,0,0,0,61
881,MEGHALAYA,2009,23,DEATH OF DEAR PERSON,0,0,0,0,0,0,0,0,0,0,0,0,0,0,0,0,0,0,0
1427,MEGHALAYA,2009,23,DOWRY DISPUTE,0,0,0,0,0,0,0,0,0,0,0,0,0,0,0,0,0,0,0
1973,MEGHALAYA,2009,23,DRUG ABUSE,0,1,0,1,0,2,0,0,0,0,0,0,0,0,0,0,0,0,2
2519,MEGHALAYA,2009,23,ECONOMIC ISSUES,0,1,1,0,0,2,0,0,3,0,0,3,0,0,0,0,0,0,5
3065,MEGHALAYA,2009,23,EXAM FAILURE,1,1,0,0,0,2,0,0,0,0,0,0,0,0,0,0,0,0,2
3611,MEGHALAYA,2009,23,FAMILY PROBLEMS,0,5,0,3,1,9,0,2,2,0,0,4,0,0,0,0,0,0,13
4157,MEGHALAYA,2009,23,HEALTH ISSUES,0,1,1,2,0,4,0,0,0,2,0,2,0,0,0,0,0,0,6
4702,MEGHALAYA,2009,23,HERO WORSHIP,0,0,0,0,0,0,0,0,0,0,0,0,0,0,0,0,0,0,0
5247,MEGHALAYA,2009,23,ILLEGITIMATE PREGNANCY,0,0,0,0,0,0,0,1,0,0,0,1,0,0,0,0,0,0,1
5792,MEGHALAYA,2009,23,LOVE AFFAIRS,0,3,1,0,0,4,0,1,0,0,0,1,0,0,0,0,0,0,5
6338,MEGHALAYA,2009,23,MARITAL ISSUES,0,0,0,0,0,0,0,0,0,0,0,0,0,0,0,0,0,0,0
6884,MEGHALAYA,2009,23,MENTAL HEALTH,0,3,1,6,0,10,0,0,0,3,0,3,0,0,0,0,0,0,13
7430,MEGHALAYA,2009,23,OTHERS,0,1,1,0,0,2,0,2,0,0,0,2,0,0,0,0,0,0,4
8014,MEGHALAYA,2009,23,"PHYSICAL ABUSE (RAPE,INCEST ETC.)",0,0,0,0,0,0,0,0,0,0,0,0,0,0,0,0,0,0,0
8521,MEGHALAYA,2009,23,SOCIETAL ISSUES,0,0,0,0,0,0,0,0,0,0,0,0,0,0,0,0,0,0,0
374,MEGHALAYA,2010,23,CAUSES NOT KNOWN,2,15,6,5,3,31,1,5,4,1,1,12,0,0,0,0,0,0,43
920,MEGHALAYA,2010,23,DEATH OF DEAR PERSON,0,0,0,0,0,0,0,0,1,0,0,1,0,0,0,0,0,0,1
1466,MEGHALAYA,2010,23,DOWRY DISPUTE,0,0,0,0,0,0,0,0,0,0,0,0,0,0,0,0,0,0,0
2012,MEGHALAYA,2010,23,DRUG ABUSE,0,0,0,0,0,0,0,0,0,0,0,0,0,0,0,0,0,0,0
2558,MEGHALAYA,2010,23,ECONOMIC ISSUES,0,0,0,0,0,0,0,0,0,0,0,0,0,0,0,0,0,0,0
3104,MEGHALAYA,2010,23,EXAM FAILURE,0,0,0,0,0,0,0,0,0,0,0,0,0,0,0,0,0,0,0
3650,MEGHALAYA,2010,23,FAMILY PROBLEMS,0,5,2,3,0,10,0,5,1,1,0,7,0,0,0,0,0,0,17
4196,MEGHALAYA,2010,23,HEALTH ISSUES,0,4,3,1,2,10,0,3,2,0,0,5,0,0,0,0,0,0,15
4741,MEGHALAYA,2010,23,HERO WORSHIP,0,0,0,0,0,0,0,0,0,0,0,0,0,0,0,0,0,0,0
5286,MEGHALAYA,2010,23,ILLEGITIMATE PREGNANCY,0,0,0,0,0,0,0,0,0,0,0,0,0,0,0,0,0,0,0
5831,MEGHALAYA,2010,23,LOVE AFFAIRS,0,5,1,0,0,6,0,2,0,0,0,2,0,0,0,0,0,0,8
6377,MEGHALAYA,2010,23,MARITAL ISSUES,0,1,0,0,0,1,0,0,0,0,0,0,0,0,0,0,0,0,1
6923,MEGHALAYA,2010,23,MENTAL HEALTH,0,1,0,0,0,1,0,0,0,0,0,0,0,0,0,0,0,0,1
7469,MEGHALAYA,2010,23,OTHERS,0,6,11,4,0,21,0,0,1,0,0,1,0,0,0,0,0,0,22
8053,MEGHALAYA,2010,23,"PHYSICAL ABUSE (RAPE,INCEST ETC.)",0,0,0,0,0,0,0,0,0,0,0,0,0,0,0,0,0,0,0
8560,MEGHALAYA,2010,23,SOCIETAL ISSUES,0,0,0,0,0,0,0,0,0,0,0,0,0,0,0,0,0,0,0
413,MEGHALAYA,2011,23,CAUSES NOT KNOWN,3,36,11,9,0,59,1,11,6,3,1,22,0,0,0,0,0,0,81
959,MEGHALAYA,2011,23,DEATH OF DEAR PERSON,0,0,0,0,0,0,0,0,0,0,0,0,0,0,0,0,0,0,0
1505,MEGHALAYA,2011,23,DOWRY DISPUTE,0,0,0,0,0,0,0,0,0,0,0,0,0,0,0,0,0,0,0
2051,MEGHALAYA,2011,23,DRUG ABUSE,0,3,0,0,0,3,0,0,0,0,0,0,0,0,0,0,0,0,3
2597,MEGHALAYA,2011,23,ECONOMIC ISSUES,0,0,0,0,0,0,0,0,0,0,0,0,0,0,0,0,0,0,0
3143,MEGHALAYA,2011,23,EXAM FAILURE,1,0,0,0,0,1,0,2,0,0,0,2,0,0,0,0,0,0,3
3689,MEGHALAYA,2011,23,FAMILY PROBLEMS,0,6,6,4,0,16,0,4,3,0,0,7,0,0,0,0,0,0,23
4235,MEGHALAYA,2011,23,HEALTH ISSUES,0,1,0,0,1,2,0,0,0,1,1,2,0,0,0,0,0,0,4
4780,MEGHALAYA,2011,23,HERO WORSHIP,0,0,0,0,0,0,0,0,0,0,0,0,0,0,0,0,0,0,0
5325,MEGHALAYA,2011,23,ILLEGITIMATE PREGNANCY,0,0,0,0,0,0,0,0,0,0,0,0,0,0,0,0,0,0,0
5870,MEGHALAYA,2011,23,LOVE AFFAIRS,0,3,0,0,0,3,0,2,0,0,0,2,0,0,0,0,0,0,5
6416,MEGHALAYA,2011,23,MARITAL ISSUES,0,0,1,0,0,1,0,0,0,0,0,0,0,0,0,0,0,0,1
6962,MEGHALAYA,2011,23,MENTAL HEALTH,0,3,2,0,0,5,0,2,4,1,0,7,0,0,0,0,0,0,12
7508,MEGHALAYA,2011,23,OTHERS,0,15,5,0,1,21,0,0,0,0,0,0,0,0,0,0,0,0,21
8092,MEGHALAYA,2011,23,"PHYSICAL ABUSE (RAPE,INCEST ETC.)",0,0,0,0,0,0,0,0,0,0,0,0,0,0,0,0,0,0,0
8599,MEGHALAYA,2011,23,SOCIETAL ISSUES,0,0,0,0,0,0,0,0,0,0,0,0,0,0,0,0,0,0,0
452,MEGHALAYA,2012,23,CAUSES NOT KNOWN,2,34,21,12,1,70,1,19,6,1,0,27,0,0,0,0,0,0,97
998,MEGHALAYA,2012,23,DEATH OF DEAR PERSON,0,0,0,0,0,0,0,0,0,0,0,0,0,0,0,0,0,0,0
1544,MEGHALAYA,2012,23,DOWRY DISPUTE,0,0,0,0,0,0,0,0,0,0,0,0,0,0,0,0,0,0,0
2090,MEGHALAYA,2012,23,DRUG ABUSE,0,1,1,0,0,2,0,0,0,0,0,0,0,0,0,0,0,0,2
2636,MEGHALAYA,2012,23,ECONOMIC ISSUES,0,0,0,0,0,0,0,0,0,0,0,0,0,0,0,0,0,0,0
3182,MEGHALAYA,2012,23,EXAM FAILURE,0,0,0,0,0,0,0,0,0,0,0,0,0,0,0,0,0,0,0
3728,MEGHALAYA,2012,23,FAMILY PROBLEMS,1,2,6,2,0,11,0,5,1,1,0,7,0,0,0,0,0,0,18
4274,MEGHALAYA,2012,23,HEALTH ISSUES,0,0,0,1,0,1,0,0,0,0,0,0,0,0,0,0,0,0,1
4819,MEGHALAYA,2012,23,HERO WORSHIP,0,0,0,0,0,0,0,0,0,0,0,0,0,0,0,0,0,0,0
5364,MEGHALAYA,2012,23,ILLEGITIMATE PREGNANCY,0,0,0,0,0,0,0,0,0,0,0,0,0,0,0,0,0,0,0
5909,MEGHALAYA,2012,23,LOVE AFFAIRS,0,1,0,0,0,1,0,1,0,0,0,1,0,0,0,0,0,0,2
6455,MEGHALAYA,2012,23,MARITAL ISSUES,0,0,0,0,0,0,0,1,0,0,0,1,0,0,0,0,0,0,1
7001,MEGHALAYA,2012,23,MENTAL HEALTH,0,1,1,0,0,2,0,0,0,0,0,0,0,0,0,0,0,0,2
7547,MEGHALAYA,2012,23,OTHERS,0,1,1,1,0,3,1,1,0,0,0,2,0,0,0,0,0,0,5
8131,MEGHALAYA,2012,23,"PHYSICAL ABUSE (RAPE,INCEST ETC.)",0,0,0,0,0,0,0,0,0,0,0,0,0,0,0,0,0,0,0
8638,MEGHALAYA,2012,23,SOCIETAL ISSUES,0,0,0,0,0,0,0,0,0,0,0,0,0,0,0,0,0,0,0
491,MEGHALAYA,2013,23,CAUSES NOT KNOWN,3,26,13,5,1,48,4,9,5,2,0,20,0,0,0,0,0,0,68
1037,MEGHALAYA,2013,23,DEATH OF DEAR PERSON,0,0,0,0,0,0,0,0,0,0,0,0,0,0,0,0,0,0,0
1583,MEGHALAYA,2013,23,DOWRY DISPUTE,0,0,0,0,0,0,0,0,0,0,0,0,0,0,0,0,0,0,0
2129,MEGHALAYA,2013,23,DRUG ABUSE,0,1,0,0,0,1,0,0,0,0,0,0,0,0,0,0,0,0,1
2675,MEGHALAYA,2013,23,ECONOMIC ISSUES,0,1,0,0,0,1,0,1,0,0,0,1,0,0,0,0,0,0,2
3221,MEGHALAYA,2013,23,EXAM FAILURE,0,1,0,0,0,1,0,0,0,0,0,0,0,0,0,0,0,0,1
3767,MEGHALAYA,2013,23,FAMILY PROBLEMS,0,10,4,4,0,18,0,6,4,0,0,10,0,0,0,0,0,0,28
4313,MEGHALAYA,2013,23,HEALTH ISSUES,0,0,0,0,2,2,0,0,0,0,0,0,0,0,0,0,0,0,2
4858,MEGHALAYA,2013,23,HERO WORSHIP,0,0,0,0,0,0,0,0,0,0,0,0,0,0,0,0,0,0,0
5403,MEGHALAYA,2013,23,ILLEGITIMATE PREGNANCY,0,0,0,0,0,0,0,4,0,0,0,4,0,0,0,0,0,0,4
5948,MEGHALAYA,2013,23,LOVE AFFAIRS,0,6,0,0,0,6,2,2,0,0,0,4,0,0,0,0,0,0,10
6494,MEGHALAYA,2013,23,MARITAL ISSUES,0,0,0,0,0,0,0,0,0,0,0,0,0,0,0,0,0,0,0
7040,MEGHALAYA,2013,23,MENTAL HEALTH,0,1,3,1,0,5,0,2,0,0,0,2,0,0,0,0,0,0,7
7586,MEGHALAYA,2013,23,OTHERS,0,5,4,1,0,10,0,0,0,0,0,0,0,0,0,0,0,0,10
8170,MEGHALAYA,2013,23,"PHYSICAL ABUSE (RAPE,INCEST ETC.)",0,0,0,0,0,0,0,0,0,0,0,0,0,0,0,0,0,0,0
8677,MEGHALAYA,2013,23,SOCIETAL ISSUES,0,0,4,0,0,4,0,0,0,0,0,0,0,0,0,0,0,0,4
530,MEGHALAYA,2014,23,CAUSES NOT KNOWN,1,11,9,5,2,28,1,3,2,0,0,6,0,0,0,0,0,0,34
1076,MEGHALAYA,2014,23,DEATH OF DEAR PERSON,0,0,0,0,0,0,0,0,0,0,0,0,0,0,0,0,0,0,0
1622,MEGHALAYA,2014,23,DOWRY DISPUTE,0,0,0,0,0,0,0,0,0,0,0,0,0,0,0,0,0,0,0
2168,MEGHALAYA,2014,23,DRUG ABUSE,0,0,1,0,0,1,0,0,0,0,0,0,0,0,0,0,0,0,1
2714,MEGHALAYA,2014,23,ECONOMIC ISSUES,0,2,0,0,0,2,0,0,0,0,0,0,0,0,0,0,0,0,2
3260,MEGHALAYA,2014,23,EXAM FAILURE,1,3,0,0,0,4,1,1,0,0,0,2,0,0,0,0,0,0,6
3806,MEGHALAYA,2014,23,FAMILY PROBLEMS,0,3,5,3,1,12,0,1,1,0,1,3,0,0,0,0,0,0,15
4352,MEGHALAYA,2014,23,HEALTH ISSUES,0,2,2,0,2,6,0,0,0,0,0,0,0,0,0,0,0,0,6
4897,MEGHALAYA,2014,23,HERO WORSHIP,0,0,0,0,0,0,0,0,0,0,0,0,0,0,0,0,0,0,0
5442,MEGHALAYA,2014,23,ILLEGITIMATE PREGNANCY,0,0,0,0,0,0,0,0,0,0,0,0,0,0,0,0,0,0,0
5987,MEGHALAYA,2014,23,LOVE AFFAIRS,0,5,0,0,0,5,0,7,0,0,0,7,0,0,0,0,0,0,12
6533,MEGHALAYA,2014,23,MARITAL ISSUES,0,2,5,2,0,9,0,3,1,0,0,4,0,0,0,0,0,0,13
7079,MEGHALAYA,2014,23,MENTAL HEALTH,0,0,0,0,0,0,0,0,0,0,0,0,0,0,0,0,0,0,0
7625,MEGHALAYA,2014,23,OTHERS,0,5,8,4,0,17,1,2,1,0,0,4,0,0,0,0,0,0,21
7664,MEGHALAYA,2014,23,PHYSICAL ABUSE,0,0,0,0,0,0,0,0,1,0,0,1,0,0,0,0,0,0,1
8716,MEGHALAYA,2014,23,SOCIETAL ISSUES,0,0,0,0,0,0,0,0,0,0,0,0,0,0,0,0,0,0,0
24,MIZORAM,2001,24,CAUSES NOT KNOWN,2,12,4,1,1,20,0,2,1,0,0,3,0,0,0,0,0,0,23
570,MIZORAM,2001,24,DEATH OF DEAR PERSON,0,0,0,0,0,0,0,0,0,0,0,0,0,0,0,0,0,0,0
1116,MIZORAM,2001,24,DOWRY DISPUTE,0,0,0,0,0,0,0,0,0,0,0,0,0,0,0,0,0,0,0
1662,MIZORAM,2001,24,DRUG ABUSE,0,5,1,0,0,6,0,0,0,0,0,0,0,0,0,0,0,0,6
2208,MIZORAM,2001,24,ECONOMIC ISSUES,0,1,0,0,0,1,0,0,0,1,0,1,0,0,0,0,0,0,2
2754,MIZORAM,2001,24,EXAM FAILURE,0,0,0,0,0,0,0,0,0,0,0,0,0,0,0,0,0,0,0
3300,MIZORAM,2001,24,FAMILY PROBLEMS,0,0,2,4,0,6,0,0,0,0,0,0,0,0,0,0,0,0,6
3846,MIZORAM,2001,24,HEALTH ISSUES,0,0,0,0,0,0,0,0,0,0,0,0,0,0,0,0,0,0,0
4392,MIZORAM,2001,24,HERO WORSHIP,0,0,0,0,0,0,0,0,0,0,0,0,0,0,0,0,0,0,0
4937,MIZORAM,2001,24,ILLEGITIMATE PREGNANCY,0,0,0,0,0,0,0,0,0,0,0,0,0,0,0,0,0,0,0
5482,MIZORAM,2001,24,LOVE AFFAIRS,0,0,1,0,0,1,0,0,0,0,0,0,0,0,0,0,0,0,1
6027,MIZORAM,2001,24,MARITAL ISSUES,0,0,0,0,0,0,0,0,0,0,0,0,0,0,0,0,0,0,0
6573,MIZORAM,2001,24,MENTAL HEALTH,0,0,0,0,0,0,0,0,0,0,0,0,0,0,0,0,0,0,0
7119,MIZORAM,2001,24,OTHERS,5,4,2,0,1,12,0,1,1,1,1,4,0,0,0,0,0,0,16
7704,MIZORAM,2001,24,"PHYSICAL ABUSE (RAPE,INCEST ETC.)",0,0,0,0,0,0,0,0,0,0,0,0,0,0,0,0,0,0,0
8210,MIZORAM,2001,24,SOCIETAL ISSUES,0,0,0,0,0,0,0,0,0,0,0,0,0,0,0,0,0,0,0
63,MIZORAM,2002,24,CAUSES NOT KNOWN,0,23,19,8,2,52,0,5,2,3,0,10,0,0,0,0,0,0,62
609,MIZORAM,2002,24,DEATH OF DEAR PERSON,0,0,0,0,0,0,0,0,0,0,0,0,0,0,0,0,0,0,0
1155,MIZORAM,2002,24,DOWRY DISPUTE,0,0,0,0,0,0,0,0,0,0,0,0,0,0,0,0,0,0,0
1701,MIZORAM,2002,24,DRUG ABUSE,0,4,0,0,0,4,0,0,0,0,0,0,0,0,0,0,0,0,4
2247,MIZORAM,2002,24,ECONOMIC ISSUES,0,0,0,0,0,0,0,0,0,0,0,0,0,0,0,0,0,0,0
2793,MIZORAM,2002,24,EXAM FAILURE,0,0,0,0,0,0,0,0,0,0,0,0,0,0,0,0,0,0,0
3339,MIZORAM,2002,24,FAMILY PROBLEMS,0,0,0,0,0,0,0,0,0,0,0,0,0,0,0,0,0,0,0
3885,MIZORAM,2002,24,HEALTH ISSUES,0,0,0,0,0,0,0,0,0,0,0,0,0,0,0,0,0,0,0
4431,MIZORAM,2002,24,HERO WORSHIP,0,0,0,0,0,0,0,0,0,0,0,0,0,0,0,0,0,0,0
4976,MIZORAM,2002,24,ILLEGITIMATE PREGNANCY,0,0,0,0,0,0,0,0,0,0,0,0,0,0,0,0,0,0,0
5521,MIZORAM,2002,24,LOVE AFFAIRS,0,0,0,0,0,0,0,0,0,0,0,0,0,0,0,0,0,0,0
6066,MIZORAM,2002,24,MARITAL ISSUES,0,0,0,0,0,0,0,0,0,0,0,0,0,0,0,0,0,0,0
6612,MIZORAM,2002,24,MENTAL HEALTH,0,0,0,0,0,0,0,0,0,0,0,0,0,0,0,0,0,0,0
7158,MIZORAM,2002,24,OTHERS,0,0,0,0,0,0,0,0,0,0,0,0,0,0,0,0,0,0,0
7743,MIZORAM,2002,24,"PHYSICAL ABUSE (RAPE,INCEST ETC.)",0,0,0,0,0,0,0,0,0,0,0,0,0,0,0,0,0,0,0
8249,MIZORAM,2002,24,SOCIETAL ISSUES,0,0,0,0,0,0,0,0,0,0,0,0,0,0,0,0,0,0,0
102,MIZORAM,2003,24,CAUSES NOT KNOWN,1,16,14,3,0,34,0,2,7,1,0,10,0,0,0,0,0,0,44
648,MIZORAM,2003,24,DEATH OF DEAR PERSON,0,0,0,0,0,0,0,0,0,0,0,0,0,0,0,0,0,0,0
1194,MIZORAM,2003,24,DOWRY DISPUTE,0,0,0,0,0,0,0,0,0,0,0,0,0,0,0,0,0,0,0
1740,MIZORAM,2003,24,DRUG ABUSE,0,0,0,0,0,0,0,1,0,0,0,1,0,0,0,0,0,0,1
2286,MIZORAM,2003,24,ECONOMIC ISSUES,0,1,1,2,0,4,0,0,0,0,0,0,0,0,0,0,0,0,4
2832,MIZORAM,2003,24,EXAM FAILURE,0,0,0,0,0,0,0,0,0,0,0,0,0,0,0,0,0,0,0
3378,MIZORAM,2003,24,FAMILY PROBLEMS,0,0,1,0,0,1,0,0,0,0,0,0,0,0,0,0,0,0,1
3924,MIZORAM,2003,24,HEALTH ISSUES,0,0,0,0,0,0,0,0,0,0,0,0,0,0,0,0,0,0,0
4470,MIZORAM,2003,24,HERO WORSHIP,0,0,0,0,0,0,0,0,0,0,0,0,0,0,0,0,0,0,0
5015,MIZORAM,2003,24,ILLEGITIMATE PREGNANCY,0,0,0,0,0,0,0,0,0,0,0,0,0,0,0,0,0,0,0
5560,MIZORAM,2003,24,LOVE AFFAIRS,0,0,0,0,0,0,0,0,0,0,0,0,0,0,0,0,0,0,0
6105,MIZORAM,2003,24,MARITAL ISSUES,0,0,0,0,0,0,0,0,0,0,0,0,0,0,0,0,0,0,0
6651,MIZORAM,2003,24,MENTAL HEALTH,0,0,0,0,0,0,0,0,0,0,0,0,0,0,0,0,0,0,0
7197,MIZORAM,2003,24,OTHERS,0,1,0,1,0,2,0,0,0,0,0,0,0,0,0,0,0,0,2
7782,MIZORAM,2003,24,"PHYSICAL ABUSE (RAPE,INCEST ETC.)",0,0,0,0,0,0,0,0,0,0,0,0,0,0,0,0,0,0,0
8288,MIZORAM,2003,24,SOCIETAL ISSUES,0,0,0,0,0,0,0,0,0,0,0,0,0,0,0,0,0,0,0
141,MIZORAM,2004,24,CAUSES NOT KNOWN,0,21,17,7,0,45,0,4,1,0,0,5,0,0,0,0,0,0,50
687,MIZORAM,2004,24,DEATH OF DEAR PERSON,0,0,0,0,0,0,0,0,0,0,0,0,0,0,0,0,0,0,0
1233,MIZORAM,2004,24,DOWRY DISPUTE,0,0,0,0,0,0,0,0,0,0,0,0,0,0,0,0,0,0,0
1779,MIZORAM,2004,24,DRUG ABUSE,0,8,0,0,0,8,0,2,0,0,0,2,0,0,0,0,0,0,10
2325,MIZORAM,2004,24,ECONOMIC ISSUES,0,0,0,0,0,0,0,0,0,0,0,0,0,0,0,0,0,0,0
2871,MIZORAM,2004,24,EXAM FAILURE,0,0,0,0,0,0,0,0,0,0,0,0,0,0,0,0,0,0,0
3417,MIZORAM,2004,24,FAMILY PROBLEMS,0,0,0,0,0,0,0,0,0,0,0,0,0,0,0,0,0,0,0
3963,MIZORAM,2004,24,HEALTH ISSUES,0,0,0,0,0,0,0,0,0,0,0,0,0,0,0,0,0,0,0
4509,MIZORAM,2004,24,HERO WORSHIP,0,0,0,0,0,0,0,0,0,0,0,0,0,0,0,0,0,0,0
5054,MIZORAM,2004,24,ILLEGITIMATE PREGNANCY,0,0,0,0,0,0,0,0,0,0,0,0,0,0,0,0,0,0,0
5599,MIZORAM,2004,24,LOVE AFFAIRS,0,0,0,0,0,0,0,0,0,0,0,0,0,0,0,0,0,0,0
6144,MIZORAM,2004,24,MARITAL ISSUES,0,0,0,0,0,0,0,0,0,0,0,0,0,0,0,0,0,0,0
6690,MIZORAM,2004,24,MENTAL HEALTH,0,0,0,0,0,0,0,0,0,0,0,0,0,0,0,0,0,0,0
7236,MIZORAM,2004,24,OTHERS,0,0,0,0,0,0,0,0,0,0,0,0,0,0,0,0,0,0,0
7821,MIZORAM,2004,24,"PHYSICAL ABUSE (RAPE,INCEST ETC.)",0,0,0,0,0,0,0,0,0,0,0,0,0,0,0,0,0,0,0
8327,MIZORAM,2004,24,SOCIETAL ISSUES,0,0,0,0,0,0,0,0,0,0,0,0,0,0,0,0,0,0,0
180,MIZORAM,2005,24,CAUSES NOT KNOWN,0,7,5,0,0,12,0,1,1,0,0,2,0,0,0,0,0,0,14
726,MIZORAM,2005,24,DEATH OF DEAR PERSON,0,0,0,0,0,0,0,0,0,0,0,0,0,0,0,0,0,0,0
1272,MIZORAM,2005,24,DOWRY DISPUTE,0,0,0,0,0,0,0,0,0,0,0,0,0,0,0,0,0,0,0
1818,MIZORAM,2005,24,DRUG ABUSE,0,3,0,0,0,3,0,0,0,0,0,0,0,0,0,0,0,0,3
2364,MIZORAM,2005,24,ECONOMIC ISSUES,0,0,0,0,0,0,0,0,0,0,0,0,0,0,0,0,0,0,0
2910,MIZORAM,2005,24,EXAM FAILURE,0,0,0,0,0,0,0,0,0,0,0,0,0,0,0,0,0,0,0
3456,MIZORAM,2005,24,FAMILY PROBLEMS,0,0,0,0,0,0,0,0,0,0,0,0,0,0,0,0,0,0,0
4002,MIZORAM,2005,24,HEALTH ISSUES,0,0,0,0,0,0,0,0,0,0,0,0,0,0,0,0,0,0,0
4548,MIZORAM,2005,24,HERO WORSHIP,0,0,0,0,0,0,0,0,0,0,0,0,0,0,0,0,0,0,0
5093,MIZORAM,2005,24,ILLEGITIMATE PREGNANCY,0,0,0,0,0,0,0,0,0,0,0,0,0,0,0,0,0,0,0
5638,MIZORAM,2005,24,LOVE AFFAIRS,0,0,0,0,0,0,0,0,0,0,0,0,0,0,0,0,0,0,0
6183,MIZORAM,2005,24,MARITAL ISSUES,0,0,1,0,0,1,0,0,0,0,0,0,0,0,0,0,0,0,1
6729,MIZORAM,2005,24,MENTAL HEALTH,0,0,0,0,0,0,0,0,0,0,0,0,0,0,0,0,0,0,0
7275,MIZORAM,2005,24,OTHERS,2,9,14,4,2,31,0,2,3,1,0,6,0,0,0,0,0,0,37
7860,MIZORAM,2005,24,"PHYSICAL ABUSE (RAPE,INCEST ETC.)",0,0,0,0,0,0,0,0,0,0,0,0,0,0,0,0,0,0,0
8366,MIZORAM,2005,24,SOCIETAL ISSUES,0,0,0,0,0,0,0,0,0,0,0,0,0,0,0,0,0,0,0
219,MIZORAM,2006,24,CAUSES NOT KNOWN,0,7,3,0,2,12,0,1,0,1,0,2,0,0,0,0,0,0,14
765,MIZORAM,2006,24,DEATH OF DEAR PERSON,0,0,0,0,0,0,0,0,0,1,0,1,0,0,0,0,0,0,1
1311,MIZORAM,2006,24,DOWRY DISPUTE,0,0,0,0,0,0,0,0,0,0,0,0,0,0,0,0,0,0,0
1857,MIZORAM,2006,24,DRUG ABUSE,0,5,1,0,0,6,0,0,0,0,0,0,0,0,0,0,0,0,6
2403,MIZORAM,2006,24,ECONOMIC ISSUES,0,2,1,0,1,4,0,0,0,0,0,0,0,0,0,0,0,0,4
2949,MIZORAM,2006,24,EXAM FAILURE,0,0,0,0,0,0,0,0,0,0,0,0,0,0,0,0,0,0,0
3495,MIZORAM,2006,24,FAMILY PROBLEMS,0,3,3,2,1,9,0,1,0,1,0,2,0,0,0,0,0,0,11
4041,MIZORAM,2006,24,HEALTH ISSUES,0,0,0,0,0,0,0,0,0,0,0,0,0,0,0,0,0,0,0
4586,MIZORAM,2006,24,HERO WORSHIP,0,0,0,0,0,0,0,0,0,0,0,0,0,0,0,0,0,0,0
5131,MIZORAM,2006,24,ILLEGITIMATE PREGNANCY,0,0,0,0,0,0,0,0,0,0,0,0,0,0,0,0,0,0,0
5676,MIZORAM,2006,24,LOVE AFFAIRS,0,0,0,0,0,0,0,1,0,0,0,1,0,0,0,0,0,0,1
6222,MIZORAM,2006,24,MARITAL ISSUES,0,0,0,0,0,0,0,0,0,0,0,0,0,0,0,0,0,0,0
6768,MIZORAM,2006,24,MENTAL HEALTH,0,0,1,0,0,1,0,0,0,0,0,0,0,0,0,0,0,0,1
7314,MIZORAM,2006,24,OTHERS,0,14,13,1,0,28,0,2,2,0,0,4,0,0,0,0,0,0,32
7898,MIZORAM,2006,24,"PHYSICAL ABUSE (RAPE,INCEST ETC.)",0,0,0,0,0,0,0,0,0,0,0,0,0,0,0,0,0,0,0
8405,MIZORAM,2006,24,SOCIETAL ISSUES,0,0,0,0,0,0,0,0,0,0,0,0,0,0,0,0,0,0,0
258,MIZORAM,2007,24,CAUSES NOT KNOWN,1,9,5,1,0,16,0,1,3,0,0,4,0,0,0,0,0,0,20
804,MIZORAM,2007,24,DEATH OF DEAR PERSON,0,0,0,0,0,0,0,0,0,0,0,0,0,0,0,0,0,0,0
1350,MIZORAM,2007,24,DOWRY DISPUTE,0,0,0,0,0,0,0,0,0,0,0,0,0,0,0,0,0,0,0
1896,MIZORAM,2007,24,DRUG ABUSE,0,0,0,0,0,0,0,0,0,0,0,0,0,0,0,0,0,0,0
2442,MIZORAM,2007,24,ECONOMIC ISSUES,0,0,0,0,0,0,0,0,0,0,0,0,0,0,0,0,0,0,0
2988,MIZORAM,2007,24,EXAM FAILURE,0,0,0,0,0,0,0,0,0,0,0,0,0,0,0,0,0,0,0
3534,MIZORAM,2007,24,FAMILY PROBLEMS,0,0,0,0,0,0,0,0,0,0,0,0,0,0,0,0,0,0,0
4080,MIZORAM,2007,24,HEALTH ISSUES,0,0,0,0,0,0,0,0,0,0,0,0,0,0,0,0,0,0,0
4625,MIZORAM,2007,24,HERO WORSHIP,0,0,0,0,0,0,0,0,0,0,0,0,0,0,0,0,0,0,0
5170,MIZORAM,2007,24,ILLEGITIMATE PREGNANCY,0,0,0,0,0,0,0,0,0,0,0,0,0,0,0,0,0,0,0
5715,MIZORAM,2007,24,LOVE AFFAIRS,0,0,1,0,0,1,0,0,0,0,0,0,0,0,0,0,0,0,1
6261,MIZORAM,2007,24,MARITAL ISSUES,0,0,0,0,0,0,0,0,0,0,0,0,0,0,0,0,0,0,0
6807,MIZORAM,2007,24,MENTAL HEALTH,0,0,0,0,0,0,0,0,0,0,0,0,0,0,0,0,0,0,0
7353,MIZORAM,2007,24,OTHERS,0,0,0,0,0,0,0,0,0,0,0,0,0,0,0,0,0,0,0
7937,MIZORAM,2007,24,"PHYSICAL ABUSE (RAPE,INCEST ETC.)",0,0,0,0,0,0,0,0,0,0,0,0,0,0,0,0,0,0,0
8444,MIZORAM,2007,24,SOCIETAL ISSUES,0,0,2,1,2,5,0,0,0,2,0,2,0,0,0,0,0,0,7
297,MIZORAM,2008,24,CAUSES NOT KNOWN,0,7,9,7,0,23,0,2,2,1,0,5,0,0,0,0,0,0,28
843,MIZORAM,2008,24,DEATH OF DEAR PERSON,0,0,0,0,0,0,0,0,0,0,0,0,0,0,0,0,0,0,0
1389,MIZORAM,2008,24,DOWRY DISPUTE,0,0,0,0,0,0,0,0,0,0,0,0,0,0,0,0,0,0,0
1935,MIZORAM,2008,24,DRUG ABUSE,0,2,4,0,0,6,0,0,1,0,0,1,0,0,0,0,0,0,7
2481,MIZORAM,2008,24,ECONOMIC ISSUES,0,0,0,0,0,0,0,0,0,0,0,0,0,0,0,0,0,0,0
3027,MIZORAM,2008,24,EXAM FAILURE,0,0,0,0,0,0,0,0,0,0,0,0,0,0,0,0,0,0,0
3573,MIZORAM,2008,24,FAMILY PROBLEMS,0,1,0,0,0,1,0,0,0,0,0,0,0,0,0,0,0,0,1
4119,MIZORAM,2008,24,HEALTH ISSUES,0,0,0,0,0,0,0,0,0,0,0,0,0,0,0,0,0,0,0
4664,MIZORAM,2008,24,HERO WORSHIP,0,0,0,0,0,0,0,0,0,0,0,0,0,0,0,0,0,0,0
5209,MIZORAM,2008,24,ILLEGITIMATE PREGNANCY,0,0,0,0,0,0,0,0,0,0,0,0,0,0,0,0,0,0,0
5754,MIZORAM,2008,24,LOVE AFFAIRS,0,0,0,0,0,0,0,0,0,0,0,0,0,0,0,0,0,0,0
6300,MIZORAM,2008,24,MARITAL ISSUES,0,0,0,0,0,0,0,0,0,0,0,0,0,0,0,0,0,0,0
6846,MIZORAM,2008,24,MENTAL HEALTH,0,0,0,0,0,0,0,0,0,0,0,0,0,0,0,0,0,0,0
7392,MIZORAM,2008,24,OTHERS,0,2,3,0,0,5,0,0,0,0,0,0,0,0,0,0,0,0,5
7976,MIZORAM,2008,24,"PHYSICAL ABUSE (RAPE,INCEST ETC.)",0,0,0,0,0,0,0,0,0,0,0,0,0,0,0,0,0,0,0
8483,MIZORAM,2008,24,SOCIETAL ISSUES,0,0,0,0,0,0,0,0,0,0,0,0,0,0,0,0,0,0,0
336,MIZORAM,2009,24,CAUSES NOT KNOWN,0,7,6,1,0,14,0,1,0,1,0,2,0,0,0,0,0,0,16
882,MIZORAM,2009,24,DEATH OF DEAR PERSON,0,0,0,0,0,0,0,0,0,0,0,0,0,0,0,0,0,0,0
1428,MIZORAM,2009,24,DOWRY DISPUTE,0,0,0,0,0,0,0,0,0,0,0,0,0,0,0,0,0,0,0
1974,MIZORAM,2009,24,DRUG ABUSE,1,2,0,0,0,3,0,0,0,0,0,0,0,0,0,0,0,0,3
2520,MIZORAM,2009,24,ECONOMIC ISSUES,0,0,0,0,0,0,0,0,0,0,0,0,0,0,0,0,0,0,0
3066,MIZORAM,2009,24,EXAM FAILURE,0,0,0,0,0,0,0,0,0,0,0,0,0,0,0,0,0,0,0
3612,MIZORAM,2009,24,FAMILY PROBLEMS,0,0,0,0,0,0,0,0,0,0,0,0,0,0,0,0,0,0,0
4158,MIZORAM,2009,24,HEALTH ISSUES,0,0,0,0,0,0,0,0,0,0,0,0,0,0,0,0,0,0,0
4703,MIZORAM,2009,24,HERO WORSHIP,0,0,0,0,0,0,0,0,0,0,0,0,0,0,0,0,0,0,0
5248,MIZORAM,2009,24,ILLEGITIMATE PREGNANCY,0,0,0,0,0,0,0,0,0,0,0,0,0,0,0,0,0,0,0
5793,MIZORAM,2009,24,LOVE AFFAIRS,0,0,0,0,0,0,0,0,0,0,0,0,0,0,0,0,0,0,0
6339,MIZORAM,2009,24,MARITAL ISSUES,0,0,0,0,0,0,0,0,0,0,0,0,0,0,0,0,0,0,0
6885,MIZORAM,2009,24,MENTAL HEALTH,0,0,0,0,0,0,0,0,0,0,0,0,0,0,0,0,0,0,0
7431,MIZORAM,2009,24,OTHERS,0,22,19,3,1,45,0,2,2,1,0,5,0,0,0,0,0,0,50
8015,MIZORAM,2009,24,"PHYSICAL ABUSE (RAPE,INCEST ETC.)",0,0,0,0,0,0,0,0,0,0,0,0,0,0,0,0,0,0,0
8522,MIZORAM,2009,24,SOCIETAL ISSUES,0,0,0,0,0,0,0,0,0,0,0,0,0,0,0,0,0,0,0
375,MIZORAM,2010,24,CAUSES NOT KNOWN,3,22,21,6,1,53,0,3,0,0,0,3,0,0,0,0,0,0,56
921,MIZORAM,2010,24,DEATH OF DEAR PERSON,0,0,0,0,0,0,0,0,0,0,0,0,0,0,0,0,0,0,0
1467,MIZORAM,2010,24,DOWRY DISPUTE,0,0,0,0,0,0,0,0,0,0,0,0,0,0,0,0,0,0,0
2013,MIZORAM,2010,24,DRUG ABUSE,0,5,1,0,0,6,0,0,0,0,0,0,0,0,0,0,0,0,6
2559,MIZORAM,2010,24,ECONOMIC ISSUES,0,0,0,0,0,0,0,0,0,0,0,0,0,0,0,0,0,0,0
3105,MIZORAM,2010,24,EXAM FAILURE,0,0,0,0,0,0,0,0,0,0,0,0,0,0,0,0,0,0,0
3651,MIZORAM,2010,24,FAMILY PROBLEMS,0,1,0,0,1,2,0,0,0,0,0,0,0,0,0,0,0,0,2
4197,MIZORAM,2010,24,HEALTH ISSUES,0,0,0,0,0,0,0,0,0,0,0,0,0,0,0,0,0,0,0
4742,MIZORAM,2010,24,HERO WORSHIP,0,0,0,0,0,0,0,0,0,0,0,0,0,0,0,0,0,0,0
5287,MIZORAM,2010,24,ILLEGITIMATE PREGNANCY,0,0,0,0,0,0,0,0,0,0,0,0,0,0,0,0,0,0,0
5832,MIZORAM,2010,24,LOVE AFFAIRS,0,1,0,0,0,1,0,3,0,0,0,3,0,0,0,0,0,0,4
6378,MIZORAM,2010,24,MARITAL ISSUES,0,0,1,0,0,1,0,0,0,0,0,0,0,0,0,0,0,0,1
6924,MIZORAM,2010,24,MENTAL HEALTH,0,0,0,0,0,0,0,0,0,0,0,0,0,0,0,0,0,0,0
7470,MIZORAM,2010,24,OTHERS,1,1,2,0,0,4,0,2,1,0,0,3,0,0,0,0,0,0,7
8054,MIZORAM,2010,24,"PHYSICAL ABUSE (RAPE,INCEST ETC.)",0,0,0,0,0,0,0,0,0,0,0,0,0,0,0,0,0,0,0
8561,MIZORAM,2010,24,SOCIETAL ISSUES,0,0,0,0,0,0,0,0,0,0,0,0,0,0,0,0,0,0,0
414,MIZORAM,2011,24,CAUSES NOT KNOWN,1,16,17,5,1,40,0,3,5,1,0,9,0,0,0,0,0,0,49
960,MIZORAM,2011,24,DEATH OF DEAR PERSON,0,0,2,0,0,2,0,0,0,0,0,0,0,0,0,0,0,0,2
1506,MIZORAM,2011,24,DOWRY DISPUTE,0,0,0,0,0,0,0,0,0,0,0,0,0,0,0,0,0,0,0
2052,MIZORAM,2011,24,DRUG ABUSE,0,5,0,0,0,5,0,0,0,0,0,0,0,0,0,0,0,0,5
2598,MIZORAM,2011,24,ECONOMIC ISSUES,0,0,0,1,0,1,0,0,0,0,0,0,0,0,0,0,0,0,1
3144,MIZORAM,2011,24,EXAM FAILURE,0,0,0,0,0,0,0,0,0,0,0,0,0,0,0,0,0,0,0
3690,MIZORAM,2011,24,FAMILY PROBLEMS,1,0,5,0,0,6,0,0,0,0,0,0,0,0,0,0,0,0,6
4236,MIZORAM,2011,24,HEALTH ISSUES,0,10,0,0,1,11,0,0,0,0,0,0,0,0,0,0,0,0,11
4781,MIZORAM,2011,24,HERO WORSHIP,0,0,0,0,0,0,0,0,0,0,0,0,0,0,0,0,0,0,0
5326,MIZORAM,2011,24,ILLEGITIMATE PREGNANCY,0,0,0,0,0,0,0,2,0,0,0,2,0,0,0,0,0,0,2
5871,MIZORAM,2011,24,LOVE AFFAIRS,0,0,0,0,0,0,0,0,0,0,0,0,0,0,0,0,0,0,0
6417,MIZORAM,2011,24,MARITAL ISSUES,0,3,4,0,0,7,0,0,0,1,0,1,0,0,0,0,0,0,8
6963,MIZORAM,2011,24,MENTAL HEALTH,0,0,0,0,0,0,0,0,0,0,0,0,0,0,0,0,0,0,0
7509,MIZORAM,2011,24,OTHERS,0,3,1,1,0,5,0,0,1,0,0,1,0,0,0,0,0,0,6
8093,MIZORAM,2011,24,"PHYSICAL ABUSE (RAPE,INCEST ETC.)",0,0,0,0,0,0,0,0,0,0,0,0,0,0,0,0,0,0,0
8600,MIZORAM,2011,24,SOCIETAL ISSUES,0,0,0,0,0,0,0,0,0,0,0,0,0,0,0,0,0,0,0
453,MIZORAM,2012,24,CAUSES NOT KNOWN,1,19,9,6,0,35,0,1,1,0,0,2,0,0,0,0,0,0,37
999,MIZORAM,2012,24,DEATH OF DEAR PERSON,0,0,0,0,0,0,0,0,0,0,0,0,0,0,0,0,0,0,0
1545,MIZORAM,2012,24,DOWRY DISPUTE,0,0,0,0,0,0,0,0,0,0,0,0,0,0,0,0,0,0,0
2091,MIZORAM,2012,24,DRUG ABUSE,1,27,23,3,3,57,2,2,0,0,0,4,0,0,0,0,0,0,61
2637,MIZORAM,2012,24,ECONOMIC ISSUES,3,9,9,2,1,24,0,0,0,0,1,1,0,0,0,0,0,0,25
3183,MIZORAM,2012,24,EXAM FAILURE,0,0,0,0,0,0,0,0,0,0,0,0,0,0,0,0,0,0,0
3729,MIZORAM,2012,24,FAMILY PROBLEMS,0,3,1,1,0,5,0,0,0,0,0,0,0,0,0,0,0,0,5
4275,MIZORAM,2012,24,HEALTH ISSUES,0,0,0,0,0,0,0,0,0,0,0,0,0,0,0,0,0,0,0
4820,MIZORAM,2012,24,HERO WORSHIP,0,0,0,0,0,0,0,0,0,0,0,0,0,0,0,0,0,0,0
5365,MIZORAM,2012,24,ILLEGITIMATE PREGNANCY,0,0,0,0,0,0,0,0,0,3,0,3,0,0,0,0,0,0,3
5910,MIZORAM,2012,24,LOVE AFFAIRS,0,0,0,0,0,0,0,0,0,0,0,0,0,0,0,0,0,0,0
6456,MIZORAM,2012,24,MARITAL ISSUES,0,0,0,0,0,0,0,0,0,0,0,0,0,0,0,0,0,0,0
7002,MIZORAM,2012,24,MENTAL HEALTH,0,0,0,0,0,0,0,0,0,0,0,0,0,0,0,0,0,0,0
7548,MIZORAM,2012,24,OTHERS,2,12,15,3,4,36,1,4,0,1,0,6,0,0,0,0,0,0,42
8132,MIZORAM,2012,24,"PHYSICAL ABUSE (RAPE,INCEST ETC.)",0,0,0,0,0,0,0,0,0,0,0,0,0,0,0,0,0,0,0
8639,MIZORAM,2012,24,SOCIETAL ISSUES,0,0,0,0,0,0,0,0,0,0,0,0,0,0,0,0,0,0,0
492,MIZORAM,2013,24,CAUSES NOT KNOWN,2,10,6,6,0,24,2,2,3,1,0,8,0,0,0,0,0,0,32
1038,MIZORAM,2013,24,DEATH OF DEAR PERSON,0,24,12,4,1,41,0,3,0,1,0,4,0,0,0,0,0,0,45
1584,MIZORAM,2013,24,DOWRY DISPUTE,0,0,0,0,0,0,0,0,0,0,0,0,0,0,0,0,0,0,0
2130,MIZORAM,2013,24,DRUG ABUSE,0,6,1,0,0,7,0,1,0,0,0,1,0,0,0,0,0,0,8
2676,MIZORAM,2013,24,ECONOMIC ISSUES,0,0,0,0,0,0,0,0,0,0,0,0,0,0,0,0,0,0,0
3222,MIZORAM,2013,24,EXAM FAILURE,0,0,0,0,0,0,0,0,0,0,0,0,0,0,0,0,0,0,0
3768,MIZORAM,2013,24,FAMILY PROBLEMS,0,1,0,0,0,1,0,0,0,0,0,0,0,0,0,0,0,0,1
4314,MIZORAM,2013,24,HEALTH ISSUES,0,0,0,0,0,0,0,0,0,0,0,0,0,0,0,0,0,0,0
4859,MIZORAM,2013,24,HERO WORSHIP,0,0,0,0,0,0,0,0,0,0,0,0,0,0,0,0,0,0,0
5404,MIZORAM,2013,24,ILLEGITIMATE PREGNANCY,0,0,0,0,0,0,0,0,0,0,0,0,0,0,0,0,0,0,0
5949,MIZORAM,2013,24,LOVE AFFAIRS,0,0,0,0,0,0,0,0,0,0,0,0,0,0,0,0,0,0,0
6495,MIZORAM,2013,24,MARITAL ISSUES,0,0,0,0,0,0,0,0,0,0,0,0,0,0,0,0,0,0,0
7041,MIZORAM,2013,24,MENTAL HEALTH,0,0,0,0,0,0,0,0,0,0,0,0,0,0,0,0,0,0,0
7587,MIZORAM,2013,24,OTHERS,1,3,1,1,0,6,0,1,1,1,0,3,0,0,0,0,0,0,9
8171,MIZORAM,2013,24,"PHYSICAL ABUSE (RAPE,INCEST ETC.)",0,0,0,0,0,0,0,0,0,0,0,0,0,0,0,0,0,0,0
8678,MIZORAM,2013,24,SOCIETAL ISSUES,0,0,0,0,0,0,0,0,0,0,0,0,0,0,0,0,0,0,0
531,MIZORAM,2014,24,CAUSES NOT KNOWN,1,11,12,4,0,28,0,1,0,0,1,2,0,0,0,0,0,0,30
1077,MIZORAM,2014,24,DEATH OF DEAR PERSON,0,0,0,0,0,0,0,0,0,0,0,0,0,0,0,0,0,0,0
1623,MIZORAM,2014,24,DOWRY DISPUTE,0,0,0,0,0,0,0,0,0,0,0,0,0,0,0,0,0,0,0
2169,MIZORAM,2014,24,DRUG ABUSE,0,2,3,0,0,5,0,0,0,0,0,0,0,0,0,0,0,0,5
2715,MIZORAM,2014,24,ECONOMIC ISSUES,0,0,0,0,0,0,0,0,0,0,0,0,0,0,0,0,0,0,0
3261,MIZORAM,2014,24,EXAM FAILURE,0,1,0,0,0,1,0,0,0,0,0,0,0,0,0,0,0,0,1
3807,MIZORAM,2014,24,FAMILY PROBLEMS,2,18,14,5,4,43,0,8,1,2,0,11,0,0,0,0,0,0,54
4353,MIZORAM,2014,24,HEALTH ISSUES,2,0,0,1,0,3,0,0,0,0,0,0,0,0,0,0,0,0,3
4898,MIZORAM,2014,24,HERO WORSHIP,0,0,0,0,0,0,0,0,0,0,0,0,0,0,0,0,0,0,0
5443,MIZORAM,2014,24,ILLEGITIMATE PREGNANCY,0,0,0,0,0,0,0,0,0,0,0,0,0,0,0,0,0,0,0
5988,MIZORAM,2014,24,LOVE AFFAIRS,0,0,0,0,0,0,0,1,0,0,0,1,0,0,0,0,0,0,1
6534,MIZORAM,2014,24,MARITAL ISSUES,0,1,2,0,0,3,0,1,0,0,0,1,0,0,0,0,0,0,4
7080,MIZORAM,2014,24,MENTAL HEALTH,0,0,0,1,0,1,0,0,0,0,0,0,0,0,0,0,0,0,1
7626,MIZORAM,2014,24,OTHERS,0,9,8,2,1,20,0,1,0,1,0,2,0,0,0,0,0,0,22
7665,MIZORAM,2014,24,PHYSICAL ABUSE,0,0,0,0,0,0,0,0,0,0,0,0,0,0,0,0,0,0,0
8717,MIZORAM,2014,24,SOCIETAL ISSUES,0,0,0,0,0,0,0,0,0,0,0,0,0,0,0,0,0,0,0
25,NAGALAND,2001,25,CAUSES NOT KNOWN,0,2,8,1,0,11,0,2,4,0,0,6,0,0,0,0,0,0,17
571,NAGALAND,2001,25,DEATH OF DEAR PERSON,0,0,0,0,0,0,0,0,0,0,0,0,0,0,0,0,0,0,0
1117,NAGALAND,2001,25,DOWRY DISPUTE,0,0,0,0,0,0,0,0,0,0,0,0,0,0,0,0,0,0,0
1663,NAGALAND,2001,25,DRUG ABUSE,0,0,2,0,0,2,0,0,0,0,0,0,0,0,0,0,0,0,2
2209,NAGALAND,2001,25,ECONOMIC ISSUES,0,0,0,0,0,0,0,0,0,0,0,0,0,0,0,0,0,0,0
2755,NAGALAND,2001,25,EXAM FAILURE,0,0,0,0,0,0,0,0,0,0,0,0,0,0,0,0,0,0,0
3301,NAGALAND,2001,25,FAMILY PROBLEMS,0,1,3,1,0,5,0,1,1,1,0,3,0,0,0,0,0,0,8
3847,NAGALAND,2001,25,HEALTH ISSUES,0,0,1,0,0,1,0,0,0,0,0,0,0,0,0,0,0,0,1
4393,NAGALAND,2001,25,HERO WORSHIP,0,0,0,0,0,0,0,0,0,0,0,0,0,0,0,0,0,0,0
4938,NAGALAND,2001,25,ILLEGITIMATE PREGNANCY,0,0,0,0,0,0,0,0,0,0,0,0,0,0,0,0,0,0,0
5483,NAGALAND,2001,25,LOVE AFFAIRS,0,0,0,0,0,0,0,3,0,0,0,3,0,0,0,0,0,0,3
6028,NAGALAND,2001,25,MARITAL ISSUES,0,0,0,0,0,0,0,0,0,0,0,0,0,0,0,0,0,0,0
6574,NAGALAND,2001,25,MENTAL HEALTH,0,0,0,0,0,0,0,0,0,0,0,0,0,0,0,0,0,0,0
7120,NAGALAND,2001,25,OTHERS,0,5,1,0,0,6,0,1,0,0,0,1,0,0,0,0,0,0,7
7705,NAGALAND,2001,25,"PHYSICAL ABUSE (RAPE,INCEST ETC.)",0,0,0,0,0,0,0,0,0,2,0,2,0,0,0,0,0,0,2
8211,NAGALAND,2001,25,SOCIETAL ISSUES,0,0,0,0,0,0,0,0,0,0,0,0,0,0,0,0,0,0,0
64,NAGALAND,2002,25,CAUSES NOT KNOWN,0,2,6,0,0,8,0,1,2,0,0,3,0,0,0,0,0,0,11
610,NAGALAND,2002,25,DEATH OF DEAR PERSON,0,0,0,0,0,0,0,0,0,0,0,0,0,0,0,0,0,0,0
1156,NAGALAND,2002,25,DOWRY DISPUTE,0,0,0,0,0,0,0,0,0,0,0,0,0,0,0,0,0,0,0
1702,NAGALAND,2002,25,DRUG ABUSE,0,0,0,0,0,0,0,0,0,0,0,0,0,0,0,0,0,0,0
2248,NAGALAND,2002,25,ECONOMIC ISSUES,1,0,8,0,0,9,1,2,1,0,0,4,0,0,0,0,0,0,13
2794,NAGALAND,2002,25,EXAM FAILURE,0,0,0,0,0,0,0,0,0,0,0,0,0,0,0,0,0,0,0
3340,NAGALAND,2002,25,FAMILY PROBLEMS,0,0,0,0,0,0,0,0,0,0,0,0,0,0,0,0,0,0,0
3886,NAGALAND,2002,25,HEALTH ISSUES,0,0,0,0,0,0,0,0,0,0,0,0,0,0,0,0,0,0,0
4432,NAGALAND,2002,25,HERO WORSHIP,0,0,0,0,0,0,0,0,0,0,0,0,0,0,0,0,0,0,0
4977,NAGALAND,2002,25,ILLEGITIMATE PREGNANCY,0,0,0,0,0,0,0,0,0,0,0,0,0,0,0,0,0,0,0
5522,NAGALAND,2002,25,LOVE AFFAIRS,0,0,0,0,0,0,0,0,0,0,0,0,0,0,0,0,0,0,0
6067,NAGALAND,2002,25,MARITAL ISSUES,0,0,0,0,0,0,0,0,0,0,0,0,0,0,0,0,0,0,0
6613,NAGALAND,2002,25,MENTAL HEALTH,0,0,0,0,0,0,0,0,0,0,0,0,0,0,0,0,0,0,0
7159,NAGALAND,2002,25,OTHERS,0,0,1,1,0,2,1,0,0,0,0,1,0,0,0,0,0,0,3
7744,NAGALAND,2002,25,"PHYSICAL ABUSE (RAPE,INCEST ETC.)",0,0,0,0,0,0,0,0,0,0,0,0,0,0,0,0,0,0,0
8250,NAGALAND,2002,25,SOCIETAL ISSUES,0,0,0,0,0,0,0,0,0,0,0,0,0,0,0,0,0,0,0
103,NAGALAND,2003,25,CAUSES NOT KNOWN,0,4,8,0,0,12,0,1,0,0,0,1,0,0,0,0,0,0,13
649,NAGALAND,2003,25,DEATH OF DEAR PERSON,0,0,0,0,0,0,0,0,0,0,0,0,0,0,0,0,0,0,0
1195,NAGALAND,2003,25,DOWRY DISPUTE,0,0,0,0,0,0,0,0,0,0,0,0,0,0,0,0,0,0,0
1741,NAGALAND,2003,25,DRUG ABUSE,0,2,3,0,0,5,0,0,0,0,0,0,0,0,0,0,0,0,5
2287,NAGALAND,2003,25,ECONOMIC ISSUES,0,0,0,0,0,0,0,0,0,0,0,0,0,0,0,0,0,0,0
2833,NAGALAND,2003,25,EXAM FAILURE,0,0,0,0,0,0,0,0,0,0,0,0,0,0,0,0,0,0,0
3379,NAGALAND,2003,25,FAMILY PROBLEMS,0,0,0,0,0,0,0,0,0,0,0,0,0,0,0,0,0,0,0
3925,NAGALAND,2003,25,HEALTH ISSUES,0,0,0,0,0,0,0,0,0,0,0,0,0,0,0,0,0,0,0
4471,NAGALAND,2003,25,HERO WORSHIP,0,0,0,0,0,0,0,0,0,0,0,0,0,0,0,0,0,0,0
5016,NAGALAND,2003,25,ILLEGITIMATE PREGNANCY,0,0,0,0,0,0,0,1,0,0,0,1,0,0,0,0,0,0,1
5561,NAGALAND,2003,25,LOVE AFFAIRS,0,0,0,0,0,0,0,0,0,0,0,0,0,0,0,0,0,0,0
6106,NAGALAND,2003,25,MARITAL ISSUES,0,0,0,0,0,0,0,2,0,0,0,2,0,0,0,0,0,0,2
6652,NAGALAND,2003,25,MENTAL HEALTH,0,0,0,0,0,0,0,0,0,0,0,0,0,0,0,0,0,0,0
7198,NAGALAND,2003,25,OTHERS,0,0,0,0,0,0,0,1,0,0,0,1,0,0,0,0,0,0,1
7783,NAGALAND,2003,25,"PHYSICAL ABUSE (RAPE,INCEST ETC.)",0,0,0,0,0,0,0,0,0,0,0,0,0,0,0,0,0,0,0
8289,NAGALAND,2003,25,SOCIETAL ISSUES,0,0,0,0,0,0,0,0,0,0,0,0,0,0,0,0,0,0,0
142,NAGALAND,2004,25,CAUSES NOT KNOWN,0,10,13,2,0,25,0,4,2,0,0,6,0,0,0,0,0,0,31
688,NAGALAND,2004,25,DEATH OF DEAR PERSON,0,0,0,0,0,0,0,0,0,0,0,0,0,0,0,0,0,0,0
1234,NAGALAND,2004,25,DOWRY DISPUTE,0,0,0,0,0,0,0,0,0,0,0,0,0,0,0,0,0,0,0
1780,NAGALAND,2004,25,DRUG ABUSE,0,0,0,0,0,0,0,0,0,0,0,0,0,0,0,0,0,0,0
2326,NAGALAND,2004,25,ECONOMIC ISSUES,0,0,0,0,0,0,0,0,0,0,0,0,0,0,0,0,0,0,0
2872,NAGALAND,2004,25,EXAM FAILURE,0,0,0,0,0,0,0,0,0,0,0,0,0,0,0,0,0,0,0
3418,NAGALAND,2004,25,FAMILY PROBLEMS,0,0,0,0,0,0,0,0,0,0,0,0,0,0,0,0,0,0,0
3964,NAGALAND,2004,25,HEALTH ISSUES,0,0,0,0,0,0,0,0,0,0,0,0,0,0,0,0,0,0,0
4510,NAGALAND,2004,25,HERO WORSHIP,0,0,0,0,0,0,0,0,0,0,0,0,0,0,0,0,0,0,0
5055,NAGALAND,2004,25,ILLEGITIMATE PREGNANCY,0,0,0,0,0,0,0,0,0,0,0,0,0,0,0,0,0,0,0
5600,NAGALAND,2004,25,LOVE AFFAIRS,0,0,0,0,0,0,0,0,0,0,0,0,0,0,0,0,0,0,0
6145,NAGALAND,2004,25,MARITAL ISSUES,0,0,0,0,0,0,0,0,0,0,0,0,0,0,0,0,0,0,0
6691,NAGALAND,2004,25,MENTAL HEALTH,0,0,0,0,0,0,0,0,0,0,0,0,0,0,0,0,0,0,0
7237,NAGALAND,2004,25,OTHERS,0,0,0,0,0,0,0,0,0,0,0,0,0,0,0,0,0,0,0
7822,NAGALAND,2004,25,"PHYSICAL ABUSE (RAPE,INCEST ETC.)",0,0,0,0,0,0,0,0,0,0,0,0,0,0,0,0,0,0,0
8328,NAGALAND,2004,25,SOCIETAL ISSUES,0,0,0,0,0,0,0,0,0,0,0,0,0,0,0,0,0,0,0
181,NAGALAND,2005,25,CAUSES NOT KNOWN,0,0,0,0,0,0,0,0,0,0,0,0,0,0,0,0,0,0,0
727,NAGALAND,2005,25,DEATH OF DEAR PERSON,0,0,0,0,0,0,0,0,0,0,0,0,0,0,0,0,0,0,0
1273,NAGALAND,2005,25,DOWRY DISPUTE,0,0,0,0,0,0,0,0,0,0,0,0,0,0,0,0,0,0,0
1819,NAGALAND,2005,25,DRUG ABUSE,0,1,7,0,0,8,0,0,0,0,0,0,0,0,0,0,0,0,8
2365,NAGALAND,2005,25,ECONOMIC ISSUES,0,0,0,0,0,0,0,0,0,0,0,0,0,0,0,0,0,0,0
2911,NAGALAND,2005,25,EXAM FAILURE,0,0,0,0,0,0,0,0,0,0,0,0,0,0,0,0,0,0,0
3457,NAGALAND,2005,25,FAMILY PROBLEMS,0,0,0,0,0,0,0,0,0,0,0,0,0,0,0,0,0,0,0
4003,NAGALAND,2005,25,HEALTH ISSUES,0,0,2,1,0,3,0,0,1,0,0,1,0,0,0,0,0,0,4
4549,NAGALAND,2005,25,HERO WORSHIP,0,0,0,0,0,0,0,0,0,0,0,0,0,0,0,0,0,0,0
5094,NAGALAND,2005,25,ILLEGITIMATE PREGNANCY,0,0,0,0,0,0,0,0,0,0,0,0,0,0,0,0,0,0,0
5639,NAGALAND,2005,25,LOVE AFFAIRS,0,1,0,0,0,1,0,2,0,0,0,2,0,0,0,0,0,0,3
6184,NAGALAND,2005,25,MARITAL ISSUES,0,0,0,0,0,0,0,0,0,0,0,0,0,0,0,0,0,0,0
6730,NAGALAND,2005,25,MENTAL HEALTH,0,0,0,0,0,0,0,0,0,0,0,0,0,0,0,0,0,0,0
7276,NAGALAND,2005,25,OTHERS,0,2,4,3,0,9,0,1,2,0,0,3,0,0,0,0,0,0,12
7861,NAGALAND,2005,25,"PHYSICAL ABUSE (RAPE,INCEST ETC.)",0,0,0,0,0,0,0,0,0,0,0,0,0,0,0,0,0,0,0
8367,NAGALAND,2005,25,SOCIETAL ISSUES,0,0,0,0,0,0,0,0,0,0,0,0,0,0,0,0,0,0,0
220,NAGALAND,2006,25,CAUSES NOT KNOWN,1,3,3,2,0,9,0,2,3,0,0,5,0,0,0,0,0,0,14
766,NAGALAND,2006,25,DEATH OF DEAR PERSON,0,0,0,0,0,0,0,0,0,0,0,0,0,0,0,0,0,0,0
1312,NAGALAND,2006,25,DOWRY DISPUTE,0,0,0,0,0,0,0,0,0,0,0,0,0,0,0,0,0,0,0
1858,NAGALAND,2006,25,DRUG ABUSE,0,1,1,0,0,2,0,1,0,0,0,1,0,0,0,0,0,0,3
2404,NAGALAND,2006,25,ECONOMIC ISSUES,0,2,0,0,0,2,0,0,0,0,0,0,0,0,0,0,0,0,2
2950,NAGALAND,2006,25,EXAM FAILURE,0,0,0,0,0,0,0,0,0,0,0,0,0,0,0,0,0,0,0
3496,NAGALAND,2006,25,FAMILY PROBLEMS,0,3,1,1,0,5,0,0,1,0,0,1,0,0,0,0,0,0,6
4042,NAGALAND,2006,25,HEALTH ISSUES,0,0,0,0,0,0,0,1,0,0,0,1,0,0,0,0,0,0,1
4587,NAGALAND,2006,25,HERO WORSHIP,0,0,0,0,0,0,0,0,0,0,0,0,0,0,0,0,0,0,0
5132,NAGALAND,2006,25,ILLEGITIMATE PREGNANCY,0,0,0,0,0,0,0,0,0,0,0,0,0,0,0,0,0,0,0
5677,NAGALAND,2006,25,LOVE AFFAIRS,0,0,0,0,0,0,0,0,0,0,0,0,0,0,0,0,0,0,0
6223,NAGALAND,2006,25,MARITAL ISSUES,0,0,0,0,0,0,0,0,0,0,0,0,0,0,0,0,0,0,0
6769,NAGALAND,2006,25,MENTAL HEALTH,0,0,0,0,0,0,0,0,0,0,0,0,0,0,0,0,0,0,0
7315,NAGALAND,2006,25,OTHERS,0,0,1,0,0,1,0,0,0,1,0,1,0,0,0,0,0,0,2
7899,NAGALAND,2006,25,"PHYSICAL ABUSE (RAPE,INCEST ETC.)",0,0,0,0,0,0,0,0,0,0,0,0,0,0,0,0,0,0,0
8406,NAGALAND,2006,25,SOCIETAL ISSUES,0,0,0,0,0,0,0,0,0,0,0,0,0,0,0,0,0,0,0
259,NAGALAND,2007,25,CAUSES NOT KNOWN,0,1,3,4,0,8,0,1,0,0,0,1,0,0,0,0,0,0,9
805,NAGALAND,2007,25,DEATH OF DEAR PERSON,0,0,0,0,0,0,0,0,0,0,0,0,0,0,0,0,0,0,0
1351,NAGALAND,2007,25,DOWRY DISPUTE,0,0,0,0,0,0,0,0,0,0,0,0,0,0,0,0,0,0,0
1897,NAGALAND,2007,25,DRUG ABUSE,0,0,1,0,0,1,0,0,1,0,0,1,0,0,0,0,0,0,2
2443,NAGALAND,2007,25,ECONOMIC ISSUES,0,0,0,0,0,0,0,0,0,0,0,0,0,0,0,0,0,0,0
2989,NAGALAND,2007,25,EXAM FAILURE,0,0,0,0,0,0,0,0,0,0,0,0,0,0,0,0,0,0,0
3535,NAGALAND,2007,25,FAMILY PROBLEMS,0,1,1,0,0,2,0,0,2,0,0,2,0,0,0,0,0,0,4
4081,NAGALAND,2007,25,HEALTH ISSUES,0,0,0,0,0,0,0,0,0,0,0,0,0,0,0,0,0,0,0
4626,NAGALAND,2007,25,HERO WORSHIP,0,0,0,0,0,0,0,0,0,0,0,0,0,0,0,0,0,0,0
5171,NAGALAND,2007,25,ILLEGITIMATE PREGNANCY,0,0,0,0,0,0,0,0,0,0,0,0,0,0,0,0,0,0,0
5716,NAGALAND,2007,25,LOVE AFFAIRS,0,0,0,0,0,0,0,0,0,0,0,0,0,0,0,0,0,0,0
6262,NAGALAND,2007,25,MARITAL ISSUES,0,0,0,0,0,0,0,0,0,0,0,0,0,0,0,0,0,0,0
6808,NAGALAND,2007,25,MENTAL HEALTH,0,0,0,0,0,0,0,0,1,0,0,1,0,0,0,0,0,0,1
7354,NAGALAND,2007,25,OTHERS,0,2,3,1,0,6,0,2,0,0,0,2,0,0,0,0,0,0,8
7938,NAGALAND,2007,25,"PHYSICAL ABUSE (RAPE,INCEST ETC.)",0,0,0,0,0,0,0,0,0,0,0,0,0,0,0,0,0,0,0
8445,NAGALAND,2007,25,SOCIETAL ISSUES,0,0,0,0,0,0,0,0,0,0,0,0,0,0,0,0,0,0,0
298,NAGALAND,2008,25,CAUSES NOT KNOWN,0,1,5,1,0,7,0,3,0,0,0,3,0,0,0,0,0,0,10
844,NAGALAND,2008,25,DEATH OF DEAR PERSON,0,0,0,0,0,0,0,0,0,0,0,0,0,0,0,0,0,0,0
1390,NAGALAND,2008,25,DOWRY DISPUTE,0,0,0,0,0,0,0,0,0,0,0,0,0,0,0,0,0,0,0
1936,NAGALAND,2008,25,DRUG ABUSE,0,0,2,0,0,2,0,0,0,0,0,0,0,0,0,0,0,0,2
2482,NAGALAND,2008,25,ECONOMIC ISSUES,0,0,0,0,0,0,0,0,0,0,0,0,0,0,0,0,0,0,0
3028,NAGALAND,2008,25,EXAM FAILURE,0,0,0,0,0,0,0,0,0,0,0,0,0,0,0,0,0,0,0
3574,NAGALAND,2008,25,FAMILY PROBLEMS,0,0,0,2,0,2,0,2,0,0,0,2,0,0,0,0,0,0,4
4120,NAGALAND,2008,25,HEALTH ISSUES,0,0,0,0,0,0,0,0,0,0,0,0,0,0,0,0,0,0,0
4665,NAGALAND,2008,25,HERO WORSHIP,0,0,0,0,0,0,0,0,0,0,0,0,0,0,0,0,0,0,0
5210,NAGALAND,2008,25,ILLEGITIMATE PREGNANCY,0,0,0,0,0,0,0,0,0,0,0,0,0,0,0,0,0,0,0
5755,NAGALAND,2008,25,LOVE AFFAIRS,0,0,0,0,0,0,0,0,0,0,0,0,0,0,0,0,0,0,0
6301,NAGALAND,2008,25,MARITAL ISSUES,0,0,0,0,0,0,0,0,0,0,0,0,0,0,0,0,0,0,0
6847,NAGALAND,2008,25,MENTAL HEALTH,0,0,0,0,0,0,0,0,0,0,0,0,0,0,0,0,0,0,0
7393,NAGALAND,2008,25,OTHERS,0,1,13,7,0,21,0,3,2,0,0,5,0,0,0,0,0,0,26
7977,NAGALAND,2008,25,"PHYSICAL ABUSE (RAPE,INCEST ETC.)",0,0,0,0,0,0,0,0,0,0,0,0,0,0,0,0,0,0,0
8484,NAGALAND,2008,25,SOCIETAL ISSUES,0,0,0,0,0,0,0,0,0,0,0,0,0,0,0,0,0,0,0
337,NAGALAND,2009,25,CAUSES NOT KNOWN,2,10,4,3,0,19,0,3,2,0,0,5,0,0,0,0,0,0,24
883,NAGALAND,2009,25,DEATH OF DEAR PERSON,0,0,0,0,0,0,0,0,0,0,0,0,0,0,0,0,0,0,0
1429,NAGALAND,2009,25,DOWRY DISPUTE,0,0,0,0,0,0,0,0,0,0,0,0,0,0,0,0,0,0,0
1975,NAGALAND,2009,25,DRUG ABUSE,0,0,1,0,0,1,0,0,0,0,0,0,0,0,0,0,0,0,1
2521,NAGALAND,2009,25,ECONOMIC ISSUES,0,0,1,0,0,1,0,0,0,0,0,0,0,0,0,0,0,0,1
3067,NAGALAND,2009,25,EXAM FAILURE,0,0,0,0,0,0,0,0,0,0,0,0,0,0,0,0,0,0,0
3613,NAGALAND,2009,25,FAMILY PROBLEMS,0,1,0,1,0,2,0,0,0,0,0,0,0,0,0,0,0,0,2
4159,NAGALAND,2009,25,HEALTH ISSUES,0,0,0,0,0,0,0,0,0,0,0,0,0,0,0,0,0,0,0
4704,NAGALAND,2009,25,HERO WORSHIP,0,0,0,0,0,0,0,0,0,0,0,0,0,0,0,0,0,0,0
5249,NAGALAND,2009,25,ILLEGITIMATE PREGNANCY,0,0,0,0,0,0,0,0,0,0,0,0,0,0,0,0,0,0,0
5794,NAGALAND,2009,25,LOVE AFFAIRS,0,0,0,0,0,0,0,0,0,0,0,0,0,0,0,0,0,0,0
6340,NAGALAND,2009,25,MARITAL ISSUES,0,1,0,0,0,1,0,0,0,0,0,0,0,0,0,0,0,0,1
6886,NAGALAND,2009,25,MENTAL HEALTH,0,0,1,0,0,1,0,0,0,0,0,0,0,0,0,0,0,0,1
7432,NAGALAND,2009,25,OTHERS,0,0,0,0,0,0,0,1,0,0,0,1,0,0,0,0,0,0,1
8016,NAGALAND,2009,25,"PHYSICAL ABUSE (RAPE,INCEST ETC.)",0,0,0,0,0,0,0,0,0,0,0,0,0,0,0,0,0,0,0
8523,NAGALAND,2009,25,SOCIETAL ISSUES,0,0,0,0,0,0,0,0,0,0,0,0,0,0,0,0,0,0,0
376,NAGALAND,2010,25,CAUSES NOT KNOWN,0,4,4,0,0,8,0,0,0,0,0,0,0,0,0,0,0,0,8
922,NAGALAND,2010,25,DEATH OF DEAR PERSON,0,0,0,0,0,0,0,0,0,0,0,0,0,0,0,0,0,0,0
1468,NAGALAND,2010,25,DOWRY DISPUTE,0,0,0,0,0,0,0,0,0,0,0,0,0,0,0,0,0,0,0
2014,NAGALAND,2010,25,DRUG ABUSE,0,0,0,0,0,0,0,0,0,0,0,0,0,0,0,0,0,0,0
2560,NAGALAND,2010,25,ECONOMIC ISSUES,0,0,0,0,0,0,0,0,0,0,0,0,0,0,0,0,0,0,0
3106,NAGALAND,2010,25,EXAM FAILURE,0,0,0,0,0,0,0,0,0,0,0,0,0,0,0,0,0,0,0
3652,NAGALAND,2010,25,FAMILY PROBLEMS,0,0,2,0,0,2,0,0,0,0,0,0,0,0,0,0,0,0,2
4198,NAGALAND,2010,25,HEALTH ISSUES,0,0,0,0,0,0,0,0,0,0,0,0,0,0,0,0,0,0,0
4743,NAGALAND,2010,25,HERO WORSHIP,0,0,0,0,0,0,0,0,0,0,0,0,0,0,0,0,0,0,0
5288,NAGALAND,2010,25,ILLEGITIMATE PREGNANCY,0,0,0,0,0,0,0,0,0,0,0,0,0,0,0,0,0,0,0
5833,NAGALAND,2010,25,LOVE AFFAIRS,0,0,0,0,0,0,0,0,0,0,0,0,0,0,0,0,0,0,0
6379,NAGALAND,2010,25,MARITAL ISSUES,0,0,0,0,0,0,0,0,0,0,0,0,0,0,0,0,0,0,0
6925,NAGALAND,2010,25,MENTAL HEALTH,0,0,0,0,0,0,0,0,0,0,0,0,0,0,0,0,0,0,0
7471,NAGALAND,2010,25,OTHERS,0,0,0,1,0,1,0,1,0,0,0,1,0,0,0,0,0,0,2
8055,NAGALAND,2010,25,"PHYSICAL ABUSE (RAPE,INCEST ETC.)",0,0,0,0,0,0,0,0,0,0,0,0,0,0,0,0,0,0,0
8562,NAGALAND,2010,25,SOCIETAL ISSUES,0,0,0,0,0,0,0,0,0,0,0,0,0,0,0,0,0,0,0
415,NAGALAND,2011,25,CAUSES NOT KNOWN,0,5,8,3,0,16,0,6,2,0,0,8,0,0,0,0,0,0,24
961,NAGALAND,2011,25,DEATH OF DEAR PERSON,0,0,0,0,0,0,0,0,0,0,0,0,0,0,0,0,0,0,0
1507,NAGALAND,2011,25,DOWRY DISPUTE,0,0,0,0,0,0,0,0,0,0,0,0,0,0,0,0,0,0,0
2053,NAGALAND,2011,25,DRUG ABUSE,0,0,0,0,0,0,0,0,0,0,0,0,0,0,0,0,0,0,0
2599,NAGALAND,2011,25,ECONOMIC ISSUES,0,0,0,0,0,0,0,0,0,0,0,0,0,0,0,0,0,0,0
3145,NAGALAND,2011,25,EXAM FAILURE,0,0,0,0,0,0,0,0,0,0,0,0,0,0,0,0,0,0,0
3691,NAGALAND,2011,25,FAMILY PROBLEMS,0,0,0,0,0,0,0,0,0,0,0,0,0,0,0,0,0,0,0
4237,NAGALAND,2011,25,HEALTH ISSUES,0,0,0,0,0,0,0,0,0,0,0,0,0,0,0,0,0,0,0
4782,NAGALAND,2011,25,HERO WORSHIP,0,0,0,0,0,0,0,0,0,0,0,0,0,0,0,0,0,0,0
5327,NAGALAND,2011,25,ILLEGITIMATE PREGNANCY,0,0,0,0,0,0,0,0,0,0,0,0,0,0,0,0,0,0,0
5872,NAGALAND,2011,25,LOVE AFFAIRS,0,0,0,0,0,0,0,0,0,0,0,0,0,0,0,0,0,0,0
6418,NAGALAND,2011,25,MARITAL ISSUES,0,0,0,0,0,0,0,0,0,0,0,0,0,0,0,0,0,0,0
6964,NAGALAND,2011,25,MENTAL HEALTH,0,0,0,0,0,0,0,0,0,0,0,0,0,0,0,0,0,0,0
7510,NAGALAND,2011,25,OTHERS,0,1,3,5,0,9,0,0,0,0,0,0,0,0,0,0,0,0,9
8094,NAGALAND,2011,25,"PHYSICAL ABUSE (RAPE,INCEST ETC.)",0,0,0,0,0,0,0,0,0,0,0,0,0,0,0,0,0,0,0
8601,NAGALAND,2011,25,SOCIETAL ISSUES,0,0,0,0,0,0,0,0,0,0,0,0,0,0,0,0,0,0,0
454,NAGALAND,2012,25,CAUSES NOT KNOWN,0,10,6,3,0,19,0,2,1,0,0,3,0,0,0,0,0,0,22
1000,NAGALAND,2012,25,DEATH OF DEAR PERSON,0,0,0,0,0,0,0,0,0,0,0,0,0,0,0,0,0,0,0
1546,NAGALAND,2012,25,DOWRY DISPUTE,0,0,0,0,0,0,0,0,0,0,0,0,0,0,0,0,0,0,0
2092,NAGALAND,2012,25,DRUG ABUSE,0,0,0,0,0,0,0,0,0,0,0,0,0,0,0,0,0,0,0
2638,NAGALAND,2012,25,ECONOMIC ISSUES,0,0,0,0,0,0,0,0,0,0,0,0,0,0,0,0,0,0,0
3184,NAGALAND,2012,25,EXAM FAILURE,0,0,0,0,0,0,0,0,0,0,0,0,0,0,0,0,0,0,0
3730,NAGALAND,2012,25,FAMILY PROBLEMS,0,0,0,0,0,0,0,0,0,0,0,0,0,0,0,0,0,0,0
4276,NAGALAND,2012,25,HEALTH ISSUES,0,0,0,0,0,0,0,0,0,0,0,0,0,0,0,0,0,0,0
4821,NAGALAND,2012,25,HERO WORSHIP,0,0,0,0,0,0,0,0,0,0,0,0,0,0,0,0,0,0,0
5366,NAGALAND,2012,25,ILLEGITIMATE PREGNANCY,0,0,0,0,0,0,0,0,0,0,0,0,0,0,0,0,0,0,0
5911,NAGALAND,2012,25,LOVE AFFAIRS,0,0,0,0,0,0,0,0,0,0,0,0,0,0,0,0,0,0,0
6457,NAGALAND,2012,25,MARITAL ISSUES,0,0,0,1,0,1,0,0,0,0,0,0,0,0,0,0,0,0,1
7003,NAGALAND,2012,25,MENTAL HEALTH,0,0,0,0,0,0,0,0,0,0,0,0,0,0,0,0,0,0,0
7549,NAGALAND,2012,25,OTHERS,0,1,2,1,0,4,1,2,0,0,0,3,0,0,0,0,0,0,7
8133,NAGALAND,2012,25,"PHYSICAL ABUSE (RAPE,INCEST ETC.)",0,0,0,0,0,0,0,0,0,0,0,0,0,0,0,0,0,0,0
8640,NAGALAND,2012,25,SOCIETAL ISSUES,0,0,0,0,0,0,0,0,0,0,0,0,0,0,0,0,0,0,0
493,NAGALAND,2013,25,CAUSES NOT KNOWN,1,7,15,1,1,25,0,7,2,1,2,12,0,0,0,0,0,0,37
1039,NAGALAND,2013,25,DEATH OF DEAR PERSON,0,0,0,0,0,0,0,0,0,0,0,0,0,0,0,0,0,0,0
1585,NAGALAND,2013,25,DOWRY DISPUTE,0,0,0,0,0,0,0,0,0,0,0,0,0,0,0,0,0,0,0
2131,NAGALAND,2013,25,DRUG ABUSE,0,0,0,0,0,0,0,0,0,0,0,0,0,0,0,0,0,0,0
2677,NAGALAND,2013,25,ECONOMIC ISSUES,0,0,0,0,0,0,0,0,0,0,0,0,0,0,0,0,0,0,0
3223,NAGALAND,2013,25,EXAM FAILURE,0,0,0,0,0,0,0,0,0,0,0,0,0,0,0,0,0,0,0
3769,NAGALAND,2013,25,FAMILY PROBLEMS,0,0,0,0,0,0,0,0,0,0,0,0,0,0,0,0,0,0,0
4315,NAGALAND,2013,25,HEALTH ISSUES,0,0,0,0,0,0,0,0,0,0,0,0,0,0,0,0,0,0,0
4860,NAGALAND,2013,25,HERO WORSHIP,0,0,0,0,0,0,0,0,0,0,0,0,0,0,0,0,0,0,0
5405,NAGALAND,2013,25,ILLEGITIMATE PREGNANCY,0,0,0,0,0,0,0,0,0,0,0,0,0,0,0,0,0,0,0
5950,NAGALAND,2013,25,LOVE AFFAIRS,0,0,0,0,0,0,0,0,0,0,0,0,0,0,0,0,0,0,0
6496,NAGALAND,2013,25,MARITAL ISSUES,0,0,0,0,0,0,0,0,0,0,0,0,0,0,0,0,0,0,0
7042,NAGALAND,2013,25,MENTAL HEALTH,0,0,0,0,0,0,0,0,0,0,0,0,0,0,0,0,0,0,0
7588,NAGALAND,2013,25,OTHERS,0,0,0,0,0,0,0,0,0,0,0,0,0,0,0,0,0,0,0
8172,NAGALAND,2013,25,"PHYSICAL ABUSE (RAPE,INCEST ETC.)",0,0,0,0,0,0,0,0,0,0,0,0,0,0,0,0,0,0,0
8679,NAGALAND,2013,25,SOCIETAL ISSUES,0,0,0,0,0,0,0,0,0,0,0,0,0,0,0,0,0,0,0
532,NAGALAND,2014,25,CAUSES NOT KNOWN,0,2,2,0,0,4,0,2,1,0,0,3,0,0,0,0,0,0,7
1078,NAGALAND,2014,25,DEATH OF DEAR PERSON,0,0,0,0,0,0,0,0,0,0,0,0,0,0,0,0,0,0,0
1624,NAGALAND,2014,25,DOWRY DISPUTE,0,0,0,0,0,0,0,0,0,0,0,0,0,0,0,0,0,0,0
2170,NAGALAND,2014,25,DRUG ABUSE,0,0,0,0,0,0,0,0,0,0,0,0,0,0,0,0,0,0,0
2716,NAGALAND,2014,25,ECONOMIC ISSUES,0,0,0,0,0,0,0,0,0,0,0,0,0,0,0,0,0,0,0
3262,NAGALAND,2014,25,EXAM FAILURE,0,0,0,0,0,0,0,0,0,0,0,0,0,0,0,0,0,0,0
3808,NAGALAND,2014,25,FAMILY PROBLEMS,0,0,0,0,0,0,0,0,0,0,0,0,0,0,0,0,0,0,0
4354,NAGALAND,2014,25,HEALTH ISSUES,0,0,0,0,0,0,0,0,0,0,0,0,0,0,0,0,0,0,0
4899,NAGALAND,2014,25,HERO WORSHIP,0,0,0,0,0,0,0,0,0,0,0,0,0,0,0,0,0,0,0
5444,NAGALAND,2014,25,ILLEGITIMATE PREGNANCY,0,0,0,0,0,0,0,0,0,0,0,0,0,0,0,0,0,0,0
5989,NAGALAND,2014,25,LOVE AFFAIRS,0,0,0,0,0,0,0,0,0,0,0,0,0,0,0,0,0,0,0
6535,NAGALAND,2014,25,MARITAL ISSUES,0,0,0,0,0,0,0,0,0,0,0,0,0,0,0,0,0,0,0
7081,NAGALAND,2014,25,MENTAL HEALTH,0,0,0,0,0,0,0,0,0,0,0,0,0,0,0,0,0,0,0
7627,NAGALAND,2014,25,OTHERS,0,2,1,1,1,5,0,1,0,0,0,1,0,0,0,0,0,0,6
7666,NAGALAND,2014,25,PHYSICAL ABUSE,0,0,0,0,0,0,0,0,0,0,0,0,0,0,0,0,0,0,0
8718,NAGALAND,2014,25,SOCIETAL ISSUES,0,0,0,0,0,0,0,0,0,0,0,0,0,0,0,0,0,0,0
26,ODISHA,2001,26,CAUSES NOT KNOWN,18,200,250,182,54,704,27,185,169,64,24,469,0,0,0,0,0,0,1173
572,ODISHA,2001,26,DEATH OF DEAR PERSON,0,0,0,3,5,8,0,2,2,0,2,6,0,0,0,0,0,0,14
1118,ODISHA,2001,26,DOWRY DISPUTE,0,0,0,0,0,0,0,85,43,3,0,131,0,0,0,0,0,0,131
1664,ODISHA,2001,26,DRUG ABUSE,0,17,2,1,0,20,0,0,0,0,0,0,0,0,0,0,0,0,20
2210,ODISHA,2001,26,ECONOMIC ISSUES,1,69,71,43,5,189,3,35,20,20,10,88,0,0,0,0,0,0,277
2756,ODISHA,2001,26,EXAM FAILURE,2,25,1,0,0,28,6,15,5,2,0,28,0,0,0,0,0,0,56
3302,ODISHA,2001,26,FAMILY PROBLEMS,8,138,171,96,12,425,3,211,208,79,22,523,0,0,0,0,0,0,948
3848,ODISHA,2001,26,HEALTH ISSUES,0,14,24,57,28,123,1,21,33,28,6,89,0,0,0,0,0,0,212
4394,ODISHA,2001,26,HERO WORSHIP,0,0,0,0,0,0,0,0,0,0,0,0,0,0,0,0,0,0,0
4939,ODISHA,2001,26,ILLEGITIMATE PREGNANCY,0,0,0,0,0,0,2,29,11,0,0,42,0,0,0,0,0,0,42
5484,ODISHA,2001,26,LOVE AFFAIRS,0,65,24,6,0,95,1,109,23,0,0,133,0,0,0,0,0,0,228
6029,ODISHA,2001,26,MARITAL ISSUES,0,21,9,1,0,31,0,73,58,4,0,135,0,0,0,0,0,0,166
6575,ODISHA,2001,26,MENTAL HEALTH,0,9,25,18,6,58,0,5,15,8,2,30,0,0,0,0,0,0,88
7121,ODISHA,2001,26,OTHERS,7,149,130,82,34,402,19,109,85,51,15,279,0,0,0,0,0,0,681
7706,ODISHA,2001,26,"PHYSICAL ABUSE (RAPE,INCEST ETC.)",0,0,0,0,0,0,0,2,2,0,0,4,0,0,0,0,0,0,4
8212,ODISHA,2001,26,SOCIETAL ISSUES,0,1,2,3,0,6,0,0,5,1,0,6,0,0,0,0,0,0,12
65,ODISHA,2002,26,CAUSES NOT KNOWN,30,285,251,194,63,823,29,124,108,59,8,328,0,0,0,0,0,0,1151
611,ODISHA,2002,26,DEATH OF DEAR PERSON,0,2,3,0,0,5,0,0,1,2,2,5,0,0,0,0,0,0,10
1157,ODISHA,2002,26,DOWRY DISPUTE,0,0,0,0,0,0,1,64,35,0,0,100,0,0,0,0,0,0,100
1703,ODISHA,2002,26,DRUG ABUSE,0,9,2,0,0,11,0,0,0,0,0,0,0,0,0,0,0,0,11
2249,ODISHA,2002,26,ECONOMIC ISSUES,3,133,147,115,12,410,0,36,36,14,2,88,0,0,0,0,0,0,498
2795,ODISHA,2002,26,EXAM FAILURE,6,24,6,1,0,37,3,15,4,0,0,22,0,0,0,0,0,0,59
3341,ODISHA,2002,26,FAMILY PROBLEMS,5,148,153,79,29,414,12,192,135,75,10,424,0,0,0,0,0,0,838
3887,ODISHA,2002,26,HEALTH ISSUES,0,10,24,70,22,126,2,23,19,50,8,102,0,0,0,0,0,0,228
4433,ODISHA,2002,26,HERO WORSHIP,0,0,0,0,0,0,0,3,6,5,2,16,0,0,0,0,0,0,16
4978,ODISHA,2002,26,ILLEGITIMATE PREGNANCY,0,0,0,0,0,0,0,12,9,0,0,21,0,0,0,0,0,0,21
5523,ODISHA,2002,26,LOVE AFFAIRS,0,57,30,0,0,87,1,47,51,1,0,100,0,0,0,0,0,0,187
6068,ODISHA,2002,26,MARITAL ISSUES,0,28,12,2,1,43,0,123,50,4,7,184,0,0,0,0,0,0,227
6614,ODISHA,2002,26,MENTAL HEALTH,0,17,32,9,4,62,0,15,8,3,4,30,0,0,0,0,0,0,92
7160,ODISHA,2002,26,OTHERS,11,139,249,131,34,564,21,128,103,52,30,334,0,0,0,0,0,0,898
7745,ODISHA,2002,26,"PHYSICAL ABUSE (RAPE,INCEST ETC.)",0,0,0,0,0,0,0,1,1,0,0,2,0,0,0,0,0,0,2
8251,ODISHA,2002,26,SOCIETAL ISSUES,0,0,36,13,0,49,0,0,0,1,0,1,0,0,0,0,0,0,50
104,ODISHA,2003,26,CAUSES NOT KNOWN,10,198,200,166,37,611,5,101,63,66,8,243,0,0,0,0,0,0,854
650,ODISHA,2003,26,DEATH OF DEAR PERSON,0,1,1,1,0,3,0,33,25,0,0,58,0,0,0,0,0,0,61
1196,ODISHA,2003,26,DOWRY DISPUTE,0,0,0,0,0,0,0,49,20,3,0,72,0,0,0,0,0,0,72
1742,ODISHA,2003,26,DRUG ABUSE,0,0,0,0,0,0,0,0,0,0,0,0,0,0,0,0,0,0,0
2288,ODISHA,2003,26,ECONOMIC ISSUES,1,75,70,38,4,188,0,15,17,3,0,35,0,0,0,0,0,0,223
2834,ODISHA,2003,26,EXAM FAILURE,2,37,2,0,0,41,7,14,0,1,0,22,0,0,0,0,0,0,63
3380,ODISHA,2003,26,FAMILY PROBLEMS,2,196,226,131,28,583,0,174,122,90,29,415,0,0,0,0,0,0,998
3926,ODISHA,2003,26,HEALTH ISSUES,0,9,24,35,15,83,0,24,14,10,5,53,0,0,0,0,0,0,136
4472,ODISHA,2003,26,HERO WORSHIP,0,11,7,1,1,20,0,8,1,0,0,9,0,0,0,0,0,0,29
5017,ODISHA,2003,26,ILLEGITIMATE PREGNANCY,0,0,0,0,0,0,0,15,8,0,0,23,0,0,0,0,0,0,23
5562,ODISHA,2003,26,LOVE AFFAIRS,2,90,39,0,0,131,5,79,64,0,0,148,0,0,0,0,0,0,279
6107,ODISHA,2003,26,MARITAL ISSUES,0,18,19,4,2,43,1,71,36,7,0,115,0,0,0,0,0,0,158
6653,ODISHA,2003,26,MENTAL HEALTH,1,17,11,8,5,42,1,6,8,1,1,17,0,0,0,0,0,0,59
7199,ODISHA,2003,26,OTHERS,49,265,299,275,84,972,27,208,100,99,25,459,0,0,0,0,0,0,1431
7784,ODISHA,2003,26,"PHYSICAL ABUSE (RAPE,INCEST ETC.)",0,0,0,0,0,0,0,0,0,0,0,0,0,0,0,0,0,0,0
8290,ODISHA,2003,26,SOCIETAL ISSUES,0,9,11,2,1,23,0,5,5,1,0,11,0,0,0,0,0,0,34
143,ODISHA,2004,26,CAUSES NOT KNOWN,28,190,195,121,34,568,20,126,94,33,17,290,0,0,0,0,0,0,858
689,ODISHA,2004,26,DEATH OF DEAR PERSON,2,1,0,2,1,6,0,2,4,3,0,9,0,0,0,0,0,0,15
1235,ODISHA,2004,26,DOWRY DISPUTE,0,5,0,0,0,5,0,87,39,1,0,127,0,0,0,0,0,0,132
1781,ODISHA,2004,26,DRUG ABUSE,0,1,1,2,0,4,0,0,0,0,0,0,0,0,0,0,0,0,4
2327,ODISHA,2004,26,ECONOMIC ISSUES,0,65,105,24,12,206,1,16,21,3,1,42,0,0,0,0,0,0,248
2873,ODISHA,2004,26,EXAM FAILURE,11,29,0,0,0,40,10,18,0,0,0,28,0,0,0,0,0,0,68
3419,ODISHA,2004,26,FAMILY PROBLEMS,4,140,265,186,44,639,9,172,144,83,36,444,0,0,0,0,0,0,1083
3965,ODISHA,2004,26,HEALTH ISSUES,1,10,33,35,18,97,0,11,35,17,10,73,0,0,0,0,0,0,170
4511,ODISHA,2004,26,HERO WORSHIP,0,0,0,0,0,0,0,0,0,0,0,0,0,0,0,0,0,0,0
5056,ODISHA,2004,26,ILLEGITIMATE PREGNANCY,0,0,0,0,0,0,1,14,8,0,0,23,0,0,0,0,0,0,23
5601,ODISHA,2004,26,LOVE AFFAIRS,1,54,11,1,0,67,7,60,5,0,0,72,0,0,0,0,0,0,139
6146,ODISHA,2004,26,MARITAL ISSUES,1,39,27,5,0,72,3,85,36,4,0,128,0,0,0,0,0,0,200
6692,ODISHA,2004,26,MENTAL HEALTH,1,15,18,16,5,55,1,13,5,3,1,23,0,0,0,0,0,0,78
7238,ODISHA,2004,26,OTHERS,35,191,248,220,78,772,27,178,104,80,19,408,0,0,0,0,0,0,1180
7823,ODISHA,2004,26,"PHYSICAL ABUSE (RAPE,INCEST ETC.)",0,0,0,0,0,0,0,3,1,0,0,4,0,0,0,0,0,0,4
8329,ODISHA,2004,26,SOCIETAL ISSUES,0,7,1,4,1,13,0,0,0,0,0,0,0,0,0,0,0,0,13
182,ODISHA,2005,26,CAUSES NOT KNOWN,25,173,198,125,37,558,14,127,115,50,8,314,0,0,0,0,0,0,872
728,ODISHA,2005,26,DEATH OF DEAR PERSON,0,0,1,1,0,2,0,0,1,2,0,3,0,0,0,0,0,0,5
1274,ODISHA,2005,26,DOWRY DISPUTE,0,0,0,0,0,0,0,47,22,3,0,72,0,0,0,0,0,0,72
1820,ODISHA,2005,26,DRUG ABUSE,0,0,2,0,0,2,0,0,0,0,0,0,0,0,0,0,0,0,2
2366,ODISHA,2005,26,ECONOMIC ISSUES,0,61,75,34,6,176,0,14,10,2,1,27,0,0,0,0,0,0,203
2912,ODISHA,2005,26,EXAM FAILURE,4,27,0,0,0,31,4,10,0,0,0,14,0,0,0,0,0,0,45
3458,ODISHA,2005,26,FAMILY PROBLEMS,1,182,283,208,81,755,5,160,185,109,26,485,0,0,0,0,0,0,1240
4004,ODISHA,2005,26,HEALTH ISSUES,1,8,30,38,31,108,0,11,29,23,13,76,0,0,0,0,0,0,184
4550,ODISHA,2005,26,HERO WORSHIP,0,1,0,0,0,1,0,0,0,0,0,0,0,0,0,0,0,0,1
5095,ODISHA,2005,26,ILLEGITIMATE PREGNANCY,0,0,0,0,0,0,1,23,8,0,0,32,0,0,0,0,0,0,32
5640,ODISHA,2005,26,LOVE AFFAIRS,2,48,11,0,0,61,5,74,9,1,0,89,0,0,0,0,0,0,150
6185,ODISHA,2005,26,MARITAL ISSUES,0,17,19,15,0,51,5,75,35,6,0,121,0,0,0,0,0,0,172
6731,ODISHA,2005,26,MENTAL HEALTH,0,21,29,15,11,76,1,14,13,14,5,47,0,0,0,0,0,0,123
7277,ODISHA,2005,26,OTHERS,25,188,267,182,67,729,25,131,143,53,20,372,0,0,0,0,0,0,1101
7862,ODISHA,2005,26,"PHYSICAL ABUSE (RAPE,INCEST ETC.)",0,0,0,0,0,0,0,0,0,0,0,0,0,0,0,0,0,0,0
8368,ODISHA,2005,26,SOCIETAL ISSUES,0,0,4,0,0,4,0,0,2,0,0,2,0,0,0,0,0,0,6
221,ODISHA,2006,26,CAUSES NOT KNOWN,10,253,239,147,76,725,21,237,174,79,20,531,0,0,0,0,0,0,1256
767,ODISHA,2006,26,DEATH OF DEAR PERSON,0,2,0,0,0,2,0,0,0,0,0,0,0,0,0,0,0,0,2
1313,ODISHA,2006,26,DOWRY DISPUTE,0,0,0,0,0,0,0,31,8,0,0,39,0,0,0,0,0,0,39
1859,ODISHA,2006,26,DRUG ABUSE,0,0,0,0,0,0,0,0,0,0,0,0,0,0,0,0,0,0,0
2405,ODISHA,2006,26,ECONOMIC ISSUES,0,40,75,28,7,150,0,8,21,6,1,36,0,0,0,0,0,0,186
2951,ODISHA,2006,26,EXAM FAILURE,5,13,4,0,0,22,4,6,0,0,0,10,0,0,0,0,0,0,32
3497,ODISHA,2006,26,FAMILY PROBLEMS,5,153,220,126,47,551,7,168,130,68,21,394,0,0,0,0,0,0,945
4043,ODISHA,2006,26,HEALTH ISSUES,0,11,36,41,18,106,0,11,23,23,2,59,0,0,0,0,0,0,165
4588,ODISHA,2006,26,HERO WORSHIP,0,0,0,0,0,0,0,0,0,0,0,0,0,0,0,0,0,0,0
5133,ODISHA,2006,26,ILLEGITIMATE PREGNANCY,0,0,0,0,0,0,1,16,4,0,0,21,0,0,0,0,0,0,21
5678,ODISHA,2006,26,LOVE AFFAIRS,1,40,15,5,0,61,4,58,8,2,0,72,0,0,0,0,0,0,133
6224,ODISHA,2006,26,MARITAL ISSUES,0,40,18,2,2,62,3,69,29,3,0,104,0,0,0,0,0,0,166
6770,ODISHA,2006,26,MENTAL HEALTH,2,21,23,21,10,77,0,7,13,3,5,28,0,0,0,0,0,0,105
7316,ODISHA,2006,26,OTHERS,20,159,219,107,64,569,19,125,142,53,22,361,0,0,0,0,0,0,930
7900,ODISHA,2006,26,"PHYSICAL ABUSE (RAPE,INCEST ETC.)",0,0,0,0,0,0,0,0,0,0,0,0,0,0,0,0,0,0,0
8407,ODISHA,2006,26,SOCIETAL ISSUES,0,9,21,16,2,48,0,11,13,10,3,37,0,0,0,0,0,0,85
260,ODISHA,2007,26,CAUSES NOT KNOWN,24,213,264,148,63,712,29,208,144,71,25,477,0,0,0,0,0,0,1189
806,ODISHA,2007,26,DEATH OF DEAR PERSON,0,0,2,0,0,2,0,13,8,0,0,21,0,0,0,0,0,0,23
1352,ODISHA,2007,26,DOWRY DISPUTE,0,0,0,0,0,0,0,57,14,0,0,71,0,0,0,0,0,0,71
1898,ODISHA,2007,26,DRUG ABUSE,0,0,0,0,0,0,0,0,0,0,0,0,0,0,0,0,0,0,0
2444,ODISHA,2007,26,ECONOMIC ISSUES,0,43,21,17,8,89,0,14,1,0,1,16,0,0,0,0,0,0,105
2990,ODISHA,2007,26,EXAM FAILURE,1,21,0,0,0,22,3,13,0,0,0,16,0,0,0,0,0,0,38
3536,ODISHA,2007,26,FAMILY PROBLEMS,7,202,267,172,68,716,3,199,172,71,20,465,0,0,0,0,0,0,1181
4082,ODISHA,2007,26,HEALTH ISSUES,1,28,50,56,38,173,1,30,28,18,11,88,0,0,0,0,0,0,261
4627,ODISHA,2007,26,HERO WORSHIP,0,0,0,0,0,0,0,0,0,0,0,0,0,0,0,0,0,0,0
5172,ODISHA,2007,26,ILLEGITIMATE PREGNANCY,0,0,0,0,0,0,0,13,2,0,0,15,0,0,0,0,0,0,15
5717,ODISHA,2007,26,LOVE AFFAIRS,0,48,23,15,6,92,4,75,14,0,0,93,0,0,0,0,0,0,185
6263,ODISHA,2007,26,MARITAL ISSUES,0,26,8,3,0,37,0,73,39,3,0,115,0,0,0,0,0,0,152
6809,ODISHA,2007,26,MENTAL HEALTH,3,14,11,7,4,39,1,7,5,3,1,17,0,0,0,0,0,0,56
7355,ODISHA,2007,26,OTHERS,41,171,191,118,59,580,29,172,127,76,15,419,0,0,0,0,0,0,999
7939,ODISHA,2007,26,"PHYSICAL ABUSE (RAPE,INCEST ETC.)",0,0,0,0,0,0,0,0,0,0,0,0,0,0,0,0,0,0,0
8446,ODISHA,2007,26,SOCIETAL ISSUES,0,10,11,5,0,26,0,4,2,1,0,7,0,0,0,0,0,0,33
299,ODISHA,2008,26,CAUSES NOT KNOWN,46,393,284,264,90,1077,28,183,176,80,29,496,0,0,0,0,0,0,1573
845,ODISHA,2008,26,DEATH OF DEAR PERSON,0,3,1,0,2,6,0,2,3,1,0,6,0,0,0,0,0,0,12
1391,ODISHA,2008,26,DOWRY DISPUTE,0,0,0,0,0,0,0,111,45,3,0,159,0,0,0,0,0,0,159
1937,ODISHA,2008,26,DRUG ABUSE,0,0,0,3,0,3,0,0,0,0,0,0,0,0,0,0,0,0,3
2483,ODISHA,2008,26,ECONOMIC ISSUES,0,77,105,66,6,254,0,9,4,2,1,16,0,0,0,0,0,0,270
3029,ODISHA,2008,26,EXAM FAILURE,2,29,0,0,0,31,3,19,1,0,0,23,0,0,0,0,0,0,54
3575,ODISHA,2008,26,FAMILY PROBLEMS,9,182,266,173,74,704,9,171,180,98,42,500,0,0,0,0,0,0,1204
4121,ODISHA,2008,26,HEALTH ISSUES,2,7,31,38,13,91,0,4,20,15,15,54,0,0,0,0,0,0,145
4666,ODISHA,2008,26,HERO WORSHIP,0,0,0,0,0,0,0,0,0,0,0,0,0,0,0,0,0,0,0
5211,ODISHA,2008,26,ILLEGITIMATE PREGNANCY,0,0,0,0,0,0,2,18,1,0,0,21,0,0,0,0,0,0,21
5756,ODISHA,2008,26,LOVE AFFAIRS,1,68,27,7,4,107,4,78,20,2,1,105,0,0,0,0,0,0,212
6302,ODISHA,2008,26,MARITAL ISSUES,2,50,29,17,5,103,2,48,57,6,3,116,0,0,0,0,0,0,219
6848,ODISHA,2008,26,MENTAL HEALTH,0,12,23,12,5,52,0,10,6,4,7,27,0,0,0,0,0,0,79
7394,ODISHA,2008,26,OTHERS,52,222,237,131,64,706,7,59,79,48,21,214,0,0,0,0,0,0,920
7978,ODISHA,2008,26,"PHYSICAL ABUSE (RAPE,INCEST ETC.)",0,0,0,0,0,0,0,1,0,0,0,1,0,0,0,0,0,0,1
8485,ODISHA,2008,26,SOCIETAL ISSUES,0,1,18,2,0,21,0,7,4,0,0,11,0,0,0,0,0,0,32
338,ODISHA,2009,26,CAUSES NOT KNOWN,27,206,230,138,84,685,17,165,154,73,43,452,0,0,0,0,0,0,1137
884,ODISHA,2009,26,DEATH OF DEAR PERSON,0,0,3,0,0,3,0,1,4,2,0,7,0,0,0,0,0,0,10
1430,ODISHA,2009,26,DOWRY DISPUTE,0,0,0,0,0,0,0,74,27,1,0,102,0,0,0,0,0,0,102
1976,ODISHA,2009,26,DRUG ABUSE,0,2,2,0,0,4,0,0,0,0,0,0,0,0,0,0,0,0,4
2522,ODISHA,2009,26,ECONOMIC ISSUES,0,100,55,18,0,173,0,22,8,1,3,34,0,0,0,0,0,0,207
3068,ODISHA,2009,26,EXAM FAILURE,10,52,4,0,0,66,5,32,0,0,0,37,0,0,0,0,0,0,103
3614,ODISHA,2009,26,FAMILY PROBLEMS,6,129,234,127,28,524,7,166,161,63,7,404,0,0,0,0,0,0,928
4160,ODISHA,2009,26,HEALTH ISSUES,0,16,16,23,31,86,0,13,14,22,4,53,0,0,0,0,0,0,139
4705,ODISHA,2009,26,HERO WORSHIP,0,0,0,0,0,0,0,0,0,0,0,0,0,0,0,0,0,0,0
5250,ODISHA,2009,26,ILLEGITIMATE PREGNANCY,0,0,0,0,0,0,0,3,0,0,0,3,0,0,0,0,0,0,3
5795,ODISHA,2009,26,LOVE AFFAIRS,11,64,29,2,0,106,12,74,18,1,0,105,0,0,0,0,0,0,211
6341,ODISHA,2009,26,MARITAL ISSUES,0,26,24,2,0,52,2,66,38,6,1,113,0,0,0,0,0,0,165
6887,ODISHA,2009,26,MENTAL HEALTH,0,13,21,25,11,70,0,7,14,8,5,34,0,0,0,0,0,0,104
7433,ODISHA,2009,26,OTHERS,15,236,289,181,48,769,24,151,153,88,22,438,0,0,0,0,0,0,1207
8017,ODISHA,2009,26,"PHYSICAL ABUSE (RAPE,INCEST ETC.)",0,0,0,0,0,0,0,1,0,0,1,2,0,0,0,0,0,0,2
8524,ODISHA,2009,26,SOCIETAL ISSUES,0,2,7,12,8,29,0,8,6,0,0,14,0,0,0,0,0,0,43
377,ODISHA,2010,26,CAUSES NOT KNOWN,41,218,234,129,53,675,26,179,116,69,28,418,0,0,0,0,0,0,1093
923,ODISHA,2010,26,DEATH OF DEAR PERSON,0,5,2,0,0,7,0,3,3,0,0,6,0,0,0,0,0,0,13
1469,ODISHA,2010,26,DOWRY DISPUTE,0,2,0,0,0,2,1,59,23,1,1,85,0,0,0,0,0,0,87
2015,ODISHA,2010,26,DRUG ABUSE,0,0,6,0,0,6,0,0,0,0,0,0,0,0,0,0,0,0,6
2561,ODISHA,2010,26,ECONOMIC ISSUES,0,50,63,35,2,150,0,18,17,13,1,49,0,0,0,0,0,0,199
3107,ODISHA,2010,26,EXAM FAILURE,6,59,6,0,0,71,4,36,0,0,0,40,0,0,0,0,0,0,111
3653,ODISHA,2010,26,FAMILY PROBLEMS,5,127,195,104,34,465,9,190,134,67,16,416,0,0,0,0,0,0,881
4199,ODISHA,2010,26,HEALTH ISSUES,1,6,23,28,20,78,1,11,17,18,10,57,0,0,0,0,0,0,135
4744,ODISHA,2010,26,HERO WORSHIP,0,1,0,0,0,1,0,0,0,0,1,1,0,0,0,0,0,0,2
5289,ODISHA,2010,26,ILLEGITIMATE PREGNANCY,0,0,0,0,0,0,0,3,3,0,0,6,0,0,0,0,0,0,6
5834,ODISHA,2010,26,LOVE AFFAIRS,2,66,28,6,1,103,10,86,28,1,0,125,0,0,0,0,0,0,228
6380,ODISHA,2010,26,MARITAL ISSUES,4,35,30,12,7,88,4,78,43,9,1,135,0,0,0,0,0,0,223
6926,ODISHA,2010,26,MENTAL HEALTH,1,10,15,18,7,51,1,14,14,13,2,44,0,0,0,0,0,0,95
7472,ODISHA,2010,26,OTHERS,38,211,210,169,28,656,21,144,127,78,7,377,0,0,0,0,0,0,1033
8056,ODISHA,2010,26,"PHYSICAL ABUSE (RAPE,INCEST ETC.)",0,0,0,0,0,0,0,0,0,0,0,0,0,0,0,0,0,0,0
8563,ODISHA,2010,26,SOCIETAL ISSUES,1,7,30,32,7,77,0,32,29,5,0,66,0,0,0,0,0,0,143
416,ODISHA,2011,26,CAUSES NOT KNOWN,46,241,279,195,81,842,36,142,139,102,44,463,0,0,0,0,0,0,1305
962,ODISHA,2011,26,DEATH OF DEAR PERSON,0,6,14,10,2,32,0,15,12,5,0,32,0,0,0,0,0,0,64
1508,ODISHA,2011,26,DOWRY DISPUTE,0,2,3,0,0,5,0,74,48,7,0,129,0,0,0,0,0,0,134
2054,ODISHA,2011,26,DRUG ABUSE,0,1,8,4,0,13,0,0,0,0,0,0,0,0,0,0,0,0,13
2600,ODISHA,2011,26,ECONOMIC ISSUES,1,60,87,49,11,208,3,36,25,9,5,78,0,0,0,0,0,0,286
3146,ODISHA,2011,26,EXAM FAILURE,9,42,3,1,1,56,9,31,1,1,0,42,0,0,0,0,0,0,98
3692,ODISHA,2011,26,FAMILY PROBLEMS,7,125,179,109,23,443,8,118,129,58,11,324,0,0,0,0,0,0,767
4238,ODISHA,2011,26,HEALTH ISSUES,2,12,35,32,20,101,1,8,32,32,13,86,0,0,0,0,0,0,187
4783,ODISHA,2011,26,HERO WORSHIP,0,0,0,0,0,0,0,0,0,0,0,0,0,0,0,0,0,0,0
5328,ODISHA,2011,26,ILLEGITIMATE PREGNANCY,0,0,0,0,0,0,0,3,3,0,0,6,0,0,0,0,0,0,6
5873,ODISHA,2011,26,LOVE AFFAIRS,6,109,36,2,1,154,9,120,23,2,0,154,0,0,0,0,0,0,308
6419,ODISHA,2011,26,MARITAL ISSUES,6,37,46,22,10,121,5,54,56,21,8,144,0,0,0,0,0,0,265
6965,ODISHA,2011,26,MENTAL HEALTH,0,14,13,15,7,49,1,8,8,8,6,31,0,0,0,0,0,0,80
7511,ODISHA,2011,26,OTHERS,67,342,282,195,71,957,49,233,195,108,39,624,0,0,0,0,0,0,1581
8095,ODISHA,2011,26,"PHYSICAL ABUSE (RAPE,INCEST ETC.)",0,0,0,0,0,0,0,0,0,0,0,0,0,0,0,0,0,0,0
8602,ODISHA,2011,26,SOCIETAL ISSUES,0,25,41,13,0,79,0,30,34,3,1,68,0,0,0,0,0,0,147
455,ODISHA,2012,26,CAUSES NOT KNOWN,49,242,246,174,76,787,33,197,185,82,35,532,0,0,0,0,0,0,1319
1001,ODISHA,2012,26,DEATH OF DEAR PERSON,0,0,2,3,5,10,0,1,4,6,0,11,0,0,0,0,0,0,21
1547,ODISHA,2012,26,DOWRY DISPUTE,0,0,0,0,0,0,0,78,27,2,0,107,0,0,0,0,0,0,107
2093,ODISHA,2012,26,DRUG ABUSE,1,4,8,2,0,15,0,0,0,0,0,0,0,0,0,0,0,0,15
2639,ODISHA,2012,26,ECONOMIC ISSUES,0,32,46,39,5,122,0,17,14,9,0,40,0,0,0,0,0,0,162
3185,ODISHA,2012,26,EXAM FAILURE,7,55,0,0,0,62,10,44,0,0,0,54,0,0,0,0,0,0,116
3731,ODISHA,2012,26,FAMILY PROBLEMS,3,125,259,133,38,558,9,97,169,70,8,353,0,0,0,0,0,0,911
4277,ODISHA,2012,26,HEALTH ISSUES,0,17,33,47,19,116,1,8,18,18,11,56,0,0,0,0,0,0,172
4822,ODISHA,2012,26,HERO WORSHIP,0,0,0,0,0,0,0,3,0,0,0,3,0,0,0,0,0,0,3
5367,ODISHA,2012,26,ILLEGITIMATE PREGNANCY,0,0,0,0,0,0,0,5,0,0,0,5,0,0,0,0,0,0,5
5912,ODISHA,2012,26,LOVE AFFAIRS,4,87,38,0,0,129,23,125,48,0,0,196,0,0,0,0,0,0,325
6458,ODISHA,2012,26,MARITAL ISSUES,0,39,34,16,0,89,5,59,41,11,0,116,0,0,0,0,0,0,205
7004,ODISHA,2012,26,MENTAL HEALTH,0,25,15,12,5,57,0,14,6,6,2,28,0,0,0,0,0,0,85
7550,ODISHA,2012,26,OTHERS,80,233,273,239,93,918,62,157,199,120,53,591,0,0,0,0,0,0,1509
8134,ODISHA,2012,26,"PHYSICAL ABUSE (RAPE,INCEST ETC.)",0,0,0,0,0,0,0,0,0,0,0,0,0,0,0,0,0,0,0
8641,ODISHA,2012,26,SOCIETAL ISSUES,0,8,10,14,1,33,0,24,10,5,0,39,0,0,0,0,0,0,72
494,ODISHA,2013,26,CAUSES NOT KNOWN,44,209,241,195,165,854,39,143,134,86,28,430,0,0,0,0,0,0,1284
1040,ODISHA,2013,26,DEATH OF DEAR PERSON,0,7,0,3,2,12,0,0,1,0,0,1,0,0,0,0,0,0,13
1586,ODISHA,2013,26,DOWRY DISPUTE,0,0,0,0,0,0,0,57,33,0,0,90,0,0,0,0,0,0,90
2132,ODISHA,2013,26,DRUG ABUSE,2,6,9,5,0,22,0,1,1,0,0,2,0,0,0,0,0,0,24
2678,ODISHA,2013,26,ECONOMIC ISSUES,0,34,40,26,4,104,0,16,13,6,2,37,0,0,0,0,0,0,141
3224,ODISHA,2013,26,EXAM FAILURE,6,43,0,0,0,49,6,32,0,0,0,38,0,0,0,0,0,0,87
3770,ODISHA,2013,26,FAMILY PROBLEMS,1,114,218,169,45,547,6,95,136,97,13,347,0,0,0,0,0,0,894
4316,ODISHA,2013,26,HEALTH ISSUES,0,8,41,30,10,89,2,4,11,19,9,45,0,0,0,0,0,0,134
4861,ODISHA,2013,26,HERO WORSHIP,0,0,1,0,1,2,0,0,0,0,0,0,0,0,0,0,0,0,2
5406,ODISHA,2013,26,ILLEGITIMATE PREGNANCY,0,0,0,0,0,0,3,18,8,0,0,29,0,0,0,0,0,0,29
5951,ODISHA,2013,26,LOVE AFFAIRS,0,89,29,0,0,118,10,91,41,0,0,142,0,0,0,0,0,0,260
6497,ODISHA,2013,26,MARITAL ISSUES,0,45,39,14,0,98,4,44,36,12,0,96,0,0,0,0,0,0,194
7043,ODISHA,2013,26,MENTAL HEALTH,0,21,23,19,2,65,0,16,8,6,2,32,0,0,0,0,0,0,97
7589,ODISHA,2013,26,OTHERS,100,354,363,275,140,1232,69,212,202,121,75,679,0,0,0,0,0,0,1911
8173,ODISHA,2013,26,"PHYSICAL ABUSE (RAPE,INCEST ETC.)",0,0,0,0,0,0,0,0,0,0,0,0,0,0,0,0,0,0,0
8680,ODISHA,2013,26,SOCIETAL ISSUES,0,8,36,34,2,80,0,3,8,1,0,12,0,0,0,0,0,0,92
533,ODISHA,2014,26,CAUSES NOT KNOWN,13,138,83,63,38,335,9,163,102,89,2,365,0,0,0,0,0,0,700
1079,ODISHA,2014,26,DEATH OF DEAR PERSON,0,0,1,2,2,5,0,1,0,1,0,2,0,0,0,0,0,0,7
1625,ODISHA,2014,26,DOWRY DISPUTE,0,2,0,0,0,2,0,68,12,0,0,80,0,0,0,0,0,0,82
2171,ODISHA,2014,26,DRUG ABUSE,0,7,29,32,0,68,0,0,1,0,0,1,0,0,0,0,0,0,69
2717,ODISHA,2014,26,ECONOMIC ISSUES,0,73,45,16,9,143,0,19,14,4,0,37,0,0,0,0,0,0,180
3263,ODISHA,2014,26,EXAM FAILURE,2,65,0,0,0,67,2,48,0,0,0,50,0,0,0,0,0,0,117
3809,ODISHA,2014,26,FAMILY PROBLEMS,1,102,170,114,24,411,6,112,133,69,17,337,0,0,0,0,0,0,748
4355,ODISHA,2014,26,HEALTH ISSUES,3,102,138,159,68,470,12,52,66,36,20,186,0,0,0,0,0,0,656
4900,ODISHA,2014,26,HERO WORSHIP,0,0,0,0,0,0,0,0,0,0,0,0,0,0,0,0,0,0,0
5445,ODISHA,2014,26,ILLEGITIMATE PREGNANCY,0,0,0,0,0,0,0,9,3,0,0,12,0,0,0,0,0,0,12
5990,ODISHA,2014,26,LOVE AFFAIRS,2,107,13,1,0,123,0,138,13,1,0,152,0,0,0,0,0,0,275
6536,ODISHA,2014,26,MARITAL ISSUES,0,109,65,14,0,188,0,236,126,3,0,365,0,0,0,0,0,0,553
7082,ODISHA,2014,26,MENTAL HEALTH,1,22,18,11,8,60,0,14,12,2,2,30,0,0,0,0,0,0,90
7628,ODISHA,2014,26,OTHERS,5,384,231,154,49,823,13,299,152,95,22,581,0,0,0,0,0,0,1404
7667,ODISHA,2014,26,PHYSICAL ABUSE,0,0,0,0,0,0,0,1,0,0,0,1,0,0,0,0,0,0,1
8719,ODISHA,2014,26,SOCIETAL ISSUES,0,3,5,5,4,17,0,5,5,0,0,10,0,0,0,0,0,0,27
27,PUDUCHERRY,2001,27,CAUSES NOT KNOWN,0,4,6,3,5,18,1,3,2,1,0,7,0,0,0,0,0,0,25
573,PUDUCHERRY,2001,27,DEATH OF DEAR PERSON,0,0,0,1,0,1,0,2,1,0,0,3,0,0,0,0,0,0,4
1119,PUDUCHERRY,2001,27,DOWRY DISPUTE,0,0,0,0,0,0,0,0,0,0,0,0,0,0,0,0,0,0,0
1665,PUDUCHERRY,2001,27,DRUG ABUSE,0,0,0,0,0,0,0,0,0,0,0,0,0,0,0,0,0,0,0
2211,PUDUCHERRY,2001,27,ECONOMIC ISSUES,0,3,2,1,0,6,0,1,0,0,0,1,0,0,0,0,0,0,7
2757,PUDUCHERRY,2001,27,EXAM FAILURE,2,0,0,0,0,2,0,2,0,0,0,2,0,0,0,0,0,0,4
3303,PUDUCHERRY,2001,27,FAMILY PROBLEMS,0,37,56,29,14,136,4,55,19,8,1,87,0,0,0,0,0,0,223
3849,PUDUCHERRY,2001,27,HEALTH ISSUES,0,17,30,43,18,108,0,40,14,8,5,67,0,0,0,0,0,0,175
4395,PUDUCHERRY,2001,27,HERO WORSHIP,0,0,0,0,0,0,0,0,0,0,0,0,0,0,0,0,0,0,0
4940,PUDUCHERRY,2001,27,ILLEGITIMATE PREGNANCY,0,0,0,0,0,0,0,1,0,0,0,1,0,0,0,0,0,0,1
5485,PUDUCHERRY,2001,27,LOVE AFFAIRS,0,3,1,0,0,4,0,5,0,0,0,5,0,0,0,0,0,0,9
6030,PUDUCHERRY,2001,27,MARITAL ISSUES,0,4,4,0,0,8,0,8,2,0,0,10,0,0,0,0,0,0,18
6576,PUDUCHERRY,2001,27,MENTAL HEALTH,0,3,2,0,0,5,0,3,5,3,1,12,0,0,0,0,0,0,17
7122,PUDUCHERRY,2001,27,OTHERS,0,10,13,4,3,30,1,0,8,2,0,11,0,0,0,0,0,0,41
7707,PUDUCHERRY,2001,27,"PHYSICAL ABUSE (RAPE,INCEST ETC.)",0,0,0,0,0,0,0,0,0,0,0,0,0,0,0,0,0,0,0
8213,PUDUCHERRY,2001,27,SOCIETAL ISSUES,0,1,1,3,0,5,0,0,0,0,0,0,0,0,0,0,0,0,5
66,PUDUCHERRY,2002,27,CAUSES NOT KNOWN,0,6,8,7,2,23,0,2,2,0,1,5,0,0,0,0,0,0,28
612,PUDUCHERRY,2002,27,DEATH OF DEAR PERSON,0,2,1,1,0,4,0,2,0,1,1,4,0,0,0,0,0,0,8
1158,PUDUCHERRY,2002,27,DOWRY DISPUTE,0,0,0,0,0,0,0,0,0,0,0,0,0,0,0,0,0,0,0
1704,PUDUCHERRY,2002,27,DRUG ABUSE,0,0,0,0,0,0,0,0,0,0,0,0,0,0,0,0,0,0,0
2250,PUDUCHERRY,2002,27,ECONOMIC ISSUES,0,4,7,6,1,18,0,2,0,1,0,3,0,0,0,0,0,0,21
2796,PUDUCHERRY,2002,27,EXAM FAILURE,0,2,0,0,0,2,0,3,0,0,0,3,0,0,0,0,0,0,5
3342,PUDUCHERRY,2002,27,FAMILY PROBLEMS,4,52,76,46,10,188,3,33,12,5,2,55,0,0,0,0,0,0,243
3888,PUDUCHERRY,2002,27,HEALTH ISSUES,0,15,41,41,18,115,0,25,19,12,11,67,0,0,0,0,0,0,182
4434,PUDUCHERRY,2002,27,HERO WORSHIP,0,0,0,0,0,0,0,0,0,0,0,0,0,0,0,0,0,0,0
4979,PUDUCHERRY,2002,27,ILLEGITIMATE PREGNANCY,0,0,0,0,0,0,0,0,0,0,0,0,0,0,0,0,0,0,0
5524,PUDUCHERRY,2002,27,LOVE AFFAIRS,0,3,2,0,0,5,0,0,0,0,0,0,0,0,0,0,0,0,5
6069,PUDUCHERRY,2002,27,MARITAL ISSUES,0,2,2,0,0,4,0,0,0,0,0,0,0,0,0,0,0,0,4
6615,PUDUCHERRY,2002,27,MENTAL HEALTH,0,9,7,4,2,22,0,2,5,3,0,10,0,0,0,0,0,0,32
7161,PUDUCHERRY,2002,27,OTHERS,1,2,14,3,6,26,0,3,3,1,1,8,0,0,0,0,0,0,34
7746,PUDUCHERRY,2002,27,"PHYSICAL ABUSE (RAPE,INCEST ETC.)",0,0,0,0,0,0,0,1,0,0,0,1,0,0,0,0,0,0,1
8252,PUDUCHERRY,2002,27,SOCIETAL ISSUES,0,1,1,1,0,3,0,1,0,0,0,1,0,0,0,0,0,0,4
105,PUDUCHERRY,2003,27,CAUSES NOT KNOWN,0,3,10,7,2,22,0,5,0,0,0,5,0,0,0,0,0,0,27
651,PUDUCHERRY,2003,27,DEATH OF DEAR PERSON,0,4,4,2,1,11,0,0,1,0,0,1,0,0,0,0,0,0,12
1197,PUDUCHERRY,2003,27,DOWRY DISPUTE,0,0,0,0,0,0,0,0,0,0,0,0,0,0,0,0,0,0,0
1743,PUDUCHERRY,2003,27,DRUG ABUSE,0,0,0,0,0,0,0,0,0,0,0,0,0,0,0,0,0,0,0
2289,PUDUCHERRY,2003,27,ECONOMIC ISSUES,0,5,7,5,2,19,0,0,2,1,0,3,0,0,0,0,0,0,22
2835,PUDUCHERRY,2003,27,EXAM FAILURE,0,4,0,0,0,4,0,4,0,0,0,4,0,0,0,0,0,0,8
3381,PUDUCHERRY,2003,27,FAMILY PROBLEMS,3,51,67,37,6,164,0,54,12,3,3,72,0,0,0,0,0,0,236
3927,PUDUCHERRY,2003,27,HEALTH ISSUES,0,19,29,30,21,99,0,38,9,12,14,73,0,0,0,0,0,0,172
4473,PUDUCHERRY,2003,27,HERO WORSHIP,0,0,0,0,0,0,0,0,0,0,0,0,0,0,0,0,0,0,0
5018,PUDUCHERRY,2003,27,ILLEGITIMATE PREGNANCY,0,0,0,0,0,0,0,0,0,0,0,0,0,0,0,0,0,0,0
5563,PUDUCHERRY,2003,27,LOVE AFFAIRS,0,6,1,0,0,7,0,7,0,0,0,7,0,0,0,0,0,0,14
6108,PUDUCHERRY,2003,27,MARITAL ISSUES,0,5,1,0,0,6,0,4,0,0,0,4,0,0,0,0,0,0,10
6654,PUDUCHERRY,2003,27,MENTAL HEALTH,0,7,12,2,3,24,0,7,6,2,0,15,0,0,0,0,0,0,39
7200,PUDUCHERRY,2003,27,OTHERS,1,7,10,3,1,22,0,7,2,0,1,10,0,0,0,0,0,0,32
7785,PUDUCHERRY,2003,27,"PHYSICAL ABUSE (RAPE,INCEST ETC.)",0,0,0,0,0,0,0,0,0,0,0,0,0,0,0,0,0,0,0
8291,PUDUCHERRY,2003,27,SOCIETAL ISSUES,0,3,5,2,0,10,0,0,0,0,0,0,0,0,0,0,0,0,10
144,PUDUCHERRY,2004,27,CAUSES NOT KNOWN,0,1,7,7,1,16,0,5,2,0,0,7,0,0,0,0,0,0,23
690,PUDUCHERRY,2004,27,DEATH OF DEAR PERSON,0,2,3,3,0,8,0,2,1,2,0,5,0,0,0,0,0,0,13
1236,PUDUCHERRY,2004,27,DOWRY DISPUTE,0,0,0,0,0,0,0,0,0,0,0,0,0,0,0,0,0,0,0
1782,PUDUCHERRY,2004,27,DRUG ABUSE,0,0,0,0,0,0,0,0,0,0,0,0,0,0,0,0,0,0,0
2328,PUDUCHERRY,2004,27,ECONOMIC ISSUES,0,4,3,3,0,10,0,0,1,0,0,1,0,0,0,0,0,0,11
2874,PUDUCHERRY,2004,27,EXAM FAILURE,0,1,0,0,0,1,3,1,0,0,0,4,0,0,0,0,0,0,5
3420,PUDUCHERRY,2004,27,FAMILY PROBLEMS,0,34,58,39,7,138,1,39,33,6,4,83,0,0,0,0,0,0,221
3966,PUDUCHERRY,2004,27,HEALTH ISSUES,0,16,26,37,22,101,0,31,16,5,6,58,0,0,0,0,0,0,159
4512,PUDUCHERRY,2004,27,HERO WORSHIP,0,0,0,0,0,0,0,0,0,0,0,0,0,0,0,0,0,0,0
5057,PUDUCHERRY,2004,27,ILLEGITIMATE PREGNANCY,0,0,0,0,0,0,0,0,0,0,0,0,0,0,0,0,0,0,0
5602,PUDUCHERRY,2004,27,LOVE AFFAIRS,0,4,0,0,0,4,0,1,0,0,0,1,0,0,0,0,0,0,5
6147,PUDUCHERRY,2004,27,MARITAL ISSUES,0,2,0,0,0,2,0,6,2,0,0,8,0,0,0,0,0,0,10
6693,PUDUCHERRY,2004,27,MENTAL HEALTH,0,6,7,4,0,17,0,2,4,3,2,11,0,0,0,0,0,0,28
7239,PUDUCHERRY,2004,27,OTHERS,1,12,12,7,2,34,0,10,6,4,3,23,0,0,0,0,0,0,57
7824,PUDUCHERRY,2004,27,"PHYSICAL ABUSE (RAPE,INCEST ETC.)",0,0,0,0,0,0,0,0,0,0,0,0,0,0,0,0,0,0,0
8330,PUDUCHERRY,2004,27,SOCIETAL ISSUES,0,0,5,2,0,7,0,0,0,0,0,0,0,0,0,0,0,0,7
183,PUDUCHERRY,2005,27,CAUSES NOT KNOWN,0,3,7,3,4,17,0,1,0,0,0,1,0,0,0,0,0,0,18
729,PUDUCHERRY,2005,27,DEATH OF DEAR PERSON,0,0,4,2,0,6,0,2,1,0,2,5,0,0,0,0,0,0,11
1275,PUDUCHERRY,2005,27,DOWRY DISPUTE,0,0,0,0,0,0,0,0,0,0,0,0,0,0,0,0,0,0,0
1821,PUDUCHERRY,2005,27,DRUG ABUSE,0,0,0,0,0,0,0,0,0,0,0,0,0,0,0,0,0,0,0
2367,PUDUCHERRY,2005,27,ECONOMIC ISSUES,0,3,3,0,0,6,0,2,0,0,0,2,0,0,0,0,0,0,8
2913,PUDUCHERRY,2005,27,EXAM FAILURE,0,1,0,0,0,1,0,5,0,0,0,5,0,0,0,0,0,0,6
3459,PUDUCHERRY,2005,27,FAMILY PROBLEMS,1,41,72,64,8,186,1,44,30,4,1,80,0,0,0,0,0,0,266
4005,PUDUCHERRY,2005,27,HEALTH ISSUES,0,7,12,23,14,56,0,22,14,8,11,55,0,0,0,0,0,0,111
4551,PUDUCHERRY,2005,27,HERO WORSHIP,0,0,0,0,0,0,0,0,0,0,0,0,0,0,0,0,0,0,0
5096,PUDUCHERRY,2005,27,ILLEGITIMATE PREGNANCY,0,0,0,0,0,0,0,0,0,0,0,0,0,0,0,0,0,0,0
5641,PUDUCHERRY,2005,27,LOVE AFFAIRS,0,4,0,0,0,4,0,2,0,0,0,2,0,0,0,0,0,0,6
6186,PUDUCHERRY,2005,27,MARITAL ISSUES,0,5,3,0,0,8,0,6,3,0,0,9,0,0,0,0,0,0,17
6732,PUDUCHERRY,2005,27,MENTAL HEALTH,0,4,8,6,0,18,0,5,4,4,2,15,0,0,0,0,0,0,33
7278,PUDUCHERRY,2005,27,OTHERS,0,7,20,7,4,38,1,12,4,3,4,24,0,0,0,0,0,0,62
7863,PUDUCHERRY,2005,27,"PHYSICAL ABUSE (RAPE,INCEST ETC.)",0,0,0,0,0,0,0,0,0,0,0,0,0,0,0,0,0,0,0
8369,PUDUCHERRY,2005,27,SOCIETAL ISSUES,0,0,0,0,0,0,0,0,0,0,0,0,0,0,0,0,0,0,0
222,PUDUCHERRY,2006,27,CAUSES NOT KNOWN,0,4,7,3,1,15,0,1,0,0,0,1,0,0,0,0,0,0,16
768,PUDUCHERRY,2006,27,DEATH OF DEAR PERSON,0,3,4,1,0,8,0,0,0,1,0,1,0,0,0,0,0,0,9
1314,PUDUCHERRY,2006,27,DOWRY DISPUTE,0,0,0,0,0,0,0,0,0,0,0,0,0,0,0,0,0,0,0
1860,PUDUCHERRY,2006,27,DRUG ABUSE,0,0,0,0,1,1,0,0,0,0,0,0,0,0,0,0,0,0,1
2406,PUDUCHERRY,2006,27,ECONOMIC ISSUES,0,3,3,1,0,7,0,1,0,0,0,1,0,0,0,0,0,0,8
2952,PUDUCHERRY,2006,27,EXAM FAILURE,0,2,0,0,0,2,0,5,0,0,0,5,0,0,0,0,0,0,7
3498,PUDUCHERRY,2006,27,FAMILY PROBLEMS,4,33,51,35,9,132,5,38,18,4,3,68,0,0,0,0,0,0,200
4044,PUDUCHERRY,2006,27,HEALTH ISSUES,0,13,30,30,14,87,3,34,14,8,7,66,0,0,0,0,0,0,153
4589,PUDUCHERRY,2006,27,HERO WORSHIP,0,0,0,0,0,0,0,0,0,0,0,0,0,0,0,0,0,0,0
5134,PUDUCHERRY,2006,27,ILLEGITIMATE PREGNANCY,0,0,0,0,0,0,0,0,0,0,0,0,0,0,0,0,0,0,0
5679,PUDUCHERRY,2006,27,LOVE AFFAIRS,0,1,1,0,0,2,0,4,0,0,0,4,0,0,0,0,0,0,6
6225,PUDUCHERRY,2006,27,MARITAL ISSUES,0,3,2,1,0,6,0,6,1,0,0,7,0,0,0,0,0,0,13
6771,PUDUCHERRY,2006,27,MENTAL HEALTH,0,4,12,5,3,24,0,4,2,1,1,8,0,0,0,0,0,0,32
7317,PUDUCHERRY,2006,27,OTHERS,1,15,22,14,1,53,0,9,1,1,2,13,0,0,0,0,0,0,66
7901,PUDUCHERRY,2006,27,"PHYSICAL ABUSE (RAPE,INCEST ETC.)",0,0,0,0,0,0,0,0,0,0,0,0,0,0,0,0,0,0,0
8408,PUDUCHERRY,2006,27,SOCIETAL ISSUES,0,3,5,3,1,12,0,1,2,0,0,3,0,0,0,0,0,0,15
261,PUDUCHERRY,2007,27,CAUSES NOT KNOWN,0,3,7,3,1,14,0,9,1,1,2,13,0,0,0,0,0,0,27
807,PUDUCHERRY,2007,27,DEATH OF DEAR PERSON,0,0,4,1,1,6,0,1,1,0,0,2,0,0,0,0,0,0,8
1353,PUDUCHERRY,2007,27,DOWRY DISPUTE,0,0,0,0,0,0,0,0,0,0,0,0,0,0,0,0,0,0,0
1899,PUDUCHERRY,2007,27,DRUG ABUSE,0,0,0,0,0,0,0,0,0,0,0,0,0,0,0,0,0,0,0
2445,PUDUCHERRY,2007,27,ECONOMIC ISSUES,0,3,0,1,0,4,0,0,0,0,0,0,0,0,0,0,0,0,4
2991,PUDUCHERRY,2007,27,EXAM FAILURE,0,0,0,0,0,0,1,8,0,0,0,9,0,0,0,0,0,0,9
3537,PUDUCHERRY,2007,27,FAMILY PROBLEMS,2,38,85,44,8,177,2,54,24,1,2,83,0,0,0,0,0,0,260
4083,PUDUCHERRY,2007,27,HEALTH ISSUES,0,5,13,23,9,50,0,27,10,2,5,44,0,0,0,0,0,0,94
4628,PUDUCHERRY,2007,27,HERO WORSHIP,0,0,0,0,0,0,0,0,0,0,0,0,0,0,0,0,0,0,0
5173,PUDUCHERRY,2007,27,ILLEGITIMATE PREGNANCY,0,0,0,0,0,0,0,0,0,0,0,0,0,0,0,0,0,0,0
5718,PUDUCHERRY,2007,27,LOVE AFFAIRS,0,6,1,0,0,7,0,2,0,1,0,3,0,0,0,0,0,0,10
6264,PUDUCHERRY,2007,27,MARITAL ISSUES,0,1,4,0,0,5,0,5,2,0,0,7,0,0,0,0,0,0,12
6810,PUDUCHERRY,2007,27,MENTAL HEALTH,0,5,8,8,1,22,0,4,11,2,1,18,0,0,0,0,0,0,40
7356,PUDUCHERRY,2007,27,OTHERS,0,12,11,8,3,34,3,10,3,1,2,19,0,0,0,0,0,0,53
7940,PUDUCHERRY,2007,27,"PHYSICAL ABUSE (RAPE,INCEST ETC.)",0,0,0,0,0,0,0,0,0,0,0,0,0,0,0,0,0,0,0
8447,PUDUCHERRY,2007,27,SOCIETAL ISSUES,0,0,0,0,0,0,0,0,0,0,0,0,0,0,0,0,0,0,0
300,PUDUCHERRY,2008,27,CAUSES NOT KNOWN,0,3,4,5,1,13,0,1,1,0,0,2,0,0,0,0,0,0,15
846,PUDUCHERRY,2008,27,DEATH OF DEAR PERSON,0,0,1,1,1,3,0,3,0,1,1,5,0,0,0,0,0,0,8
1392,PUDUCHERRY,2008,27,DOWRY DISPUTE,0,0,0,0,0,0,0,0,0,0,0,0,0,0,0,0,0,0,0
1938,PUDUCHERRY,2008,27,DRUG ABUSE,0,0,0,0,0,0,0,0,0,0,0,0,0,0,0,0,0,0,0
2484,PUDUCHERRY,2008,27,ECONOMIC ISSUES,0,1,0,0,0,1,0,0,0,0,0,0,0,0,0,0,0,0,1
3030,PUDUCHERRY,2008,27,EXAM FAILURE,0,2,1,0,0,3,0,7,0,0,0,7,0,0,0,0,0,0,10
3576,PUDUCHERRY,2008,27,FAMILY PROBLEMS,1,44,52,39,4,140,0,46,19,1,1,67,0,0,0,0,0,0,207
4122,PUDUCHERRY,2008,27,HEALTH ISSUES,0,5,25,30,9,69,0,24,16,4,6,50,0,0,0,0,0,0,119
4667,PUDUCHERRY,2008,27,HERO WORSHIP,0,0,0,0,0,0,0,0,0,0,0,0,0,0,0,0,0,0,0
5212,PUDUCHERRY,2008,27,ILLEGITIMATE PREGNANCY,0,0,0,0,0,0,0,0,0,0,0,0,0,0,0,0,0,0,0
5757,PUDUCHERRY,2008,27,LOVE AFFAIRS,0,6,0,0,0,6,0,0,0,0,0,0,0,0,0,0,0,0,6
6303,PUDUCHERRY,2008,27,MARITAL ISSUES,0,6,0,0,0,6,0,7,0,0,0,7,0,0,0,0,0,0,13
6849,PUDUCHERRY,2008,27,MENTAL HEALTH,0,3,6,10,0,19,0,4,5,0,1,10,0,0,0,0,0,0,29
7395,PUDUCHERRY,2008,27,OTHERS,1,18,26,7,10,62,0,13,2,3,4,22,0,0,0,0,0,0,84
7979,PUDUCHERRY,2008,27,"PHYSICAL ABUSE (RAPE,INCEST ETC.)",0,0,0,0,0,0,0,0,0,0,0,0,0,0,0,0,0,0,0
8486,PUDUCHERRY,2008,27,SOCIETAL ISSUES,0,2,7,2,1,12,0,0,3,0,0,3,0,0,0,0,0,0,15
339,PUDUCHERRY,2009,27,CAUSES NOT KNOWN,0,1,2,5,2,10,0,3,2,1,1,7,0,0,0,0,0,0,17
885,PUDUCHERRY,2009,27,DEATH OF DEAR PERSON,0,2,4,1,3,10,0,4,2,0,0,6,0,0,0,0,0,0,16
1431,PUDUCHERRY,2009,27,DOWRY DISPUTE,0,0,1,0,0,1,0,0,0,0,0,0,0,0,0,0,0,0,1
1977,PUDUCHERRY,2009,27,DRUG ABUSE,0,0,0,0,0,0,0,0,0,0,0,0,0,0,0,0,0,0,0
2523,PUDUCHERRY,2009,27,ECONOMIC ISSUES,0,3,1,1,0,5,0,2,0,0,0,2,0,0,0,0,0,0,7
3069,PUDUCHERRY,2009,27,EXAM FAILURE,0,1,0,0,0,1,0,3,0,0,0,3,0,0,0,0,0,0,4
3615,PUDUCHERRY,2009,27,FAMILY PROBLEMS,1,49,43,38,10,141,2,51,23,10,0,86,0,0,0,0,0,0,227
4161,PUDUCHERRY,2009,27,HEALTH ISSUES,0,13,20,35,16,84,1,22,7,10,8,48,0,0,0,0,0,0,132
4706,PUDUCHERRY,2009,27,HERO WORSHIP,0,0,0,0,0,0,0,0,0,0,0,0,0,0,0,0,0,0,0
5251,PUDUCHERRY,2009,27,ILLEGITIMATE PREGNANCY,0,0,0,0,0,0,0,0,0,0,0,0,0,0,0,0,0,0,0
5796,PUDUCHERRY,2009,27,LOVE AFFAIRS,0,4,1,0,0,5,0,2,0,0,0,2,0,0,0,0,0,0,7
6342,PUDUCHERRY,2009,27,MARITAL ISSUES,0,3,3,0,0,6,0,4,1,0,0,5,0,0,0,0,0,0,11
6888,PUDUCHERRY,2009,27,MENTAL HEALTH,0,5,6,6,5,22,0,0,3,5,3,11,0,0,0,0,0,0,33
7434,PUDUCHERRY,2009,27,OTHERS,1,10,11,17,2,41,1,12,7,1,1,22,0,0,0,0,0,0,63
8018,PUDUCHERRY,2009,27,"PHYSICAL ABUSE (RAPE,INCEST ETC.)",0,0,0,0,0,0,0,0,0,0,0,0,0,0,0,0,0,0,0
8525,PUDUCHERRY,2009,27,SOCIETAL ISSUES,0,0,0,0,0,0,0,0,0,0,0,0,0,0,0,0,0,0,0
378,PUDUCHERRY,2010,27,CAUSES NOT KNOWN,0,2,5,4,3,14,1,4,0,0,0,5,0,0,0,0,0,0,19
924,PUDUCHERRY,2010,27,DEATH OF DEAR PERSON,0,2,1,4,2,9,0,1,1,2,0,4,0,0,0,0,0,0,13
1470,PUDUCHERRY,2010,27,DOWRY DISPUTE,0,0,0,0,0,0,0,0,0,0,0,0,0,0,0,0,0,0,0
2016,PUDUCHERRY,2010,27,DRUG ABUSE,0,0,0,0,0,0,0,0,0,0,0,0,0,0,0,0,0,0,0
2562,PUDUCHERRY,2010,27,ECONOMIC ISSUES,0,3,2,0,0,5,0,0,0,0,0,0,0,0,0,0,0,0,5
3108,PUDUCHERRY,2010,27,EXAM FAILURE,0,0,0,0,0,0,0,4,0,0,0,4,0,0,0,0,0,0,4
3654,PUDUCHERRY,2010,27,FAMILY PROBLEMS,1,33,60,37,4,135,1,44,15,1,1,62,0,0,0,0,0,0,197
4200,PUDUCHERRY,2010,27,HEALTH ISSUES,0,10,34,28,10,82,1,32,9,5,10,57,0,0,0,0,0,0,139
4745,PUDUCHERRY,2010,27,HERO WORSHIP,0,0,0,0,0,0,0,0,0,0,0,0,0,0,0,0,0,0,0
5290,PUDUCHERRY,2010,27,ILLEGITIMATE PREGNANCY,0,0,0,0,0,0,0,0,0,0,0,0,0,0,0,0,0,0,0
5835,PUDUCHERRY,2010,27,LOVE AFFAIRS,0,0,0,0,0,0,0,2,0,0,0,2,0,0,0,0,0,0,2
6381,PUDUCHERRY,2010,27,MARITAL ISSUES,0,4,9,1,0,14,0,1,5,0,0,6,0,0,0,0,0,0,20
6927,PUDUCHERRY,2010,27,MENTAL HEALTH,0,2,13,8,1,24,0,2,4,2,1,9,0,0,0,0,0,0,33
7473,PUDUCHERRY,2010,27,OTHERS,1,14,16,13,5,49,0,8,7,1,7,23,0,0,0,0,0,0,72
8057,PUDUCHERRY,2010,27,"PHYSICAL ABUSE (RAPE,INCEST ETC.)",0,0,0,0,0,0,0,0,0,0,0,0,0,0,0,0,0,0,0
8564,PUDUCHERRY,2010,27,SOCIETAL ISSUES,0,0,1,0,0,1,0,1,1,1,0,3,0,0,0,0,0,0,4
417,PUDUCHERRY,2011,27,CAUSES NOT KNOWN,0,9,4,2,3,18,0,4,0,0,0,4,0,0,0,0,0,0,22
963,PUDUCHERRY,2011,27,DEATH OF DEAR PERSON,0,0,3,3,0,6,0,0,1,0,0,1,0,0,0,0,0,0,7
1509,PUDUCHERRY,2011,27,DOWRY DISPUTE,0,0,0,0,0,0,0,1,0,0,0,1,0,0,0,0,0,0,1
2055,PUDUCHERRY,2011,27,DRUG ABUSE,0,0,0,0,0,0,0,0,0,0,0,0,0,0,0,0,0,0,0
2601,PUDUCHERRY,2011,27,ECONOMIC ISSUES,0,4,4,3,0,11,0,1,1,0,0,2,0,0,0,0,0,0,13
3147,PUDUCHERRY,2011,27,EXAM FAILURE,0,5,0,0,0,5,0,3,0,0,0,3,0,0,0,0,0,0,8
3693,PUDUCHERRY,2011,27,FAMILY PROBLEMS,2,37,75,32,9,155,5,46,14,4,0,69,0,0,0,0,0,0,224
4239,PUDUCHERRY,2011,27,HEALTH ISSUES,0,9,31,62,20,122,1,16,14,9,10,50,0,0,0,0,0,0,172
4784,PUDUCHERRY,2011,27,HERO WORSHIP,0,0,0,0,0,0,0,0,0,0,0,0,0,0,0,0,0,0,0
5329,PUDUCHERRY,2011,27,ILLEGITIMATE PREGNANCY,0,0,0,0,0,0,0,0,0,0,0,0,0,0,0,0,0,0,0
5874,PUDUCHERRY,2011,27,LOVE AFFAIRS,0,5,0,0,0,5,0,3,0,0,0,3,0,0,0,0,0,0,8
6420,PUDUCHERRY,2011,27,MARITAL ISSUES,0,4,1,1,0,6,0,2,1,0,0,3,0,0,0,0,0,0,9
6966,PUDUCHERRY,2011,27,MENTAL HEALTH,0,3,10,6,0,19,0,3,1,4,3,11,0,0,0,0,0,0,30
7512,PUDUCHERRY,2011,27,OTHERS,0,17,15,11,3,46,1,7,2,0,4,14,0,0,0,0,0,0,60
8096,PUDUCHERRY,2011,27,"PHYSICAL ABUSE (RAPE,INCEST ETC.)",0,0,0,0,0,0,0,0,0,0,0,0,0,0,0,0,0,0,0
8603,PUDUCHERRY,2011,27,SOCIETAL ISSUES,0,0,1,2,0,3,0,0,0,0,0,0,0,0,0,0,0,0,3
456,PUDUCHERRY,2012,27,CAUSES NOT KNOWN,0,2,4,6,1,13,0,1,1,1,2,5,0,0,0,0,0,0,18
1002,PUDUCHERRY,2012,27,DEATH OF DEAR PERSON,0,1,1,3,2,7,0,3,3,1,1,8,0,0,0,0,0,0,15
1548,PUDUCHERRY,2012,27,DOWRY DISPUTE,0,0,0,0,0,0,0,0,0,0,0,0,0,0,0,0,0,0,0
2094,PUDUCHERRY,2012,27,DRUG ABUSE,0,0,0,0,0,0,0,0,0,0,0,0,0,0,0,0,0,0,0
2640,PUDUCHERRY,2012,27,ECONOMIC ISSUES,0,1,0,0,0,1,0,0,0,0,0,0,0,0,0,0,0,0,1
3186,PUDUCHERRY,2012,27,EXAM FAILURE,0,4,0,0,0,4,0,5,0,0,0,5,0,0,0,0,0,0,9
3732,PUDUCHERRY,2012,27,FAMILY PROBLEMS,0,47,66,34,12,159,1,30,28,0,2,61,0,0,0,0,0,0,220
4278,PUDUCHERRY,2012,27,HEALTH ISSUES,0,8,21,43,24,96,1,15,13,11,8,48,0,0,0,0,0,0,144
4823,PUDUCHERRY,2012,27,HERO WORSHIP,0,0,0,0,0,0,0,0,0,0,0,0,0,0,0,0,0,0,0
5368,PUDUCHERRY,2012,27,ILLEGITIMATE PREGNANCY,0,0,0,0,0,0,0,0,0,0,0,0,0,0,0,0,0,0,0
5913,PUDUCHERRY,2012,27,LOVE AFFAIRS,0,7,0,0,0,7,0,3,0,0,0,3,0,0,0,0,0,0,10
6459,PUDUCHERRY,2012,27,MARITAL ISSUES,0,4,7,3,0,14,0,3,1,1,0,5,0,0,0,0,0,0,19
7005,PUDUCHERRY,2012,27,MENTAL HEALTH,0,1,6,6,1,14,0,2,4,3,0,9,0,0,0,0,0,0,23
7551,PUDUCHERRY,2012,27,OTHERS,1,16,20,7,8,52,2,11,4,3,5,25,0,0,0,0,0,0,77
8135,PUDUCHERRY,2012,27,"PHYSICAL ABUSE (RAPE,INCEST ETC.)",0,0,0,0,0,0,0,0,0,0,0,0,0,0,0,0,0,0,0
8642,PUDUCHERRY,2012,27,SOCIETAL ISSUES,0,1,2,1,1,5,0,0,0,0,0,0,0,0,0,0,0,0,5
495,PUDUCHERRY,2013,27,CAUSES NOT KNOWN,1,6,3,4,2,16,0,3,0,0,0,3,0,0,0,0,0,0,19
1041,PUDUCHERRY,2013,27,DEATH OF DEAR PERSON,0,3,0,2,1,6,0,1,1,1,1,4,0,0,0,0,0,0,10
1587,PUDUCHERRY,2013,27,DOWRY DISPUTE,0,0,0,0,0,0,0,0,0,0,0,0,0,0,0,0,0,0,0
2133,PUDUCHERRY,2013,27,DRUG ABUSE,0,0,0,0,0,0,0,0,0,0,0,0,0,0,0,0,0,0,0
2679,PUDUCHERRY,2013,27,ECONOMIC ISSUES,0,1,4,2,0,7,0,0,1,0,0,1,0,0,0,0,0,0,8
3225,PUDUCHERRY,2013,27,EXAM FAILURE,0,2,0,0,0,2,1,3,0,0,0,4,0,0,0,0,0,0,6
3771,PUDUCHERRY,2013,27,FAMILY PROBLEMS,2,45,93,85,8,233,0,47,24,3,7,81,0,0,0,0,0,0,314
4317,PUDUCHERRY,2013,27,HEALTH ISSUES,0,11,17,44,25,97,1,4,9,7,6,27,0,0,0,0,0,0,124
4862,PUDUCHERRY,2013,27,HERO WORSHIP,0,0,0,0,0,0,0,0,0,0,0,0,0,0,0,0,0,0,0
5407,PUDUCHERRY,2013,27,ILLEGITIMATE PREGNANCY,0,0,0,0,0,0,0,0,0,0,0,0,0,0,0,0,0,0,0
5952,PUDUCHERRY,2013,27,LOVE AFFAIRS,0,3,2,0,0,5,0,3,0,0,0,3,0,0,0,0,0,0,8
6498,PUDUCHERRY,2013,27,MARITAL ISSUES,0,6,3,1,0,10,0,3,0,0,0,3,0,0,0,0,0,0,13
7044,PUDUCHERRY,2013,27,MENTAL HEALTH,0,5,5,7,2,19,0,0,4,1,4,9,0,0,0,0,0,0,28
7590,PUDUCHERRY,2013,27,OTHERS,0,0,1,0,0,1,0,0,0,0,0,0,0,0,0,0,0,0,1
8174,PUDUCHERRY,2013,27,"PHYSICAL ABUSE (RAPE,INCEST ETC.)",0,0,0,0,0,0,0,0,0,0,0,0,0,0,0,0,0,0,0
8681,PUDUCHERRY,2013,27,SOCIETAL ISSUES,0,2,4,5,1,12,0,2,1,0,0,3,0,0,0,0,0,0,15
534,PUDUCHERRY,2014,27,CAUSES NOT KNOWN,0,6,10,8,16,40,0,8,5,0,4,17,0,0,0,0,0,0,57
1080,PUDUCHERRY,2014,27,DEATH OF DEAR PERSON,0,0,0,0,0,0,0,0,0,0,0,0,0,0,0,0,0,0,0
1626,PUDUCHERRY,2014,27,DOWRY DISPUTE,0,0,0,0,0,0,0,1,0,0,0,1,0,0,0,0,0,0,1
2172,PUDUCHERRY,2014,27,DRUG ABUSE,0,0,4,6,2,12,0,0,0,0,0,0,0,0,0,0,0,0,12
2718,PUDUCHERRY,2014,27,ECONOMIC ISSUES,0,4,2,0,0,6,0,0,0,0,0,0,0,0,0,0,0,0,6
3264,PUDUCHERRY,2014,27,EXAM FAILURE,1,0,0,0,0,1,0,0,0,0,0,0,0,0,0,0,0,0,1
3810,PUDUCHERRY,2014,27,FAMILY PROBLEMS,1,31,62,47,20,161,1,30,22,10,4,67,0,0,0,0,0,0,228
4356,PUDUCHERRY,2014,27,HEALTH ISSUES,0,17,46,32,12,107,0,2,8,2,6,18,0,0,0,0,0,0,125
4901,PUDUCHERRY,2014,27,HERO WORSHIP,0,0,0,0,0,0,0,0,0,0,0,0,0,0,0,0,0,0,0
5446,PUDUCHERRY,2014,27,ILLEGITIMATE PREGNANCY,0,0,0,0,0,0,0,0,0,0,0,0,0,0,0,0,0,0,0
5991,PUDUCHERRY,2014,27,LOVE AFFAIRS,0,5,0,0,0,5,0,1,0,0,0,1,0,0,0,0,0,0,6
6537,PUDUCHERRY,2014,27,MARITAL ISSUES,0,2,0,0,0,2,0,3,0,0,0,3,0,0,0,0,0,0,5
7083,PUDUCHERRY,2014,27,MENTAL HEALTH,0,1,4,0,0,5,0,0,2,0,0,2,0,0,0,0,0,0,7
7629,PUDUCHERRY,2014,27,OTHERS,2,43,74,66,25,210,0,31,8,7,9,55,0,0,0,0,0,0,265
7668,PUDUCHERRY,2014,27,PHYSICAL ABUSE,0,0,0,0,0,0,0,0,0,0,0,0,0,0,0,0,0,0,0
8720,PUDUCHERRY,2014,27,SOCIETAL ISSUES,0,0,0,0,0,0,0,0,0,0,0,0,0,0,0,0,0,0,0
28,PUNJAB,2001,28,CAUSES NOT KNOWN,0,4,1,1,0,6,0,51,27,5,9,92,0,0,0,0,0,0,98
574,PUNJAB,2001,28,DEATH OF DEAR PERSON,0,0,0,0,0,0,0,6,5,0,0,11,0,0,0,0,0,0,11
1120,PUNJAB,2001,28,DOWRY DISPUTE,0,1,0,0,0,1,0,0,0,0,0,0,0,0,0,0,0,0,1
1666,PUNJAB,2001,28,DRUG ABUSE,0,3,0,0,0,3,0,4,0,0,0,4,0,0,0,0,0,0,7
2212,PUNJAB,2001,28,ECONOMIC ISSUES,1,39,2,41,22,105,0,22,3,8,2,35,0,0,0,0,0,0,140
2758,PUNJAB,2001,28,EXAM FAILURE,0,2,1,0,0,3,0,0,0,0,0,0,0,0,0,0,0,0,3
3304,PUNJAB,2001,28,FAMILY PROBLEMS,0,8,0,1,0,9,0,4,4,0,1,9,0,0,0,0,0,0,18
3850,PUNJAB,2001,28,HEALTH ISSUES,0,21,25,19,15,80,0,9,6,2,2,19,0,0,0,0,0,0,99
4396,PUNJAB,2001,28,HERO WORSHIP,0,0,0,0,0,0,0,0,0,0,0,0,0,0,0,0,0,0,0
4941,PUNJAB,2001,28,ILLEGITIMATE PREGNANCY,0,4,0,0,0,4,0,5,0,0,0,5,0,0,0,0,0,0,9
5486,PUNJAB,2001,28,LOVE AFFAIRS,0,0,0,0,0,0,0,0,0,0,0,0,0,0,0,0,0,0,0
6031,PUNJAB,2001,28,MARITAL ISSUES,0,14,12,20,12,58,0,8,0,0,0,8,0,0,0,0,0,0,66
6577,PUNJAB,2001,28,MENTAL HEALTH,0,4,9,28,13,54,0,1,1,2,2,6,0,0,0,0,0,0,60
7123,PUNJAB,2001,28,OTHERS,0,5,5,3,1,14,0,3,0,0,0,3,0,0,0,0,0,0,17
7708,PUNJAB,2001,28,"PHYSICAL ABUSE (RAPE,INCEST ETC.)",0,4,9,6,0,19,0,3,4,1,0,8,0,0,0,0,0,0,27
8214,PUNJAB,2001,28,SOCIETAL ISSUES,0,20,0,16,4,40,0,33,16,1,2,52,0,0,0,0,0,0,92
67,PUNJAB,2002,28,CAUSES NOT KNOWN,0,37,27,30,9,103,0,11,6,0,0,17,0,0,0,0,0,0,120
613,PUNJAB,2002,28,DEATH OF DEAR PERSON,0,10,8,5,4,27,0,2,1,0,0,3,0,0,0,0,0,0,30
1159,PUNJAB,2002,28,DOWRY DISPUTE,0,0,0,0,0,0,0,0,2,0,0,2,0,0,0,0,0,0,2
1705,PUNJAB,2002,28,DRUG ABUSE,0,8,7,3,0,18,0,0,0,0,0,0,0,0,0,0,0,0,18
2251,PUNJAB,2002,28,ECONOMIC ISSUES,0,21,11,6,3,41,2,7,1,0,0,10,0,0,0,0,0,0,51
2797,PUNJAB,2002,28,EXAM FAILURE,0,1,4,1,0,6,0,13,7,0,0,20,0,0,0,0,0,0,26
3343,PUNJAB,2002,28,FAMILY PROBLEMS,0,0,0,0,0,0,0,0,0,0,0,0,0,0,0,0,0,0,0
3889,PUNJAB,2002,28,HEALTH ISSUES,0,24,37,18,10,89,0,13,4,3,3,23,0,0,0,0,0,0,112
4435,PUNJAB,2002,28,HERO WORSHIP,0,0,1,0,0,1,0,1,0,0,0,1,0,0,0,0,0,0,2
4980,PUNJAB,2002,28,ILLEGITIMATE PREGNANCY,0,3,0,1,0,4,0,1,0,0,0,1,0,0,0,0,0,0,5
5525,PUNJAB,2002,28,LOVE AFFAIRS,0,0,0,0,0,0,0,0,0,0,0,0,0,0,0,0,0,0,0
6070,PUNJAB,2002,28,MARITAL ISSUES,0,4,2,0,0,6,0,4,2,2,0,8,0,0,0,0,0,0,14
6616,PUNJAB,2002,28,MENTAL HEALTH,0,22,20,4,1,47,0,6,8,0,0,14,0,0,0,0,0,0,61
7162,PUNJAB,2002,28,OTHERS,0,0,0,0,0,0,0,0,0,0,0,0,0,0,0,0,0,0,0
7747,PUNJAB,2002,28,"PHYSICAL ABUSE (RAPE,INCEST ETC.)",0,11,12,4,2,29,0,0,3,0,0,3,0,0,0,0,0,0,32
8253,PUNJAB,2002,28,SOCIETAL ISSUES,17,9,0,0,0,26,0,6,1,1,0,8,0,0,0,0,0,0,34
106,PUNJAB,2003,28,CAUSES NOT KNOWN,1,69,31,29,14,144,1,5,5,4,2,17,0,0,0,0,0,0,161
652,PUNJAB,2003,28,DEATH OF DEAR PERSON,0,0,0,0,0,0,0,0,1,0,0,1,0,0,0,0,0,0,1
1198,PUNJAB,2003,28,DOWRY DISPUTE,0,0,0,0,0,0,0,4,2,0,0,6,0,0,0,0,0,0,6
1744,PUNJAB,2003,28,DRUG ABUSE,0,15,13,4,2,34,1,2,0,0,0,3,0,0,0,0,0,0,37
2290,PUNJAB,2003,28,ECONOMIC ISSUES,0,19,18,6,2,45,0,0,5,0,0,5,0,0,0,0,0,0,50
2836,PUNJAB,2003,28,EXAM FAILURE,0,3,0,0,0,3,0,2,0,0,0,2,0,0,0,0,0,0,5
3382,PUNJAB,2003,28,FAMILY PROBLEMS,0,19,25,15,2,61,0,14,13,1,0,28,0,0,0,0,0,0,89
3928,PUNJAB,2003,28,HEALTH ISSUES,0,10,4,9,5,28,0,7,5,1,1,14,0,0,0,0,0,0,42
4474,PUNJAB,2003,28,HERO WORSHIP,0,8,2,3,2,15,0,1,1,0,0,2,0,0,0,0,0,0,17
5019,PUNJAB,2003,28,ILLEGITIMATE PREGNANCY,0,0,0,0,0,0,0,2,0,0,0,2,0,0,0,0,0,0,2
5564,PUNJAB,2003,28,LOVE AFFAIRS,1,12,9,2,0,24,1,4,2,2,0,9,0,0,0,0,0,0,33
6109,PUNJAB,2003,28,MARITAL ISSUES,0,1,1,0,0,2,0,2,4,0,0,6,0,0,0,0,0,0,8
6655,PUNJAB,2003,28,MENTAL HEALTH,0,29,30,18,11,88,1,8,8,2,1,20,0,0,0,0,0,0,108
7201,PUNJAB,2003,28,OTHERS,0,4,6,2,1,13,0,1,1,0,0,2,0,0,0,0,0,0,15
7786,PUNJAB,2003,28,"PHYSICAL ABUSE (RAPE,INCEST ETC.)",0,24,17,4,2,47,1,4,3,0,0,8,0,0,0,0,0,0,55
8292,PUNJAB,2003,28,SOCIETAL ISSUES,1,1,0,0,0,2,0,0,0,0,0,0,0,0,0,0,0,0,2
145,PUNJAB,2004,28,CAUSES NOT KNOWN,0,36,44,21,6,107,2,1,2,1,0,6,0,0,0,0,0,0,113
691,PUNJAB,2004,28,DEATH OF DEAR PERSON,0,1,0,0,1,2,0,2,1,0,0,3,0,0,0,0,0,0,5
1237,PUNJAB,2004,28,DOWRY DISPUTE,0,0,0,0,0,0,10,2,0,0,0,12,0,0,0,0,0,0,12
1783,PUNJAB,2004,28,DRUG ABUSE,0,22,27,7,2,58,0,1,0,0,0,1,0,0,0,0,0,0,59
2329,PUNJAB,2004,28,ECONOMIC ISSUES,0,18,10,9,0,37,0,2,0,0,0,2,0,0,0,0,0,0,39
2875,PUNJAB,2004,28,EXAM FAILURE,0,3,1,0,0,4,0,4,3,1,0,8,0,0,0,0,0,0,12
3421,PUNJAB,2004,28,FAMILY PROBLEMS,2,16,24,11,2,55,1,9,11,0,0,21,0,0,0,0,0,0,76
3967,PUNJAB,2004,28,HEALTH ISSUES,0,14,15,19,15,63,0,5,4,2,0,11,0,0,0,0,0,0,74
4513,PUNJAB,2004,28,HERO WORSHIP,1,3,4,2,2,12,0,5,4,0,0,9,0,0,0,0,0,0,21
5058,PUNJAB,2004,28,ILLEGITIMATE PREGNANCY,0,0,0,0,0,0,1,0,0,0,0,1,0,0,0,0,0,0,1
5603,PUNJAB,2004,28,LOVE AFFAIRS,0,3,1,0,0,4,0,4,0,0,0,4,0,0,0,0,0,0,8
6148,PUNJAB,2004,28,MARITAL ISSUES,0,2,4,0,1,7,0,4,3,1,0,8,0,0,0,0,0,0,15
6694,PUNJAB,2004,28,MENTAL HEALTH,1,58,50,35,10,154,0,19,11,8,5,43,0,0,0,0,0,0,197
7240,PUNJAB,2004,28,OTHERS,0,8,1,0,0,9,0,0,0,0,0,0,0,0,0,0,0,0,9
7825,PUNJAB,2004,28,"PHYSICAL ABUSE (RAPE,INCEST ETC.)",0,0,0,0,0,0,0,0,0,0,0,0,0,0,0,0,0,0,0
8331,PUNJAB,2004,28,SOCIETAL ISSUES,0,2,2,0,0,4,0,0,0,0,0,0,0,0,0,0,0,0,4
184,PUNJAB,2005,28,CAUSES NOT KNOWN,0,0,20,14,10,44,0,1,2,0,0,3,0,0,0,0,0,0,47
730,PUNJAB,2005,28,DEATH OF DEAR PERSON,0,0,1,0,0,1,0,0,0,0,0,0,0,0,0,0,0,0,1
1276,PUNJAB,2005,28,DOWRY DISPUTE,0,0,0,0,0,0,0,0,4,1,0,5,0,0,0,0,0,0,5
1822,PUNJAB,2005,28,DRUG ABUSE,0,17,10,3,0,30,0,0,0,0,0,0,0,0,0,0,0,0,30
2368,PUNJAB,2005,28,ECONOMIC ISSUES,0,25,16,9,3,53,0,5,10,1,0,16,0,0,0,0,0,0,69
2914,PUNJAB,2005,28,EXAM FAILURE,0,6,0,0,0,6,0,3,0,0,1,4,0,0,0,0,0,0,10
3460,PUNJAB,2005,28,FAMILY PROBLEMS,0,15,29,18,5,67,0,12,0,4,0,16,0,0,0,0,0,0,83
4006,PUNJAB,2005,28,HEALTH ISSUES,0,8,10,9,4,31,0,4,1,2,1,8,0,0,0,0,0,0,39
4552,PUNJAB,2005,28,HERO WORSHIP,0,0,0,0,0,0,0,0,0,0,0,0,0,0,0,0,0,0,0
5097,PUNJAB,2005,28,ILLEGITIMATE PREGNANCY,0,1,0,0,0,1,0,0,0,0,0,0,0,0,0,0,0,0,1
5642,PUNJAB,2005,28,LOVE AFFAIRS,0,3,2,0,0,5,0,2,0,0,0,2,0,0,0,0,0,0,7
6187,PUNJAB,2005,28,MARITAL ISSUES,0,7,9,1,0,17,0,5,6,2,0,13,0,0,0,0,0,0,30
6733,PUNJAB,2005,28,MENTAL HEALTH,0,69,62,57,17,205,2,6,8,9,0,25,0,0,0,0,0,0,230
7279,PUNJAB,2005,28,OTHERS,0,6,3,1,0,10,0,0,2,0,0,2,0,0,0,0,0,0,12
7864,PUNJAB,2005,28,"PHYSICAL ABUSE (RAPE,INCEST ETC.)",0,0,1,0,0,1,0,0,0,0,0,0,0,0,0,0,0,0,1
8370,PUNJAB,2005,28,SOCIETAL ISSUES,0,7,4,0,0,11,0,4,7,1,0,12,0,0,0,0,0,0,23
223,PUNJAB,2006,28,CAUSES NOT KNOWN,2,37,48,26,5,118,4,13,9,1,0,27,0,0,0,0,0,0,145
769,PUNJAB,2006,28,DEATH OF DEAR PERSON,0,1,1,0,0,2,0,3,1,0,0,4,0,0,0,0,0,0,6
1315,PUNJAB,2006,28,DOWRY DISPUTE,0,0,0,0,0,0,0,1,3,2,0,6,0,0,0,0,0,0,6
1861,PUNJAB,2006,28,DRUG ABUSE,0,15,25,4,3,47,0,0,0,0,0,0,0,0,0,0,0,0,47
2407,PUNJAB,2006,28,ECONOMIC ISSUES,0,16,7,9,2,34,0,2,1,0,0,3,0,0,0,0,0,0,37
2953,PUNJAB,2006,28,EXAM FAILURE,0,5,0,0,0,5,0,7,0,0,0,7,0,0,0,0,0,0,12
3499,PUNJAB,2006,28,FAMILY PROBLEMS,3,33,25,16,7,84,5,22,13,2,1,43,0,0,0,0,0,0,127
4045,PUNJAB,2006,28,HEALTH ISSUES,1,13,16,14,4,48,0,4,4,3,0,11,0,0,0,0,0,0,59
4590,PUNJAB,2006,28,HERO WORSHIP,0,6,6,0,3,15,0,0,0,0,0,0,0,0,0,0,0,0,15
5135,PUNJAB,2006,28,ILLEGITIMATE PREGNANCY,0,0,0,0,0,0,0,3,1,2,0,6,0,0,0,0,0,0,6
5680,PUNJAB,2006,28,LOVE AFFAIRS,0,5,0,0,0,5,0,3,0,0,0,3,0,0,0,0,0,0,8
6226,PUNJAB,2006,28,MARITAL ISSUES,0,4,7,0,0,11,0,6,4,1,0,11,0,0,0,0,0,0,22
6772,PUNJAB,2006,28,MENTAL HEALTH,1,65,66,50,21,203,2,10,11,3,1,27,0,0,0,0,0,0,230
7318,PUNJAB,2006,28,OTHERS,4,13,9,5,3,34,5,4,1,1,0,11,0,0,0,0,0,0,45
7902,PUNJAB,2006,28,"PHYSICAL ABUSE (RAPE,INCEST ETC.)",0,0,0,0,0,0,0,0,0,0,0,0,0,0,0,0,0,0,0
8409,PUNJAB,2006,28,SOCIETAL ISSUES,0,3,1,0,0,4,0,1,1,1,0,3,0,0,0,0,0,0,7
262,PUNJAB,2007,28,CAUSES NOT KNOWN,2,57,55,28,15,157,1,16,3,1,1,22,0,0,0,0,0,0,179
808,PUNJAB,2007,28,DEATH OF DEAR PERSON,0,1,0,1,2,4,0,1,2,0,0,3,0,0,0,0,0,0,7
1354,PUNJAB,2007,28,DOWRY DISPUTE,0,0,0,0,0,0,0,3,3,0,0,6,0,0,0,0,0,0,6
1900,PUNJAB,2007,28,DRUG ABUSE,0,15,10,5,1,31,0,0,0,0,0,0,0,0,0,0,0,0,31
2446,PUNJAB,2007,28,ECONOMIC ISSUES,0,14,18,8,5,45,0,3,5,1,0,9,0,0,0,0,0,0,54
2992,PUNJAB,2007,28,EXAM FAILURE,0,4,0,0,0,4,1,4,0,0,0,5,0,0,0,0,0,0,9
3538,PUNJAB,2007,28,FAMILY PROBLEMS,1,32,42,16,3,94,1,33,22,5,0,61,0,0,0,0,0,0,155
4084,PUNJAB,2007,28,HEALTH ISSUES,0,17,19,7,8,51,0,5,7,4,0,16,0,0,0,0,0,0,67
4629,PUNJAB,2007,28,HERO WORSHIP,0,1,2,0,0,3,0,1,0,0,0,1,0,0,0,0,0,0,4
5174,PUNJAB,2007,28,ILLEGITIMATE PREGNANCY,0,6,2,5,1,14,0,0,0,0,0,0,0,0,0,0,0,0,14
5719,PUNJAB,2007,28,LOVE AFFAIRS,0,7,0,0,0,7,1,4,0,0,0,5,0,0,0,0,0,0,12
6265,PUNJAB,2007,28,MARITAL ISSUES,1,3,5,1,0,10,1,5,1,0,0,7,0,0,0,0,0,0,17
6811,PUNJAB,2007,28,MENTAL HEALTH,0,52,47,35,16,150,4,16,16,5,3,44,0,0,0,0,0,0,194
7357,PUNJAB,2007,28,OTHERS,0,19,9,10,7,45,3,4,2,1,0,10,0,0,0,0,0,0,55
7941,PUNJAB,2007,28,"PHYSICAL ABUSE (RAPE,INCEST ETC.)",0,0,0,0,0,0,0,1,0,0,0,1,0,0,0,0,0,0,1
8448,PUNJAB,2007,28,SOCIETAL ISSUES,1,8,7,1,0,17,1,16,8,0,0,25,0,0,0,0,0,0,42
301,PUNJAB,2008,28,CAUSES NOT KNOWN,2,37,40,26,4,109,1,8,5,3,2,19,0,0,0,0,0,0,128
847,PUNJAB,2008,28,DEATH OF DEAR PERSON,1,1,1,2,0,5,1,2,1,1,0,5,0,0,0,0,0,0,10
1393,PUNJAB,2008,28,DOWRY DISPUTE,1,0,0,0,0,1,1,9,11,1,0,22,0,0,0,0,0,0,23
1939,PUNJAB,2008,28,DRUG ABUSE,0,19,21,13,2,55,1,0,0,0,0,1,0,0,0,0,0,0,56
2485,PUNJAB,2008,28,ECONOMIC ISSUES,1,16,17,8,1,43,1,4,3,2,0,10,0,0,0,0,0,0,53
3031,PUNJAB,2008,28,EXAM FAILURE,0,5,0,0,0,5,0,7,0,0,0,7,0,0,0,0,0,0,12
3577,PUNJAB,2008,28,FAMILY PROBLEMS,2,31,47,24,12,116,2,20,22,3,2,49,0,0,0,0,0,0,165
4123,PUNJAB,2008,28,HEALTH ISSUES,0,21,41,23,13,98,0,13,12,1,3,29,0,0,0,0,0,0,127
4668,PUNJAB,2008,28,HERO WORSHIP,0,4,9,2,3,18,0,8,2,0,0,10,0,0,0,0,0,0,28
5213,PUNJAB,2008,28,ILLEGITIMATE PREGNANCY,0,0,0,0,0,0,0,0,0,0,0,0,0,0,0,0,0,0,0
5758,PUNJAB,2008,28,LOVE AFFAIRS,0,6,5,0,0,11,1,9,1,0,0,11,0,0,0,0,0,0,22
6304,PUNJAB,2008,28,MARITAL ISSUES,1,6,9,2,1,19,1,7,4,0,0,12,0,0,0,0,0,0,31
6850,PUNJAB,2008,28,MENTAL HEALTH,0,49,52,27,15,143,0,15,10,6,2,33,0,0,0,0,0,0,176
7396,PUNJAB,2008,28,OTHERS,0,0,2,1,0,3,0,1,8,0,0,9,0,0,0,0,0,0,12
7980,PUNJAB,2008,28,"PHYSICAL ABUSE (RAPE,INCEST ETC.)",0,0,0,1,0,1,0,0,1,0,0,1,0,0,0,0,0,0,2
8487,PUNJAB,2008,28,SOCIETAL ISSUES,0,9,5,1,1,16,1,3,3,1,0,8,0,0,0,0,0,0,24
340,PUNJAB,2009,28,CAUSES NOT KNOWN,1,43,40,21,16,121,0,8,4,4,1,17,0,0,0,0,0,0,138
886,PUNJAB,2009,28,DEATH OF DEAR PERSON,0,1,1,1,0,3,0,1,0,0,0,1,0,0,0,0,0,0,4
1432,PUNJAB,2009,28,DOWRY DISPUTE,0,0,0,0,0,0,1,9,5,0,2,17,0,0,0,0,0,0,17
1978,PUNJAB,2009,28,DRUG ABUSE,0,25,20,7,0,52,0,0,0,0,1,1,0,0,0,0,0,0,53
2524,PUNJAB,2009,28,ECONOMIC ISSUES,0,34,13,7,4,58,0,2,6,2,0,10,0,0,0,0,0,0,68
3070,PUNJAB,2009,28,EXAM FAILURE,0,6,0,0,0,6,0,8,0,0,0,8,0,0,0,0,0,0,14
3616,PUNJAB,2009,28,FAMILY PROBLEMS,8,25,47,21,5,106,3,35,29,8,2,77,0,0,0,0,0,0,183
4162,PUNJAB,2009,28,HEALTH ISSUES,1,32,39,22,12,106,0,13,6,4,1,24,0,0,0,0,0,0,130
4707,PUNJAB,2009,28,HERO WORSHIP,0,0,0,0,0,0,0,0,0,0,0,0,0,0,0,0,0,0,0
5252,PUNJAB,2009,28,ILLEGITIMATE PREGNANCY,0,0,0,0,0,0,0,0,0,0,0,0,0,0,0,0,0,0,0
5797,PUNJAB,2009,28,LOVE AFFAIRS,0,6,4,1,0,11,0,4,2,0,0,6,0,0,0,0,0,0,17
6343,PUNJAB,2009,28,MARITAL ISSUES,0,4,2,1,0,7,0,5,2,0,4,11,0,0,0,0,0,0,18
6889,PUNJAB,2009,28,MENTAL HEALTH,0,45,50,38,15,148,0,18,6,4,3,31,0,0,0,0,0,0,179
7435,PUNJAB,2009,28,OTHERS,1,9,2,1,0,13,1,1,1,2,1,6,0,0,0,0,0,0,19
8019,PUNJAB,2009,28,"PHYSICAL ABUSE (RAPE,INCEST ETC.)",0,0,0,0,0,0,0,1,0,0,0,1,0,0,0,0,0,0,1
8526,PUNJAB,2009,28,SOCIETAL ISSUES,0,0,2,2,0,4,0,2,0,0,0,2,0,0,0,0,0,0,6
379,PUNJAB,2010,28,CAUSES NOT KNOWN,0,38,34,33,16,121,1,3,6,4,2,16,0,0,0,0,0,0,137
925,PUNJAB,2010,28,DEATH OF DEAR PERSON,0,1,4,1,0,6,0,1,0,1,4,6,0,0,0,0,0,0,12
1471,PUNJAB,2010,28,DOWRY DISPUTE,0,0,0,0,0,0,0,14,4,0,0,18,0,0,0,0,0,0,18
2017,PUNJAB,2010,28,DRUG ABUSE,1,18,24,11,3,57,0,1,0,1,0,2,0,0,0,0,0,0,59
2563,PUNJAB,2010,28,ECONOMIC ISSUES,5,22,13,5,1,46,0,3,2,0,0,5,0,0,0,0,0,0,51
3109,PUNJAB,2010,28,EXAM FAILURE,1,4,1,0,0,6,0,7,0,0,0,7,0,0,0,0,0,0,13
3655,PUNJAB,2010,28,FAMILY PROBLEMS,1,73,65,34,15,188,1,33,26,8,3,71,0,0,0,0,0,0,259
4201,PUNJAB,2010,28,HEALTH ISSUES,0,18,31,10,9,68,0,8,4,1,0,13,0,0,0,0,0,0,81
4746,PUNJAB,2010,28,HERO WORSHIP,0,0,0,0,1,1,0,1,0,0,0,1,0,0,0,0,0,0,2
5291,PUNJAB,2010,28,ILLEGITIMATE PREGNANCY,0,0,0,0,0,0,0,0,0,0,0,0,0,0,0,0,0,0,0
5836,PUNJAB,2010,28,LOVE AFFAIRS,0,4,4,0,0,8,0,12,0,0,0,12,0,0,0,0,0,0,20
6382,PUNJAB,2010,28,MARITAL ISSUES,0,3,7,0,0,10,0,3,4,0,0,7,0,0,0,0,0,0,17
6928,PUNJAB,2010,28,MENTAL HEALTH,0,68,71,28,18,185,1,17,11,6,3,38,0,0,0,0,0,0,223
7474,PUNJAB,2010,28,OTHERS,2,9,2,2,0,15,0,1,3,0,0,4,0,0,0,0,0,0,19
8058,PUNJAB,2010,28,"PHYSICAL ABUSE (RAPE,INCEST ETC.)",0,0,0,0,0,0,0,0,0,0,0,0,0,0,0,0,0,0,0
8565,PUNJAB,2010,28,SOCIETAL ISSUES,0,1,3,3,1,8,0,0,1,0,0,1,0,0,0,0,0,0,9
418,PUNJAB,2011,28,CAUSES NOT KNOWN,0,34,41,12,5,92,0,9,4,0,0,13,0,0,0,0,0,0,105
964,PUNJAB,2011,28,DEATH OF DEAR PERSON,0,1,1,4,0,6,0,1,0,0,0,1,0,0,0,0,0,0,7
1510,PUNJAB,2011,28,DOWRY DISPUTE,0,0,0,0,0,0,0,14,8,0,0,22,0,0,0,0,0,0,22
2056,PUNJAB,2011,28,DRUG ABUSE,0,39,45,21,3,108,0,2,0,0,0,2,0,0,0,0,0,0,110
2602,PUNJAB,2011,28,ECONOMIC ISSUES,0,64,42,28,20,154,0,3,2,2,0,7,0,0,0,0,0,0,161
3148,PUNJAB,2011,28,EXAM FAILURE,0,6,0,0,0,6,0,7,0,0,0,7,0,0,0,0,0,0,13
3694,PUNJAB,2011,28,FAMILY PROBLEMS,0,32,46,16,6,100,0,22,29,2,0,53,0,0,0,0,0,0,153
4240,PUNJAB,2011,28,HEALTH ISSUES,0,7,13,11,5,36,0,4,5,4,1,14,0,0,0,0,0,0,50
4785,PUNJAB,2011,28,HERO WORSHIP,0,0,1,2,1,4,0,0,0,0,0,0,0,0,0,0,0,0,4
5330,PUNJAB,2011,28,ILLEGITIMATE PREGNANCY,0,0,0,0,0,0,0,1,0,0,0,1,0,0,0,0,0,0,1
5875,PUNJAB,2011,28,LOVE AFFAIRS,0,12,4,0,0,16,0,12,1,0,0,13,0,0,0,0,0,0,29
6421,PUNJAB,2011,28,MARITAL ISSUES,0,12,8,5,0,25,0,6,8,1,0,15,0,0,0,0,0,0,40
6967,PUNJAB,2011,28,MENTAL HEALTH,0,59,74,22,20,175,0,29,15,6,4,54,0,0,0,0,0,0,229
7513,PUNJAB,2011,28,OTHERS,0,8,16,2,5,31,0,5,1,0,0,6,0,0,0,0,0,0,37
8097,PUNJAB,2011,28,"PHYSICAL ABUSE (RAPE,INCEST ETC.)",0,0,0,0,0,0,0,1,0,0,0,1,0,0,0,0,0,0,1
8604,PUNJAB,2011,28,SOCIETAL ISSUES,0,0,0,2,0,2,0,0,2,0,0,2,0,0,0,0,0,0,4
457,PUNJAB,2012,28,CAUSES NOT KNOWN,0,54,59,26,15,154,0,5,6,1,0,12,0,0,0,0,0,0,166
1003,PUNJAB,2012,28,DEATH OF DEAR PERSON,0,2,4,2,2,10,0,0,0,1,0,1,0,0,0,0,0,0,11
1549,PUNJAB,2012,28,DOWRY DISPUTE,0,0,0,0,0,0,0,14,10,1,0,25,0,0,0,0,0,0,25
2095,PUNJAB,2012,28,DRUG ABUSE,0,34,38,11,0,83,0,3,5,0,0,8,0,0,0,0,0,0,91
2641,PUNJAB,2012,28,ECONOMIC ISSUES,0,11,19,3,4,37,0,3,2,1,0,6,0,0,0,0,0,0,43
3187,PUNJAB,2012,28,EXAM FAILURE,2,11,0,0,0,13,1,8,0,0,0,9,0,0,0,0,0,0,22
3733,PUNJAB,2012,28,FAMILY PROBLEMS,4,37,57,22,6,126,1,31,34,6,0,72,0,0,0,0,0,0,198
4279,PUNJAB,2012,28,HEALTH ISSUES,1,24,30,11,11,77,0,7,5,1,0,13,0,0,0,0,0,0,90
4824,PUNJAB,2012,28,HERO WORSHIP,0,0,0,0,0,0,0,0,0,0,0,0,0,0,0,0,0,0,0
5369,PUNJAB,2012,28,ILLEGITIMATE PREGNANCY,0,0,0,0,0,0,0,0,0,0,0,0,0,0,0,0,0,0,0
5914,PUNJAB,2012,28,LOVE AFFAIRS,0,11,1,0,0,12,0,10,6,1,0,17,0,0,0,0,0,0,29
6460,PUNJAB,2012,28,MARITAL ISSUES,0,4,2,0,0,6,0,8,8,1,0,17,0,0,0,0,0,0,23
7006,PUNJAB,2012,28,MENTAL HEALTH,0,101,77,48,14,240,0,25,21,7,2,55,0,0,0,0,0,0,295
7552,PUNJAB,2012,28,OTHERS,0,8,11,1,2,22,0,6,1,1,0,8,0,0,0,0,0,0,30
8136,PUNJAB,2012,28,"PHYSICAL ABUSE (RAPE,INCEST ETC.)",0,0,0,0,0,0,0,0,0,0,0,0,0,0,0,0,0,0,0
8643,PUNJAB,2012,28,SOCIETAL ISSUES,0,2,1,1,0,4,0,1,2,0,0,3,0,0,0,0,0,0,7
496,PUNJAB,2013,28,CAUSES NOT KNOWN,0,44,41,21,11,117,2,16,7,2,6,33,0,0,0,0,0,0,150
1042,PUNJAB,2013,28,DEATH OF DEAR PERSON,0,3,2,2,2,9,0,0,1,0,0,1,0,0,0,0,0,0,10
1588,PUNJAB,2013,28,DOWRY DISPUTE,0,0,0,0,0,0,0,10,3,0,0,13,0,0,0,0,0,0,13
2134,PUNJAB,2013,28,DRUG ABUSE,0,31,22,8,4,65,0,1,0,0,0,1,0,0,0,0,0,0,66
2680,PUNJAB,2013,28,ECONOMIC ISSUES,2,10,5,9,0,26,0,3,0,0,0,3,0,0,0,0,0,0,29
3226,PUNJAB,2013,28,EXAM FAILURE,1,18,0,0,0,19,1,10,0,0,0,11,0,0,0,0,0,0,30
3772,PUNJAB,2013,28,FAMILY PROBLEMS,1,55,48,19,5,128,1,47,22,8,1,79,0,0,0,0,0,0,207
4318,PUNJAB,2013,28,HEALTH ISSUES,0,16,16,13,8,53,1,8,3,3,1,16,0,0,0,0,0,0,69
4863,PUNJAB,2013,28,HERO WORSHIP,0,0,0,0,0,0,0,0,0,0,0,0,0,0,0,0,0,0,0
5408,PUNJAB,2013,28,ILLEGITIMATE PREGNANCY,0,0,0,0,0,0,0,1,0,0,0,1,0,0,0,0,0,0,1
5953,PUNJAB,2013,28,LOVE AFFAIRS,0,4,2,0,0,6,0,13,1,0,0,14,0,0,0,0,0,0,20
6499,PUNJAB,2013,28,MARITAL ISSUES,0,4,6,1,0,11,0,6,5,0,0,11,0,0,0,0,0,0,22
7045,PUNJAB,2013,28,MENTAL HEALTH,2,92,60,42,22,218,0,28,20,11,2,61,0,0,0,0,0,0,279
7591,PUNJAB,2013,28,OTHERS,0,14,21,16,8,59,0,4,1,3,2,10,0,0,0,0,0,0,69
8175,PUNJAB,2013,28,"PHYSICAL ABUSE (RAPE,INCEST ETC.)",0,0,0,0,0,0,1,1,0,0,0,2,0,0,0,0,0,0,2
8682,PUNJAB,2013,28,SOCIETAL ISSUES,0,1,1,0,0,2,0,3,0,0,0,3,0,0,0,0,0,0,5
535,PUNJAB,2014,28,CAUSES NOT KNOWN,0,16,12,16,1,45,0,10,3,0,0,13,0,0,0,0,0,0,58
1081,PUNJAB,2014,28,DEATH OF DEAR PERSON,0,0,0,0,2,2,0,0,0,0,0,0,0,0,0,0,0,0,2
1627,PUNJAB,2014,28,DOWRY DISPUTE,0,0,0,0,0,0,0,9,2,0,0,11,0,0,0,0,0,0,11
2173,PUNJAB,2014,28,DRUG ABUSE,0,16,17,4,1,38,0,0,0,0,0,0,0,0,0,0,0,0,38
2719,PUNJAB,2014,28,ECONOMIC ISSUES,0,10,8,2,0,20,0,2,4,2,0,8,0,0,0,0,0,0,28
3265,PUNJAB,2014,28,EXAM FAILURE,1,23,0,0,0,24,1,9,0,0,0,10,0,0,0,0,0,0,34
3811,PUNJAB,2014,28,FAMILY PROBLEMS,2,57,46,23,6,134,0,23,16,6,0,45,0,0,0,0,0,0,179
4357,PUNJAB,2014,28,HEALTH ISSUES,1,123,126,72,22,344,2,36,40,14,9,101,0,0,0,0,0,0,445
4902,PUNJAB,2014,28,HERO WORSHIP,0,0,0,0,0,0,0,0,0,0,0,0,0,0,0,0,0,0,0
5447,PUNJAB,2014,28,ILLEGITIMATE PREGNANCY,0,0,0,0,0,0,0,0,0,0,0,0,0,0,0,0,0,0,0
5992,PUNJAB,2014,28,LOVE AFFAIRS,0,9,1,0,0,10,0,10,5,0,0,15,0,0,0,0,0,0,25
6538,PUNJAB,2014,28,MARITAL ISSUES,0,23,11,1,0,35,0,32,27,0,1,60,0,0,0,0,0,0,95
7084,PUNJAB,2014,28,MENTAL HEALTH,1,79,86,28,10,204,0,24,14,6,3,47,0,0,0,0,0,0,251
7630,PUNJAB,2014,28,OTHERS,1,74,33,34,0,142,0,19,6,8,1,34,0,0,0,0,0,0,176
7669,PUNJAB,2014,28,PHYSICAL ABUSE,0,0,0,0,0,0,0,0,0,0,0,0,0,0,0,0,0,0,0
8721,PUNJAB,2014,28,SOCIETAL ISSUES,0,1,4,3,0,8,0,0,0,1,0,1,0,0,0,0,0,0,9
29,RAJASTHAN,2001,29,CAUSES NOT KNOWN,20,152,173,47,17,409,12,101,69,19,8,209,0,0,0,0,0,0,618
575,RAJASTHAN,2001,29,DEATH OF DEAR PERSON,0,3,4,3,1,11,0,0,3,1,0,4,0,0,0,0,0,0,15
1121,RAJASTHAN,2001,29,DOWRY DISPUTE,0,0,0,0,0,0,0,33,9,0,0,42,0,0,0,0,0,0,42
1667,RAJASTHAN,2001,29,DRUG ABUSE,0,25,60,32,2,119,0,0,0,0,0,0,0,0,0,0,0,0,119
2213,RAJASTHAN,2001,29,ECONOMIC ISSUES,0,80,96,35,9,220,0,14,31,2,0,47,0,0,0,0,0,0,267
2759,RAJASTHAN,2001,29,EXAM FAILURE,5,27,0,0,0,32,5,43,0,0,0,48,0,0,0,0,0,0,80
3305,RAJASTHAN,2001,29,FAMILY PROBLEMS,3,115,121,56,9,304,3,158,105,21,4,291,0,0,0,0,0,0,595
3851,RAJASTHAN,2001,29,HEALTH ISSUES,2,27,36,69,38,172,2,18,31,23,12,86,0,0,0,0,0,0,258
4397,RAJASTHAN,2001,29,HERO WORSHIP,0,0,0,0,0,0,0,0,0,0,0,0,0,0,0,0,0,0,0
4942,RAJASTHAN,2001,29,ILLEGITIMATE PREGNANCY,0,0,0,0,0,0,0,8,1,0,0,9,0,0,0,0,0,0,9
5487,RAJASTHAN,2001,29,LOVE AFFAIRS,0,26,7,0,0,33,1,29,6,1,0,37,0,0,0,0,0,0,70
6032,RAJASTHAN,2001,29,MARITAL ISSUES,0,35,17,1,0,53,0,39,14,2,0,55,0,0,0,0,0,0,108
6578,RAJASTHAN,2001,29,MENTAL HEALTH,2,59,71,41,12,185,2,25,26,18,1,72,0,0,0,0,0,0,257
7124,RAJASTHAN,2001,29,OTHERS,54,123,126,73,32,408,36,155,91,35,17,334,0,0,0,0,0,0,742
7709,RAJASTHAN,2001,29,"PHYSICAL ABUSE (RAPE,INCEST ETC.)",0,0,0,0,0,0,0,0,0,0,0,0,0,0,0,0,0,0,0
8215,RAJASTHAN,2001,29,SOCIETAL ISSUES,0,5,2,6,0,13,0,1,1,0,0,2,0,0,0,0,0,0,15
68,RAJASTHAN,2002,29,CAUSES NOT KNOWN,20,135,168,73,25,421,9,102,51,23,6,191,0,0,0,0,0,0,612
614,RAJASTHAN,2002,29,DEATH OF DEAR PERSON,0,4,4,2,0,10,0,0,2,1,0,3,0,0,0,0,0,0,13
1160,RAJASTHAN,2002,29,DOWRY DISPUTE,0,1,0,0,0,1,0,57,26,0,0,83,0,0,0,0,0,0,84
1706,RAJASTHAN,2002,29,DRUG ABUSE,1,34,50,23,2,110,0,0,0,0,0,0,0,0,0,0,0,0,110
2252,RAJASTHAN,2002,29,ECONOMIC ISSUES,0,63,69,55,5,192,0,20,32,8,0,60,0,0,0,0,0,0,252
2798,RAJASTHAN,2002,29,EXAM FAILURE,3,28,0,0,0,31,5,22,0,0,0,27,0,0,0,0,0,0,58
3344,RAJASTHAN,2002,29,FAMILY PROBLEMS,5,151,200,105,11,472,1,175,121,36,4,337,0,0,0,0,0,0,809
3890,RAJASTHAN,2002,29,HEALTH ISSUES,2,37,65,67,28,199,0,26,33,43,7,109,0,0,0,0,0,0,308
4436,RAJASTHAN,2002,29,HERO WORSHIP,0,0,0,0,0,0,0,0,0,0,0,0,0,0,0,0,0,0,0
4981,RAJASTHAN,2002,29,ILLEGITIMATE PREGNANCY,0,0,0,0,0,0,0,5,3,0,0,8,0,0,0,0,0,0,8
5526,RAJASTHAN,2002,29,LOVE AFFAIRS,0,16,6,1,0,23,1,27,9,0,0,37,0,0,0,0,0,0,60
6071,RAJASTHAN,2002,29,MARITAL ISSUES,0,39,19,4,0,62,0,37,23,0,0,60,0,0,0,0,0,0,122
6617,RAJASTHAN,2002,29,MENTAL HEALTH,4,65,80,47,17,213,2,17,32,19,3,73,0,0,0,0,0,0,286
7163,RAJASTHAN,2002,29,OTHERS,30,139,97,61,17,344,12,92,40,17,6,167,0,0,0,0,0,0,511
7748,RAJASTHAN,2002,29,"PHYSICAL ABUSE (RAPE,INCEST ETC.)",0,0,0,0,0,0,0,0,1,0,0,1,0,0,0,0,0,0,1
8254,RAJASTHAN,2002,29,SOCIETAL ISSUES,0,5,5,4,0,14,0,0,0,0,0,0,0,0,0,0,0,0,14
107,RAJASTHAN,2003,29,CAUSES NOT KNOWN,16,137,158,66,29,406,8,91,67,15,9,190,0,0,0,0,0,0,596
653,RAJASTHAN,2003,29,DEATH OF DEAR PERSON,0,4,5,1,0,10,0,3,2,0,0,5,0,0,0,0,0,0,15
1199,RAJASTHAN,2003,29,DOWRY DISPUTE,0,4,3,0,0,7,0,44,17,1,0,62,0,0,0,0,0,0,69
1745,RAJASTHAN,2003,29,DRUG ABUSE,0,41,56,39,7,143,0,0,0,0,0,0,0,0,0,0,0,0,143
2291,RAJASTHAN,2003,29,ECONOMIC ISSUES,0,63,92,60,14,229,1,17,32,7,2,59,0,0,0,0,0,0,288
2837,RAJASTHAN,2003,29,EXAM FAILURE,2,18,1,0,0,21,3,15,0,0,0,18,0,0,0,0,0,0,39
3383,RAJASTHAN,2003,29,FAMILY PROBLEMS,5,126,198,75,16,420,6,151,114,59,10,340,0,0,0,0,0,0,760
3929,RAJASTHAN,2003,29,HEALTH ISSUES,1,36,75,79,55,246,0,26,43,47,20,136,0,0,0,0,0,0,382
4475,RAJASTHAN,2003,29,HERO WORSHIP,0,0,0,0,0,0,0,0,0,0,0,0,0,0,0,0,0,0,0
5020,RAJASTHAN,2003,29,ILLEGITIMATE PREGNANCY,0,0,0,0,0,0,0,3,1,0,0,4,0,0,0,0,0,0,4
5565,RAJASTHAN,2003,29,LOVE AFFAIRS,0,27,13,2,0,42,1,33,6,2,0,42,0,0,0,0,0,0,84
6110,RAJASTHAN,2003,29,MARITAL ISSUES,0,33,16,6,0,55,0,40,20,5,0,65,0,0,0,0,0,0,120
6656,RAJASTHAN,2003,29,MENTAL HEALTH,3,72,76,46,15,212,2,33,40,15,10,100,0,0,0,0,0,0,312
7202,RAJASTHAN,2003,29,OTHERS,38,258,174,73,33,576,14,142,66,15,6,243,0,0,0,0,0,0,819
7787,RAJASTHAN,2003,29,"PHYSICAL ABUSE (RAPE,INCEST ETC.)",0,0,0,0,0,0,0,0,0,0,0,0,0,0,0,0,0,0,0
8293,RAJASTHAN,2003,29,SOCIETAL ISSUES,1,5,12,3,1,22,1,3,2,2,0,8,0,0,0,0,0,0,30
146,RAJASTHAN,2004,29,CAUSES NOT KNOWN,15,201,193,87,32,528,15,111,51,24,12,213,0,0,0,0,0,0,741
692,RAJASTHAN,2004,29,DEATH OF DEAR PERSON,0,0,3,1,0,4,0,1,1,1,0,3,0,0,0,0,0,0,7
1238,RAJASTHAN,2004,29,DOWRY DISPUTE,0,4,5,0,0,9,0,22,10,0,0,32,0,0,0,0,0,0,41
1784,RAJASTHAN,2004,29,DRUG ABUSE,0,38,53,15,2,108,0,0,0,0,0,0,0,0,0,0,0,0,108
2330,RAJASTHAN,2004,29,ECONOMIC ISSUES,0,46,70,49,5,170,0,11,13,10,3,37,0,0,0,0,0,0,207
2876,RAJASTHAN,2004,29,EXAM FAILURE,3,19,0,0,0,22,1,14,0,0,0,15,0,0,0,0,0,0,37
3422,RAJASTHAN,2004,29,FAMILY PROBLEMS,7,172,222,95,8,504,4,187,157,37,10,395,0,0,0,0,0,0,899
3968,RAJASTHAN,2004,29,HEALTH ISSUES,2,19,62,78,20,181,1,8,50,22,10,91,0,0,0,0,0,0,272
4514,RAJASTHAN,2004,29,HERO WORSHIP,0,0,0,0,0,0,0,0,0,0,0,0,0,0,0,0,0,0,0
5059,RAJASTHAN,2004,29,ILLEGITIMATE PREGNANCY,0,0,0,0,0,0,0,6,2,0,0,8,0,0,0,0,0,0,8
5604,RAJASTHAN,2004,29,LOVE AFFAIRS,4,25,13,7,0,49,1,34,8,3,0,46,0,0,0,0,0,0,95
6149,RAJASTHAN,2004,29,MARITAL ISSUES,0,45,20,5,0,70,0,32,18,3,1,54,0,0,0,0,0,0,124
6695,RAJASTHAN,2004,29,MENTAL HEALTH,3,76,91,61,20,251,0,35,36,33,4,108,0,0,0,0,0,0,359
7241,RAJASTHAN,2004,29,OTHERS,30,188,183,94,45,540,21,73,74,38,12,218,0,0,0,0,0,0,758
7826,RAJASTHAN,2004,29,"PHYSICAL ABUSE (RAPE,INCEST ETC.)",0,1,3,0,2,6,0,0,0,2,0,2,0,0,0,0,0,0,8
8332,RAJASTHAN,2004,29,SOCIETAL ISSUES,2,17,13,7,5,44,0,8,7,2,0,17,0,0,0,0,0,0,61
185,RAJASTHAN,2005,29,CAUSES NOT KNOWN,23,210,250,154,10,647,14,143,105,51,4,317,0,0,0,0,0,0,964
731,RAJASTHAN,2005,29,DEATH OF DEAR PERSON,1,1,3,1,0,6,0,8,6,0,0,14,0,0,0,0,0,0,20
1277,RAJASTHAN,2005,29,DOWRY DISPUTE,0,6,7,0,0,13,0,22,4,0,0,26,0,0,0,0,0,0,39
1823,RAJASTHAN,2005,29,DRUG ABUSE,4,41,55,25,3,128,0,0,0,0,0,0,0,0,0,0,0,0,128
2369,RAJASTHAN,2005,29,ECONOMIC ISSUES,0,31,52,27,7,117,3,4,6,1,1,15,0,0,0,0,0,0,132
2915,RAJASTHAN,2005,29,EXAM FAILURE,5,20,0,0,0,25,5,4,0,0,0,9,0,0,0,0,0,0,34
3461,RAJASTHAN,2005,29,FAMILY PROBLEMS,18,174,253,89,10,544,10,173,151,63,1,398,0,0,0,0,0,0,942
4007,RAJASTHAN,2005,29,HEALTH ISSUES,3,40,73,72,26,214,1,28,31,29,3,92,0,0,0,0,0,0,306
4553,RAJASTHAN,2005,29,HERO WORSHIP,0,0,0,0,0,0,0,0,0,0,0,0,0,0,0,0,0,0,0
5098,RAJASTHAN,2005,29,ILLEGITIMATE PREGNANCY,0,0,0,0,0,0,0,2,2,0,0,4,0,0,0,0,0,0,4
5643,RAJASTHAN,2005,29,LOVE AFFAIRS,1,22,11,0,0,34,1,24,3,0,0,28,0,0,0,0,0,0,62
6188,RAJASTHAN,2005,29,MARITAL ISSUES,2,26,12,6,0,46,0,18,10,0,0,28,0,0,0,0,0,0,74
6734,RAJASTHAN,2005,29,MENTAL HEALTH,11,83,92,48,12,246,2,37,45,20,4,108,0,0,0,0,0,0,354
7280,RAJASTHAN,2005,29,OTHERS,20,270,308,154,68,820,11,108,99,48,8,274,0,0,0,0,0,0,1094
7865,RAJASTHAN,2005,29,"PHYSICAL ABUSE (RAPE,INCEST ETC.)",0,0,1,0,0,1,0,1,0,0,0,1,0,0,0,0,0,0,2
8371,RAJASTHAN,2005,29,SOCIETAL ISSUES,0,8,8,0,1,17,3,2,1,0,0,6,0,0,0,0,0,0,23
224,RAJASTHAN,2006,29,CAUSES NOT KNOWN,7,126,119,54,6,312,9,123,46,13,1,192,0,0,0,0,0,0,504
770,RAJASTHAN,2006,29,DEATH OF DEAR PERSON,0,1,4,1,0,6,0,1,2,0,0,3,0,0,0,0,0,0,9
1316,RAJASTHAN,2006,29,DOWRY DISPUTE,0,4,12,0,0,16,0,27,13,0,0,40,0,0,0,0,0,0,56
1862,RAJASTHAN,2006,29,DRUG ABUSE,1,28,47,19,1,96,0,0,0,0,0,0,0,0,0,0,0,0,96
2408,RAJASTHAN,2006,29,ECONOMIC ISSUES,0,19,64,19,5,107,0,1,11,17,2,31,0,0,0,0,0,0,138
2954,RAJASTHAN,2006,29,EXAM FAILURE,3,20,1,0,0,24,3,20,0,0,0,23,0,0,0,0,0,0,47
3500,RAJASTHAN,2006,29,FAMILY PROBLEMS,5,186,293,114,10,608,7,143,140,29,6,325,0,0,0,0,0,0,933
4046,RAJASTHAN,2006,29,HEALTH ISSUES,0,34,79,67,40,220,0,19,36,40,9,104,0,0,0,0,0,0,324
4591,RAJASTHAN,2006,29,HERO WORSHIP,0,0,0,0,0,0,0,0,0,0,0,0,0,0,0,0,0,0,0
5136,RAJASTHAN,2006,29,ILLEGITIMATE PREGNANCY,0,0,0,0,0,0,0,0,0,0,0,0,0,0,0,0,0,0,0
5681,RAJASTHAN,2006,29,LOVE AFFAIRS,0,25,11,0,0,36,0,15,4,0,0,19,0,0,0,0,0,0,55
6227,RAJASTHAN,2006,29,MARITAL ISSUES,1,18,11,6,0,36,0,15,9,0,0,24,0,0,0,0,0,0,60
6773,RAJASTHAN,2006,29,MENTAL HEALTH,6,64,92,51,15,228,3,58,46,14,8,129,0,0,0,0,0,0,357
7319,RAJASTHAN,2006,29,OTHERS,36,384,429,292,56,1197,24,185,161,73,17,460,0,0,0,0,0,0,1657
7903,RAJASTHAN,2006,29,"PHYSICAL ABUSE (RAPE,INCEST ETC.)",0,0,0,0,0,0,0,0,0,0,0,0,0,0,0,0,0,0,0
8410,RAJASTHAN,2006,29,SOCIETAL ISSUES,0,7,10,6,1,24,0,2,1,0,0,3,0,0,0,0,0,0,27
263,RAJASTHAN,2007,29,CAUSES NOT KNOWN,3,146,110,61,7,327,3,76,32,11,1,123,0,0,0,0,0,0,450
809,RAJASTHAN,2007,29,DEATH OF DEAR PERSON,0,0,2,7,0,9,0,6,1,3,1,11,0,0,0,0,0,0,20
1355,RAJASTHAN,2007,29,DOWRY DISPUTE,0,4,4,0,0,8,0,25,12,1,0,38,0,0,0,0,0,0,46
1901,RAJASTHAN,2007,29,DRUG ABUSE,2,47,56,25,4,134,0,0,1,0,0,1,0,0,0,0,0,0,135
2447,RAJASTHAN,2007,29,ECONOMIC ISSUES,0,69,61,54,6,190,1,5,15,8,0,29,0,0,0,0,0,0,219
2993,RAJASTHAN,2007,29,EXAM FAILURE,7,21,1,0,0,29,5,15,0,0,0,20,0,0,0,0,0,0,49
3539,RAJASTHAN,2007,29,FAMILY PROBLEMS,6,201,211,83,12,513,9,159,140,29,2,339,0,0,0,0,0,0,852
4085,RAJASTHAN,2007,29,HEALTH ISSUES,3,37,49,51,26,166,1,18,19,17,9,64,0,0,0,0,0,0,230
4630,RAJASTHAN,2007,29,HERO WORSHIP,0,0,0,0,0,0,0,0,0,0,0,0,0,0,0,0,0,0,0
5175,RAJASTHAN,2007,29,ILLEGITIMATE PREGNANCY,0,0,0,0,0,0,0,0,0,0,0,0,0,0,0,0,0,0,0
5720,RAJASTHAN,2007,29,LOVE AFFAIRS,0,25,7,0,0,32,0,14,4,0,0,18,0,0,0,0,0,0,50
6266,RAJASTHAN,2007,29,MARITAL ISSUES,1,21,17,5,0,44,0,23,10,3,0,36,0,0,0,0,0,0,80
6812,RAJASTHAN,2007,29,MENTAL HEALTH,3,71,114,65,9,262,1,58,50,21,5,135,0,0,0,0,0,0,397
7358,RAJASTHAN,2007,29,OTHERS,53,416,540,348,62,1419,16,141,179,109,17,462,0,0,0,0,0,0,1881
7942,RAJASTHAN,2007,29,"PHYSICAL ABUSE (RAPE,INCEST ETC.)",0,0,0,0,0,0,0,0,0,0,0,0,0,0,0,0,0,0,0
8449,RAJASTHAN,2007,29,SOCIETAL ISSUES,0,5,9,6,1,21,0,4,3,0,0,7,0,0,0,0,0,0,28
302,RAJASTHAN,2008,29,CAUSES NOT KNOWN,28,286,341,135,36,826,11,129,101,37,19,297,0,0,0,0,0,0,1123
848,RAJASTHAN,2008,29,DEATH OF DEAR PERSON,0,4,0,2,1,7,0,2,2,3,1,8,0,0,0,0,0,0,15
1394,RAJASTHAN,2008,29,DOWRY DISPUTE,0,6,5,2,0,13,1,34,12,4,0,51,0,0,0,0,0,0,64
1940,RAJASTHAN,2008,29,DRUG ABUSE,5,34,73,38,11,161,0,2,2,2,0,6,0,0,0,0,0,0,167
2486,RAJASTHAN,2008,29,ECONOMIC ISSUES,6,46,74,33,16,175,0,9,9,3,1,22,0,0,0,0,0,0,197
3032,RAJASTHAN,2008,29,EXAM FAILURE,0,13,3,0,0,16,2,13,3,0,0,18,0,0,0,0,0,0,34
3578,RAJASTHAN,2008,29,FAMILY PROBLEMS,9,226,293,120,10,658,15,155,157,56,3,386,0,0,0,0,0,0,1044
4124,RAJASTHAN,2008,29,HEALTH ISSUES,7,39,103,104,24,277,2,31,24,21,12,90,0,0,0,0,0,0,367
4669,RAJASTHAN,2008,29,HERO WORSHIP,0,0,0,0,0,0,0,0,0,0,0,0,0,0,0,0,0,0,0
5214,RAJASTHAN,2008,29,ILLEGITIMATE PREGNANCY,0,0,0,0,0,0,0,0,0,0,0,0,0,0,0,0,0,0,0
5759,RAJASTHAN,2008,29,LOVE AFFAIRS,0,36,7,0,0,43,0,26,9,16,0,51,0,0,0,0,0,0,94
6305,RAJASTHAN,2008,29,MARITAL ISSUES,1,21,21,6,0,49,0,16,10,1,0,27,0,0,0,0,0,0,76
6851,RAJASTHAN,2008,29,MENTAL HEALTH,4,87,133,77,28,329,1,50,51,16,11,129,0,0,0,0,0,0,458
7397,RAJASTHAN,2008,29,OTHERS,58,360,351,225,31,1025,36,182,163,70,12,463,0,0,0,0,0,0,1488
7981,RAJASTHAN,2008,29,"PHYSICAL ABUSE (RAPE,INCEST ETC.)",0,0,0,0,0,0,0,5,2,0,0,7,0,0,0,0,0,0,7
8488,RAJASTHAN,2008,29,SOCIETAL ISSUES,0,4,11,6,2,23,0,4,4,1,0,9,0,0,0,0,0,0,32
341,RAJASTHAN,2009,29,CAUSES NOT KNOWN,23,179,185,81,21,489,13,109,71,30,8,231,0,0,0,0,0,0,720
887,RAJASTHAN,2009,29,DEATH OF DEAR PERSON,0,2,4,0,1,7,0,5,3,2,1,11,0,0,0,0,0,0,18
1433,RAJASTHAN,2009,29,DOWRY DISPUTE,0,3,1,2,0,6,0,28,7,2,0,37,0,0,0,0,0,0,43
1979,RAJASTHAN,2009,29,DRUG ABUSE,2,39,60,23,4,128,0,1,1,0,0,2,0,0,0,0,0,0,130
2525,RAJASTHAN,2009,29,ECONOMIC ISSUES,0,39,100,59,21,219,0,16,11,6,1,34,0,0,0,0,0,0,253
3071,RAJASTHAN,2009,29,EXAM FAILURE,5,13,0,0,0,18,2,10,1,0,0,13,0,0,0,0,0,0,31
3617,RAJASTHAN,2009,29,FAMILY PROBLEMS,8,272,329,140,31,780,12,194,176,50,3,435,0,0,0,0,0,0,1215
4163,RAJASTHAN,2009,29,HEALTH ISSUES,5,49,89,108,42,293,4,22,30,17,13,86,0,0,0,0,0,0,379
4708,RAJASTHAN,2009,29,HERO WORSHIP,0,1,0,0,0,1,0,1,0,0,0,1,0,0,0,0,0,0,2
5253,RAJASTHAN,2009,29,ILLEGITIMATE PREGNANCY,0,0,0,0,0,0,0,0,0,0,0,0,0,0,0,0,0,0,0
5798,RAJASTHAN,2009,29,LOVE AFFAIRS,0,40,10,1,0,51,1,39,18,0,0,58,0,0,0,0,0,0,109
6344,RAJASTHAN,2009,29,MARITAL ISSUES,1,29,40,12,1,83,0,32,2,0,0,34,0,0,0,0,0,0,117
6890,RAJASTHAN,2009,29,MENTAL HEALTH,7,108,113,62,23,313,3,53,47,16,10,129,0,0,0,0,0,0,442
7436,RAJASTHAN,2009,29,OTHERS,46,386,404,231,40,1107,27,195,178,70,5,475,0,0,0,0,0,0,1582
8020,RAJASTHAN,2009,29,"PHYSICAL ABUSE (RAPE,INCEST ETC.)",2,0,0,0,1,3,0,1,0,0,0,1,0,0,0,0,0,0,4
8527,RAJASTHAN,2009,29,SOCIETAL ISSUES,0,0,7,6,0,13,0,4,3,0,0,7,0,0,0,0,0,0,20
380,RAJASTHAN,2010,29,CAUSES NOT KNOWN,14,161,201,87,16,479,11,94,59,16,7,187,0,0,0,0,0,0,666
926,RAJASTHAN,2010,29,DEATH OF DEAR PERSON,0,2,12,19,0,33,0,6,7,5,0,18,0,0,0,0,0,0,51
1472,RAJASTHAN,2010,29,DOWRY DISPUTE,1,2,1,2,0,6,2,32,6,0,0,40,0,0,0,0,0,0,46
2018,RAJASTHAN,2010,29,DRUG ABUSE,0,47,60,35,6,148,0,1,0,1,0,2,0,0,0,0,0,0,150
2564,RAJASTHAN,2010,29,ECONOMIC ISSUES,0,29,99,39,19,186,0,12,9,5,0,26,0,0,0,0,0,0,212
3110,RAJASTHAN,2010,29,EXAM FAILURE,0,39,0,0,0,39,0,17,0,0,0,17,0,0,0,0,0,0,56
3656,RAJASTHAN,2010,29,FAMILY PROBLEMS,6,276,242,85,30,639,14,232,126,42,4,418,0,0,0,0,0,0,1057
4202,RAJASTHAN,2010,29,HEALTH ISSUES,0,22,49,45,23,139,0,15,31,17,3,66,0,0,0,0,0,0,205
4747,RAJASTHAN,2010,29,HERO WORSHIP,0,0,0,0,0,0,0,1,0,0,0,1,0,0,0,0,0,0,1
5292,RAJASTHAN,2010,29,ILLEGITIMATE PREGNANCY,0,0,0,0,0,0,0,0,0,0,0,0,0,0,0,0,0,0,0
5837,RAJASTHAN,2010,29,LOVE AFFAIRS,0,45,27,0,0,72,0,38,13,8,0,59,0,0,0,0,0,0,131
6383,RAJASTHAN,2010,29,MARITAL ISSUES,0,24,18,3,0,45,1,34,14,1,1,51,0,0,0,0,0,0,96
6929,RAJASTHAN,2010,29,MENTAL HEALTH,10,133,177,84,34,438,3,69,58,27,6,163,0,0,0,0,0,0,601
7475,RAJASTHAN,2010,29,OTHERS,59,312,397,334,27,1129,36,145,205,99,14,499,0,0,0,0,0,0,1628
8059,RAJASTHAN,2010,29,"PHYSICAL ABUSE (RAPE,INCEST ETC.)",0,0,0,0,0,0,0,3,0,0,0,3,0,0,0,0,0,0,3
8566,RAJASTHAN,2010,29,SOCIETAL ISSUES,0,1,5,5,1,12,0,2,2,0,1,5,0,0,0,0,0,0,17
419,RAJASTHAN,2011,29,CAUSES NOT KNOWN,12,190,179,80,12,473,4,98,62,25,14,203,0,0,0,0,0,0,676
965,RAJASTHAN,2011,29,DEATH OF DEAR PERSON,0,4,3,4,0,11,0,1,6,1,0,8,0,0,0,0,0,0,19
1511,RAJASTHAN,2011,29,DOWRY DISPUTE,0,2,3,0,0,5,0,20,9,0,0,29,0,0,0,0,0,0,34
2057,RAJASTHAN,2011,29,DRUG ABUSE,0,47,69,30,3,149,0,1,0,1,0,2,0,0,0,0,0,0,151
2603,RAJASTHAN,2011,29,ECONOMIC ISSUES,0,33,99,56,5,193,0,12,8,4,0,24,0,0,0,0,0,0,217
3149,RAJASTHAN,2011,29,EXAM FAILURE,1,50,1,1,0,53,1,11,2,0,0,14,0,0,0,0,0,0,67
3695,RAJASTHAN,2011,29,FAMILY PROBLEMS,9,254,244,116,21,644,13,201,159,54,11,438,0,0,0,0,0,0,1082
4241,RAJASTHAN,2011,29,HEALTH ISSUES,1,23,47,55,12,138,0,19,32,14,8,73,0,0,0,0,0,0,211
4786,RAJASTHAN,2011,29,HERO WORSHIP,0,0,1,0,0,1,0,0,0,0,0,0,0,0,0,0,0,0,1
5331,RAJASTHAN,2011,29,ILLEGITIMATE PREGNANCY,0,0,0,0,0,0,0,0,0,0,0,0,0,0,0,0,0,0,0
5876,RAJASTHAN,2011,29,LOVE AFFAIRS,0,54,13,5,0,72,0,44,5,0,0,49,0,0,0,0,0,0,121
6422,RAJASTHAN,2011,29,MARITAL ISSUES,1,36,31,7,3,78,0,32,12,4,0,48,0,0,0,0,0,0,126
6968,RAJASTHAN,2011,29,MENTAL HEALTH,5,113,136,88,17,359,1,71,48,22,7,149,0,0,0,0,0,0,508
7514,RAJASTHAN,2011,29,OTHERS,34,343,225,191,36,829,8,126,119,35,4,292,0,0,0,0,0,0,1121
8098,RAJASTHAN,2011,29,"PHYSICAL ABUSE (RAPE,INCEST ETC.)",0,0,0,0,0,0,0,0,0,0,1,1,0,0,0,0,0,0,1
8605,RAJASTHAN,2011,29,SOCIETAL ISSUES,0,0,5,6,0,11,0,1,1,0,0,2,0,0,0,0,0,0,13
458,RAJASTHAN,2012,29,CAUSES NOT KNOWN,14,177,176,85,18,470,10,93,57,25,8,193,0,0,0,0,0,0,663
1004,RAJASTHAN,2012,29,DEATH OF DEAR PERSON,0,1,0,1,0,2,0,5,4,1,0,10,0,0,0,0,0,0,12
1550,RAJASTHAN,2012,29,DOWRY DISPUTE,0,2,0,0,0,2,1,34,14,0,0,49,0,0,0,0,0,0,51
2096,RAJASTHAN,2012,29,DRUG ABUSE,0,32,68,42,10,152,0,0,0,0,0,0,0,0,0,0,0,0,152
2642,RAJASTHAN,2012,29,ECONOMIC ISSUES,0,31,103,52,6,192,0,15,7,3,0,25,0,0,0,0,0,0,217
3188,RAJASTHAN,2012,29,EXAM FAILURE,0,42,0,0,0,42,2,29,1,0,0,32,0,0,0,0,0,0,74
3734,RAJASTHAN,2012,29,FAMILY PROBLEMS,9,258,273,182,36,758,6,205,190,68,15,484,0,0,0,0,0,0,1242
4280,RAJASTHAN,2012,29,HEALTH ISSUES,5,23,54,37,18,137,0,19,31,12,10,72,0,0,0,0,0,0,209
4825,RAJASTHAN,2012,29,HERO WORSHIP,0,0,0,2,0,2,0,1,2,0,0,3,0,0,0,0,0,0,5
5370,RAJASTHAN,2012,29,ILLEGITIMATE PREGNANCY,0,0,0,0,0,0,0,0,0,0,0,0,0,0,0,0,0,0,0
5915,RAJASTHAN,2012,29,LOVE AFFAIRS,0,53,16,6,0,75,3,77,20,3,0,103,0,0,0,0,0,0,178
6461,RAJASTHAN,2012,29,MARITAL ISSUES,0,28,27,3,0,58,0,26,21,1,0,48,0,0,0,0,0,0,106
7007,RAJASTHAN,2012,29,MENTAL HEALTH,2,79,121,65,14,281,3,79,52,23,13,170,0,0,0,0,0,0,451
7553,RAJASTHAN,2012,29,OTHERS,38,356,317,282,50,1043,15,157,159,55,13,399,0,0,0,0,0,0,1442
8137,RAJASTHAN,2012,29,"PHYSICAL ABUSE (RAPE,INCEST ETC.)",0,0,0,0,0,0,0,0,0,0,0,0,0,0,0,0,0,0,0
8644,RAJASTHAN,2012,29,SOCIETAL ISSUES,0,4,5,2,2,13,0,1,4,0,1,6,0,0,0,0,0,0,19
497,RAJASTHAN,2013,29,CAUSES NOT KNOWN,12,243,198,86,24,563,7,110,55,17,12,201,0,0,0,0,0,0,764
1043,RAJASTHAN,2013,29,DEATH OF DEAR PERSON,0,1,1,2,0,4,1,0,0,2,1,4,0,0,0,0,0,0,8
1589,RAJASTHAN,2013,29,DOWRY DISPUTE,0,0,0,0,0,0,0,25,11,0,0,36,0,0,0,0,0,0,36
2135,RAJASTHAN,2013,29,DRUG ABUSE,0,40,57,39,8,144,0,0,0,0,0,0,0,0,0,0,0,0,144
2681,RAJASTHAN,2013,29,ECONOMIC ISSUES,0,21,92,38,3,154,0,12,12,3,0,27,0,0,0,0,0,0,181
3227,RAJASTHAN,2013,29,EXAM FAILURE,1,39,0,0,0,40,1,27,0,0,0,28,0,0,0,0,0,0,68
3773,RAJASTHAN,2013,29,FAMILY PROBLEMS,5,246,325,157,29,762,2,180,175,66,17,440,0,0,0,0,0,0,1202
4319,RAJASTHAN,2013,29,HEALTH ISSUES,1,15,41,40,11,108,1,15,12,9,4,41,0,0,0,0,0,0,149
4864,RAJASTHAN,2013,29,HERO WORSHIP,0,0,0,0,0,0,0,1,0,0,0,1,0,0,0,0,0,0,1
5409,RAJASTHAN,2013,29,ILLEGITIMATE PREGNANCY,0,0,0,0,0,0,0,0,0,0,0,0,0,0,0,0,0,0,0
5954,RAJASTHAN,2013,29,LOVE AFFAIRS,0,65,20,3,0,88,1,55,18,15,1,90,0,0,0,0,0,0,178
6500,RAJASTHAN,2013,29,MARITAL ISSUES,0,24,17,5,0,46,0,27,8,0,0,35,0,0,0,0,0,0,81
7046,RAJASTHAN,2013,29,MENTAL HEALTH,5,107,118,71,26,327,3,56,46,28,14,147,0,0,0,0,0,0,474
7592,RAJASTHAN,2013,29,OTHERS,23,297,393,321,50,1084,11,94,166,122,13,406,0,0,0,0,0,0,1490
8176,RAJASTHAN,2013,29,"PHYSICAL ABUSE (RAPE,INCEST ETC.)",0,0,0,0,0,0,0,1,0,0,0,1,0,0,0,0,0,0,1
8683,RAJASTHAN,2013,29,SOCIETAL ISSUES,0,16,29,12,0,57,0,9,11,6,0,26,0,0,0,0,0,0,83
536,RAJASTHAN,2014,29,CAUSES NOT KNOWN,5,169,153,66,18,411,4,72,45,16,3,140,0,0,0,0,0,0,551
1082,RAJASTHAN,2014,29,DEATH OF DEAR PERSON,0,2,2,0,1,5,0,2,0,0,0,2,0,0,0,0,0,0,7
1628,RAJASTHAN,2014,29,DOWRY DISPUTE,0,3,3,0,0,6,0,13,4,0,0,17,0,0,0,0,0,0,23
2174,RAJASTHAN,2014,29,DRUG ABUSE,0,27,18,12,4,61,0,1,1,0,0,2,0,0,0,0,0,0,63
2720,RAJASTHAN,2014,29,ECONOMIC ISSUES,0,36,37,16,4,93,0,2,2,1,0,5,0,0,0,0,0,0,98
3266,RAJASTHAN,2014,29,EXAM FAILURE,0,58,0,0,0,58,1,25,0,0,0,26,0,0,0,0,0,0,84
3812,RAJASTHAN,2014,29,FAMILY PROBLEMS,3,192,189,57,16,457,2,133,57,14,3,209,0,0,0,0,0,0,666
4358,RAJASTHAN,2014,29,HEALTH ISSUES,3,127,171,136,55,492,1,41,51,46,19,158,0,0,0,0,0,0,650
4903,RAJASTHAN,2014,29,HERO WORSHIP,0,0,0,0,0,0,0,1,0,0,0,1,0,0,0,0,0,0,1
5448,RAJASTHAN,2014,29,ILLEGITIMATE PREGNANCY,0,0,0,0,0,0,0,0,0,0,0,0,0,0,0,0,0,0,0
5993,RAJASTHAN,2014,29,LOVE AFFAIRS,0,54,7,1,0,62,1,39,5,0,0,45,0,0,0,0,0,0,107
6539,RAJASTHAN,2014,29,MARITAL ISSUES,0,51,22,4,1,78,0,40,23,3,1,67,0,0,0,0,0,0,145
7085,RAJASTHAN,2014,29,MENTAL HEALTH,1,73,69,60,15,218,1,33,35,22,7,98,0,0,0,0,0,0,316
7631,RAJASTHAN,2014,29,OTHERS,32,741,577,281,62,1693,26,320,224,45,10,625,0,0,0,0,0,0,2318
7670,RAJASTHAN,2014,29,PHYSICAL ABUSE,0,0,0,0,0,0,0,1,0,0,0,1,0,0,0,0,0,0,1
8722,RAJASTHAN,2014,29,SOCIETAL ISSUES,0,0,1,1,1,3,0,2,0,0,0,2,0,0,0,0,0,0,5
30,SIKKIM,2001,30,CAUSES NOT KNOWN,0,16,12,2,1,31,1,6,4,0,0,11,0,0,0,0,0,0,42
576,SIKKIM,2001,30,DEATH OF DEAR PERSON,0,0,0,0,0,0,0,0,0,0,0,0,0,0,0,0,0,0,0
1122,SIKKIM,2001,30,DOWRY DISPUTE,0,0,0,0,0,0,0,0,0,0,0,0,0,0,0,0,0,0,0
1668,SIKKIM,2001,30,DRUG ABUSE,0,1,0,0,0,1,0,0,0,0,0,0,0,0,0,0,0,0,1
2214,SIKKIM,2001,30,ECONOMIC ISSUES,0,1,2,0,0,3,0,0,0,0,0,0,0,0,0,0,0,0,3
2760,SIKKIM,2001,30,EXAM FAILURE,0,0,0,0,0,0,0,1,0,0,0,1,0,0,0,0,0,0,1
3306,SIKKIM,2001,30,FAMILY PROBLEMS,0,4,5,1,2,12,0,3,7,0,0,10,0,0,0,0,0,0,22
3852,SIKKIM,2001,30,HEALTH ISSUES,0,0,3,0,0,3,0,1,1,0,0,2,0,0,0,0,0,0,5
4398,SIKKIM,2001,30,HERO WORSHIP,0,0,1,1,0,2,0,0,0,0,0,0,0,0,0,0,0,0,2
4943,SIKKIM,2001,30,ILLEGITIMATE PREGNANCY,0,0,0,0,0,0,0,0,0,0,0,0,0,0,0,0,0,0,0
5488,SIKKIM,2001,30,LOVE AFFAIRS,0,1,0,0,0,1,0,2,1,0,0,3,0,0,0,0,0,0,4
6033,SIKKIM,2001,30,MARITAL ISSUES,0,1,0,0,0,1,0,0,0,0,0,0,0,0,0,0,0,0,1
6579,SIKKIM,2001,30,MENTAL HEALTH,0,1,3,1,0,5,0,1,3,0,0,4,0,0,0,0,0,0,9
7125,SIKKIM,2001,30,OTHERS,0,2,0,0,0,2,1,0,0,0,0,1,0,0,0,0,0,0,3
7710,SIKKIM,2001,30,"PHYSICAL ABUSE (RAPE,INCEST ETC.)",0,0,1,0,0,1,0,0,0,0,0,0,0,0,0,0,0,0,1
8216,SIKKIM,2001,30,SOCIETAL ISSUES,0,0,0,0,0,0,0,0,0,0,0,0,0,0,0,0,0,0,0
69,SIKKIM,2002,30,CAUSES NOT KNOWN,2,2,4,1,1,10,0,3,0,0,0,3,0,0,0,0,0,0,13
615,SIKKIM,2002,30,DEATH OF DEAR PERSON,0,0,0,0,0,0,0,0,0,0,0,0,0,0,0,0,0,0,0
1161,SIKKIM,2002,30,DOWRY DISPUTE,0,0,0,0,0,0,0,0,0,0,0,0,0,0,0,0,0,0,0
1707,SIKKIM,2002,30,DRUG ABUSE,0,1,0,1,0,2,0,0,0,0,0,0,0,0,0,0,0,0,2
2253,SIKKIM,2002,30,ECONOMIC ISSUES,0,0,4,2,0,6,0,0,0,0,0,0,0,0,0,0,0,0,6
2799,SIKKIM,2002,30,EXAM FAILURE,0,1,0,0,0,1,0,2,0,0,0,2,0,0,0,0,0,0,3
3345,SIKKIM,2002,30,FAMILY PROBLEMS,1,1,5,2,1,10,0,2,1,2,0,5,0,0,0,0,0,0,15
3891,SIKKIM,2002,30,HEALTH ISSUES,0,0,1,1,2,4,0,0,0,1,0,1,0,0,0,0,0,0,5
4437,SIKKIM,2002,30,HERO WORSHIP,0,0,0,0,0,0,0,0,0,0,0,0,0,0,0,0,0,0,0
4982,SIKKIM,2002,30,ILLEGITIMATE PREGNANCY,0,0,0,0,0,0,0,0,0,0,0,0,0,0,0,0,0,0,0
5527,SIKKIM,2002,30,LOVE AFFAIRS,0,1,0,0,0,1,0,1,0,0,0,1,0,0,0,0,0,0,2
6072,SIKKIM,2002,30,MARITAL ISSUES,0,1,0,0,0,1,0,0,0,0,0,0,0,0,0,0,0,0,1
6618,SIKKIM,2002,30,MENTAL HEALTH,0,4,3,2,1,10,1,3,4,2,2,12,0,0,0,0,0,0,22
7164,SIKKIM,2002,30,OTHERS,0,3,1,1,1,6,0,0,0,0,0,0,0,0,0,0,0,0,6
7749,SIKKIM,2002,30,"PHYSICAL ABUSE (RAPE,INCEST ETC.)",0,1,0,1,0,2,0,0,0,0,0,0,0,0,0,0,0,0,2
8255,SIKKIM,2002,30,SOCIETAL ISSUES,0,0,1,0,0,1,0,0,0,0,0,0,0,0,0,0,0,0,1
108,SIKKIM,2003,30,CAUSES NOT KNOWN,0,6,6,7,12,31,0,4,4,10,9,27,0,0,0,0,0,0,58
654,SIKKIM,2003,30,DEATH OF DEAR PERSON,0,0,0,1,0,1,0,0,0,0,0,0,0,0,0,0,0,0,1
1200,SIKKIM,2003,30,DOWRY DISPUTE,0,0,0,0,0,0,0,0,0,0,0,0,0,0,0,0,0,0,0
1746,SIKKIM,2003,30,DRUG ABUSE,0,2,4,5,0,11,0,0,0,0,0,0,0,0,0,0,0,0,11
2292,SIKKIM,2003,30,ECONOMIC ISSUES,0,0,0,0,0,0,0,0,0,0,0,0,0,0,0,0,0,0,0
2838,SIKKIM,2003,30,EXAM FAILURE,0,0,0,0,0,0,0,0,0,0,0,0,0,0,0,0,0,0,0
3384,SIKKIM,2003,30,FAMILY PROBLEMS,0,9,2,0,0,11,0,1,2,1,0,4,0,0,0,0,0,0,15
3930,SIKKIM,2003,30,HEALTH ISSUES,1,4,0,0,0,5,0,2,0,0,0,2,0,0,0,0,0,0,7
4476,SIKKIM,2003,30,HERO WORSHIP,0,0,0,0,0,0,0,0,0,0,0,0,0,0,0,0,0,0,0
5021,SIKKIM,2003,30,ILLEGITIMATE PREGNANCY,0,0,0,0,0,0,0,0,0,0,0,0,0,0,0,0,0,0,0
5566,SIKKIM,2003,30,LOVE AFFAIRS,0,0,0,0,0,0,0,0,0,0,0,0,0,0,0,0,0,0,0
6111,SIKKIM,2003,30,MARITAL ISSUES,0,0,0,0,0,0,0,1,0,0,0,1,0,0,0,0,0,0,1
6657,SIKKIM,2003,30,MENTAL HEALTH,0,4,4,1,0,9,0,1,2,0,0,3,0,0,0,0,0,0,12
7203,SIKKIM,2003,30,OTHERS,0,0,0,0,0,0,0,0,0,0,0,0,0,0,0,0,0,0,0
7788,SIKKIM,2003,30,"PHYSICAL ABUSE (RAPE,INCEST ETC.)",0,0,0,0,0,0,0,0,0,0,0,0,0,0,0,0,0,0,0
8294,SIKKIM,2003,30,SOCIETAL ISSUES,0,0,0,0,0,0,0,0,0,0,0,0,0,0,0,0,0,0,0
147,SIKKIM,2004,30,CAUSES NOT KNOWN,0,0,5,2,4,11,0,0,0,2,0,2,0,0,0,0,0,0,13
693,SIKKIM,2004,30,DEATH OF DEAR PERSON,0,0,0,0,0,0,0,0,0,0,0,0,0,0,0,0,0,0,0
1239,SIKKIM,2004,30,DOWRY DISPUTE,0,0,0,0,0,0,0,0,0,0,0,0,0,0,0,0,0,0,0
1785,SIKKIM,2004,30,DRUG ABUSE,0,0,2,3,0,5,0,0,0,0,0,0,0,0,0,0,0,0,5
2331,SIKKIM,2004,30,ECONOMIC ISSUES,0,0,0,0,0,0,0,0,0,0,0,0,0,0,0,0,0,0,0
2877,SIKKIM,2004,30,EXAM FAILURE,0,0,0,0,0,0,0,0,0,0,0,0,0,0,0,0,0,0,0
3423,SIKKIM,2004,30,FAMILY PROBLEMS,0,0,3,2,2,7,0,0,5,8,9,22,0,0,0,0,0,0,29
3969,SIKKIM,2004,30,HEALTH ISSUES,0,0,0,0,16,16,0,0,0,0,5,5,0,0,0,0,0,0,21
4515,SIKKIM,2004,30,HERO WORSHIP,0,0,0,0,0,0,0,0,0,0,0,0,0,0,0,0,0,0,0
5060,SIKKIM,2004,30,ILLEGITIMATE PREGNANCY,0,0,0,0,0,0,0,0,0,0,0,0,0,0,0,0,0,0,0
5605,SIKKIM,2004,30,LOVE AFFAIRS,0,0,0,0,0,0,0,0,0,0,0,0,0,0,0,0,0,0,0
6150,SIKKIM,2004,30,MARITAL ISSUES,0,0,0,0,0,0,0,0,1,0,0,1,0,0,0,0,0,0,1
6696,SIKKIM,2004,30,MENTAL HEALTH,0,0,7,6,4,17,0,0,3,5,4,12,0,0,0,0,0,0,29
7242,SIKKIM,2004,30,OTHERS,0,0,0,0,0,0,0,0,0,0,0,0,0,0,0,0,0,0,0
7827,SIKKIM,2004,30,"PHYSICAL ABUSE (RAPE,INCEST ETC.)",0,0,0,0,0,0,0,0,0,0,0,0,0,0,0,0,0,0,0
8333,SIKKIM,2004,30,SOCIETAL ISSUES,0,0,0,0,0,0,0,0,0,0,0,0,0,0,0,0,0,0,0
186,SIKKIM,2005,30,CAUSES NOT KNOWN,0,5,3,0,0,8,1,2,4,0,0,7,0,0,0,0,0,0,15
732,SIKKIM,2005,30,DEATH OF DEAR PERSON,0,0,0,0,0,0,0,0,0,0,0,0,0,0,0,0,0,0,0
1278,SIKKIM,2005,30,DOWRY DISPUTE,0,0,0,0,0,0,0,0,0,0,0,0,0,0,0,0,0,0,0
1824,SIKKIM,2005,30,DRUG ABUSE,0,4,1,0,0,5,0,0,0,0,0,0,0,0,0,0,0,0,5
2370,SIKKIM,2005,30,ECONOMIC ISSUES,0,0,1,0,0,1,0,0,0,0,0,0,0,0,0,0,0,0,1
2916,SIKKIM,2005,30,EXAM FAILURE,0,0,0,0,0,0,1,0,0,0,0,1,0,0,0,0,0,0,1
3462,SIKKIM,2005,30,FAMILY PROBLEMS,1,4,3,3,3,14,0,6,3,1,1,11,0,0,0,0,0,0,25
4008,SIKKIM,2005,30,HEALTH ISSUES,0,0,0,3,1,4,0,0,3,0,1,4,0,0,0,0,0,0,8
4554,SIKKIM,2005,30,HERO WORSHIP,0,0,0,0,0,0,0,0,0,0,0,0,0,0,0,0,0,0,0
5099,SIKKIM,2005,30,ILLEGITIMATE PREGNANCY,0,0,0,0,0,0,0,0,0,0,0,0,0,0,0,0,0,0,0
5644,SIKKIM,2005,30,LOVE AFFAIRS,0,2,0,0,0,2,0,1,0,0,0,1,0,0,0,0,0,0,3
6189,SIKKIM,2005,30,MARITAL ISSUES,0,0,0,0,0,0,0,0,0,0,0,0,0,0,0,0,0,0,0
6735,SIKKIM,2005,30,MENTAL HEALTH,1,3,0,0,0,4,0,0,1,1,3,5,0,0,0,0,0,0,9
7281,SIKKIM,2005,30,OTHERS,0,7,9,7,0,23,0,4,7,3,0,14,0,0,0,0,0,0,37
7866,SIKKIM,2005,30,"PHYSICAL ABUSE (RAPE,INCEST ETC.)",0,0,0,0,0,0,0,0,0,0,0,0,0,0,0,0,0,0,0
8372,SIKKIM,2005,30,SOCIETAL ISSUES,0,1,0,0,0,1,0,1,1,2,0,4,0,0,0,0,0,0,5
225,SIKKIM,2006,30,CAUSES NOT KNOWN,1,10,5,2,0,18,1,3,0,0,0,4,0,0,0,0,0,0,22
771,SIKKIM,2006,30,DEATH OF DEAR PERSON,0,0,0,0,0,0,0,0,0,0,0,0,0,0,0,0,0,0,0
1317,SIKKIM,2006,30,DOWRY DISPUTE,0,0,0,0,0,0,0,0,0,0,0,0,0,0,0,0,0,0,0
1863,SIKKIM,2006,30,DRUG ABUSE,0,1,2,0,0,3,0,0,0,0,1,1,0,0,0,0,0,0,4
2409,SIKKIM,2006,30,ECONOMIC ISSUES,0,0,0,0,0,0,0,0,0,0,0,0,0,0,0,0,0,0,0
2955,SIKKIM,2006,30,EXAM FAILURE,0,0,0,0,0,0,0,0,0,0,0,0,0,0,0,0,0,0,0
3501,SIKKIM,2006,30,FAMILY PROBLEMS,0,0,0,0,0,0,0,0,0,0,0,0,0,0,0,0,0,0,0
4047,SIKKIM,2006,30,HEALTH ISSUES,0,0,0,0,0,0,0,0,0,0,0,0,0,0,0,0,0,0,0
4592,SIKKIM,2006,30,HERO WORSHIP,0,0,0,0,0,0,0,0,0,0,0,0,0,0,0,0,0,0,0
5137,SIKKIM,2006,30,ILLEGITIMATE PREGNANCY,0,0,0,0,0,0,0,0,0,0,0,0,0,0,0,0,0,0,0
5682,SIKKIM,2006,30,LOVE AFFAIRS,0,0,0,0,0,0,0,0,0,0,0,0,0,0,0,0,0,0,0
6228,SIKKIM,2006,30,MARITAL ISSUES,0,0,0,0,0,0,0,0,0,0,0,0,0,0,0,0,0,0,0
6774,SIKKIM,2006,30,MENTAL HEALTH,3,34,22,12,0,71,2,22,13,1,3,41,0,0,0,0,0,0,112
7320,SIKKIM,2006,30,OTHERS,0,4,2,0,0,6,0,1,0,0,0,1,0,0,0,0,0,0,7
7904,SIKKIM,2006,30,"PHYSICAL ABUSE (RAPE,INCEST ETC.)",0,0,0,0,0,0,0,0,0,0,0,0,0,0,0,0,0,0,0
8411,SIKKIM,2006,30,SOCIETAL ISSUES,0,0,0,0,0,0,0,0,0,0,0,0,0,0,0,0,0,0,0
264,SIKKIM,2007,30,CAUSES NOT KNOWN,0,31,12,8,0,51,1,14,0,3,0,18,0,0,0,0,0,0,69
810,SIKKIM,2007,30,DEATH OF DEAR PERSON,0,2,0,0,0,2,0,0,0,0,0,0,0,0,0,0,0,0,2
1356,SIKKIM,2007,30,DOWRY DISPUTE,0,0,0,0,0,0,0,0,0,0,0,0,0,0,0,0,0,0,0
1902,SIKKIM,2007,30,DRUG ABUSE,2,2,0,0,0,4,0,0,0,0,0,0,0,0,0,0,0,0,4
2448,SIKKIM,2007,30,ECONOMIC ISSUES,0,1,0,0,0,1,0,0,0,0,0,0,0,0,0,0,0,0,1
2994,SIKKIM,2007,30,EXAM FAILURE,3,0,0,0,0,3,0,0,0,0,0,0,0,0,0,0,0,0,3
3540,SIKKIM,2007,30,FAMILY PROBLEMS,0,0,9,0,0,9,0,0,0,0,0,0,0,0,0,0,0,0,9
4086,SIKKIM,2007,30,HEALTH ISSUES,0,0,0,0,2,2,0,0,0,0,0,0,0,0,0,0,0,0,2
4631,SIKKIM,2007,30,HERO WORSHIP,0,0,0,0,0,0,0,0,0,0,0,0,0,0,0,0,0,0,0
5176,SIKKIM,2007,30,ILLEGITIMATE PREGNANCY,0,0,0,0,0,0,0,0,0,0,0,0,0,0,0,0,0,0,0
5721,SIKKIM,2007,30,LOVE AFFAIRS,0,1,0,0,0,1,0,0,0,0,0,0,0,0,0,0,0,0,1
6267,SIKKIM,2007,30,MARITAL ISSUES,0,0,0,0,0,0,0,0,0,0,0,0,0,0,0,0,0,0,0
6813,SIKKIM,2007,30,MENTAL HEALTH,0,2,1,4,0,7,0,0,0,0,0,0,0,0,0,0,0,0,7
7359,SIKKIM,2007,30,OTHERS,0,2,2,0,0,4,6,5,8,1,0,20,0,0,0,0,0,0,24
7943,SIKKIM,2007,30,"PHYSICAL ABUSE (RAPE,INCEST ETC.)",0,0,0,0,0,0,0,0,0,0,0,0,0,0,0,0,0,0,0
8450,SIKKIM,2007,30,SOCIETAL ISSUES,0,0,0,0,0,0,0,0,0,0,0,0,0,0,0,0,0,0,0
303,SIKKIM,2008,30,CAUSES NOT KNOWN,0,10,5,10,3,28,0,0,1,1,0,2,0,0,0,0,0,0,30
849,SIKKIM,2008,30,DEATH OF DEAR PERSON,0,0,0,0,0,0,0,2,2,0,0,4,0,0,0,0,0,0,4
1395,SIKKIM,2008,30,DOWRY DISPUTE,0,0,0,0,0,0,0,0,0,0,0,0,0,0,0,0,0,0,0
1941,SIKKIM,2008,30,DRUG ABUSE,0,2,1,0,0,3,0,0,0,0,0,0,0,0,0,0,0,0,3
2487,SIKKIM,2008,30,ECONOMIC ISSUES,0,2,4,2,0,8,0,5,3,2,1,11,0,0,0,0,0,0,19
3033,SIKKIM,2008,30,EXAM FAILURE,0,0,0,0,0,0,0,2,1,0,0,3,0,0,0,0,0,0,3
3579,SIKKIM,2008,30,FAMILY PROBLEMS,0,7,9,6,3,25,0,4,6,5,1,16,0,0,0,0,0,0,41
4125,SIKKIM,2008,30,HEALTH ISSUES,0,1,2,1,0,4,0,0,0,0,0,0,0,0,0,0,0,0,4
4670,SIKKIM,2008,30,HERO WORSHIP,0,0,0,0,0,0,0,0,0,0,0,0,0,0,0,0,0,0,0
5215,SIKKIM,2008,30,ILLEGITIMATE PREGNANCY,0,0,0,0,0,0,0,0,0,0,0,0,0,0,0,0,0,0,0
5760,SIKKIM,2008,30,LOVE AFFAIRS,0,8,2,0,0,10,0,0,0,0,0,0,0,0,0,0,0,0,10
6306,SIKKIM,2008,30,MARITAL ISSUES,0,14,6,6,0,26,0,8,6,0,0,14,0,0,0,0,0,0,40
6852,SIKKIM,2008,30,MENTAL HEALTH,2,4,2,3,0,11,0,2,2,1,1,6,0,0,0,0,0,0,17
7398,SIKKIM,2008,30,OTHERS,0,22,38,37,4,101,0,3,5,4,3,15,0,0,0,0,0,0,116
7982,SIKKIM,2008,30,"PHYSICAL ABUSE (RAPE,INCEST ETC.)",0,0,0,0,0,0,0,0,0,0,0,0,0,0,0,0,0,0,0
8489,SIKKIM,2008,30,SOCIETAL ISSUES,0,0,0,0,0,0,0,0,0,0,0,0,0,0,0,0,0,0,0
342,SIKKIM,2009,30,CAUSES NOT KNOWN,2,29,7,10,5,53,1,2,1,1,0,5,0,0,0,0,0,0,58
888,SIKKIM,2009,30,DEATH OF DEAR PERSON,0,2,0,0,0,2,0,3,1,0,0,4,0,0,0,0,0,0,6
1434,SIKKIM,2009,30,DOWRY DISPUTE,0,0,0,0,0,0,0,0,0,0,0,0,0,0,0,0,0,0,0
1980,SIKKIM,2009,30,DRUG ABUSE,0,3,2,0,0,5,0,0,0,0,0,0,0,0,0,0,0,0,5
2526,SIKKIM,2009,30,ECONOMIC ISSUES,0,0,7,3,0,10,0,11,3,0,0,14,0,0,0,0,0,0,24
3072,SIKKIM,2009,30,EXAM FAILURE,0,5,0,0,0,5,0,6,0,0,0,6,0,0,0,0,0,0,11
3618,SIKKIM,2009,30,FAMILY PROBLEMS,0,5,2,1,0,8,0,6,2,1,0,9,0,0,0,0,0,0,17
4164,SIKKIM,2009,30,HEALTH ISSUES,0,0,1,6,2,9,0,0,0,1,0,1,0,0,0,0,0,0,10
4709,SIKKIM,2009,30,HERO WORSHIP,0,0,0,0,0,0,0,0,0,0,0,0,0,0,0,0,0,0,0
5254,SIKKIM,2009,30,ILLEGITIMATE PREGNANCY,0,0,0,0,0,0,0,0,0,0,0,0,0,0,0,0,0,0,0
5799,SIKKIM,2009,30,LOVE AFFAIRS,0,2,1,0,0,3,0,3,1,0,0,4,0,0,0,0,0,0,7
6345,SIKKIM,2009,30,MARITAL ISSUES,0,5,0,1,0,6,0,8,2,2,0,12,0,0,0,0,0,0,18
6891,SIKKIM,2009,30,MENTAL HEALTH,0,2,1,1,0,4,0,3,2,1,0,6,0,0,0,0,0,0,10
7437,SIKKIM,2009,30,OTHERS,1,12,2,1,1,17,2,15,17,17,7,58,0,0,0,0,0,0,75
8021,SIKKIM,2009,30,"PHYSICAL ABUSE (RAPE,INCEST ETC.)",0,0,0,0,0,0,0,0,0,0,0,0,0,0,0,0,0,0,0
8528,SIKKIM,2009,30,SOCIETAL ISSUES,0,0,0,0,0,0,0,0,0,0,0,0,0,0,0,0,0,0,0
381,SIKKIM,2010,30,CAUSES NOT KNOWN,21,36,26,18,13,114,0,2,1,1,1,5,0,0,0,0,0,0,119
927,SIKKIM,2010,30,DEATH OF DEAR PERSON,0,0,0,1,0,1,0,0,0,0,0,0,0,0,0,0,0,0,1
1473,SIKKIM,2010,30,DOWRY DISPUTE,0,0,0,0,0,0,0,0,0,0,0,0,0,0,0,0,0,0,0
2019,SIKKIM,2010,30,DRUG ABUSE,0,4,2,0,0,6,0,0,0,0,0,0,0,0,0,0,0,0,6
2565,SIKKIM,2010,30,ECONOMIC ISSUES,0,0,3,0,0,3,0,0,6,1,0,7,0,0,0,0,0,0,10
3111,SIKKIM,2010,30,EXAM FAILURE,0,2,0,1,0,3,0,0,1,0,0,1,0,0,0,0,0,0,4
3657,SIKKIM,2010,30,FAMILY PROBLEMS,0,5,12,3,1,21,0,2,1,2,1,6,0,0,0,0,0,0,27
4203,SIKKIM,2010,30,HEALTH ISSUES,0,6,8,5,1,20,0,2,2,2,1,7,0,0,0,0,0,0,27
4748,SIKKIM,2010,30,HERO WORSHIP,0,0,0,1,0,1,0,0,1,0,0,1,0,0,0,0,0,0,2
5293,SIKKIM,2010,30,ILLEGITIMATE PREGNANCY,0,0,0,0,0,0,0,0,0,0,0,0,0,0,0,0,0,0,0
5838,SIKKIM,2010,30,LOVE AFFAIRS,0,2,3,0,0,5,0,0,1,0,0,1,0,0,0,0,0,0,6
6384,SIKKIM,2010,30,MARITAL ISSUES,0,14,5,0,0,19,0,5,4,0,0,9,0,0,0,0,0,0,28
6930,SIKKIM,2010,30,MENTAL HEALTH,0,9,11,1,0,21,0,2,0,2,0,4,0,0,0,0,0,0,25
7476,SIKKIM,2010,30,OTHERS,0,20,0,0,0,20,0,0,0,0,0,0,0,0,0,0,0,0,20
8060,SIKKIM,2010,30,"PHYSICAL ABUSE (RAPE,INCEST ETC.)",0,0,0,0,0,0,0,0,0,0,0,0,0,0,0,0,0,0,0
8567,SIKKIM,2010,30,SOCIETAL ISSUES,0,0,1,0,0,1,0,0,2,2,0,4,0,0,0,0,0,0,5
420,SIKKIM,2011,30,CAUSES NOT KNOWN,4,30,30,22,1,87,0,29,20,18,3,70,0,0,0,0,0,0,157
966,SIKKIM,2011,30,DEATH OF DEAR PERSON,0,0,0,0,0,0,0,0,0,0,0,0,0,0,0,0,0,0,0
1512,SIKKIM,2011,30,DOWRY DISPUTE,0,0,0,0,0,0,0,0,0,0,0,0,0,0,0,0,0,0,0
2058,SIKKIM,2011,30,DRUG ABUSE,0,6,3,1,0,10,0,0,0,0,0,0,0,0,0,0,0,0,10
2604,SIKKIM,2011,30,ECONOMIC ISSUES,0,0,0,0,0,0,0,0,0,0,0,0,0,0,0,0,0,0,0
3150,SIKKIM,2011,30,EXAM FAILURE,0,0,0,0,0,0,0,0,0,0,0,0,0,0,0,0,0,0,0
3696,SIKKIM,2011,30,FAMILY PROBLEMS,0,0,0,0,0,0,0,0,0,0,0,0,0,0,0,0,0,0,0
4242,SIKKIM,2011,30,HEALTH ISSUES,0,0,0,0,0,0,0,0,0,0,0,0,0,0,0,0,0,0,0
4787,SIKKIM,2011,30,HERO WORSHIP,0,0,0,0,0,0,0,0,0,0,0,0,0,0,0,0,0,0,0
5332,SIKKIM,2011,30,ILLEGITIMATE PREGNANCY,0,0,0,0,0,0,0,0,0,0,0,0,0,0,0,0,0,0,0
5877,SIKKIM,2011,30,LOVE AFFAIRS,0,0,0,0,0,0,0,0,0,0,0,0,0,0,0,0,0,0,0
6423,SIKKIM,2011,30,MARITAL ISSUES,0,0,0,0,0,0,0,0,0,0,0,0,0,0,0,0,0,0,0
6969,SIKKIM,2011,30,MENTAL HEALTH,0,0,0,0,0,0,0,0,0,0,0,0,0,0,0,0,0,0,0
7515,SIKKIM,2011,30,OTHERS,0,4,3,2,1,10,2,3,2,0,0,7,0,0,0,0,0,0,17
8099,SIKKIM,2011,30,"PHYSICAL ABUSE (RAPE,INCEST ETC.)",0,0,0,0,0,0,0,0,0,0,0,0,0,0,0,0,0,0,0
8606,SIKKIM,2011,30,SOCIETAL ISSUES,0,0,0,0,0,0,0,0,0,0,0,0,0,0,0,0,0,0,0
459,SIKKIM,2012,30,CAUSES NOT KNOWN,0,2,1,3,0,6,2,0,1,1,0,4,0,0,0,0,0,0,10
1005,SIKKIM,2012,30,DEATH OF DEAR PERSON,0,0,0,0,0,0,0,0,0,0,0,0,0,0,0,0,0,0,0
1551,SIKKIM,2012,30,DOWRY DISPUTE,0,0,0,0,0,0,0,0,0,0,0,0,0,0,0,0,0,0,0
2097,SIKKIM,2012,30,DRUG ABUSE,0,7,8,0,0,15,0,5,7,1,0,13,0,0,0,0,0,0,28
2643,SIKKIM,2012,30,ECONOMIC ISSUES,0,0,0,0,0,0,0,0,0,0,0,0,0,0,0,0,0,0,0
3189,SIKKIM,2012,30,EXAM FAILURE,0,0,0,0,0,0,2,3,0,0,0,5,0,0,0,0,0,0,5
3735,SIKKIM,2012,30,FAMILY PROBLEMS,5,8,7,3,2,25,0,2,2,0,5,9,0,0,0,0,0,0,34
4281,SIKKIM,2012,30,HEALTH ISSUES,0,0,0,0,2,2,0,0,4,0,0,4,0,0,0,0,0,0,6
4826,SIKKIM,2012,30,HERO WORSHIP,0,0,0,0,0,0,0,0,0,0,0,0,0,0,0,0,0,0,0
5371,SIKKIM,2012,30,ILLEGITIMATE PREGNANCY,0,0,0,0,0,0,0,1,2,0,0,3,0,0,0,0,0,0,3
5916,SIKKIM,2012,30,LOVE AFFAIRS,0,5,0,0,0,5,2,7,0,0,0,9,0,0,0,0,0,0,14
6462,SIKKIM,2012,30,MARITAL ISSUES,0,0,0,0,0,0,0,0,0,0,0,0,0,0,0,0,0,0,0
7008,SIKKIM,2012,30,MENTAL HEALTH,0,8,2,7,3,20,0,7,7,5,0,19,0,0,0,0,0,0,39
7554,SIKKIM,2012,30,OTHERS,0,0,0,0,0,0,0,0,0,0,0,0,0,0,0,0,0,0,0
8138,SIKKIM,2012,30,"PHYSICAL ABUSE (RAPE,INCEST ETC.)",0,0,0,0,0,0,0,0,0,0,0,0,0,0,0,0,0,0,0
8645,SIKKIM,2012,30,SOCIETAL ISSUES,0,5,8,7,3,23,0,10,7,2,0,19,0,0,0,0,0,0,42
498,SIKKIM,2013,30,CAUSES NOT KNOWN,0,5,5,2,4,16,0,5,4,2,2,13,0,0,0,0,0,0,29
1044,SIKKIM,2013,30,DEATH OF DEAR PERSON,0,0,0,0,0,0,0,2,0,0,0,2,0,0,0,0,0,0,2
1590,SIKKIM,2013,30,DOWRY DISPUTE,0,0,0,0,0,0,0,0,0,0,0,0,0,0,0,0,0,0,0
2136,SIKKIM,2013,30,DRUG ABUSE,0,9,6,3,0,18,0,0,0,0,0,0,0,0,0,0,0,0,18
2682,SIKKIM,2013,30,ECONOMIC ISSUES,0,6,6,0,0,12,0,2,1,0,0,3,0,0,0,0,0,0,15
3228,SIKKIM,2013,30,EXAM FAILURE,2,9,0,0,0,11,0,4,0,0,0,4,0,0,0,0,0,0,15
3774,SIKKIM,2013,30,FAMILY PROBLEMS,1,2,3,2,2,10,1,2,1,0,0,4,0,0,0,0,0,0,14
4320,SIKKIM,2013,30,HEALTH ISSUES,0,2,3,0,1,6,0,0,0,0,0,0,0,0,0,0,0,0,6
4865,SIKKIM,2013,30,HERO WORSHIP,0,0,0,0,0,0,0,0,0,0,0,0,0,0,0,0,0,0,0
5410,SIKKIM,2013,30,ILLEGITIMATE PREGNANCY,0,0,0,0,0,0,0,0,0,0,0,0,0,0,0,0,0,0,0
5955,SIKKIM,2013,30,LOVE AFFAIRS,1,0,2,0,0,3,1,5,0,0,0,6,0,0,0,0,0,0,9
6501,SIKKIM,2013,30,MARITAL ISSUES,0,16,13,2,0,31,0,11,0,0,0,11,0,0,0,0,0,0,42
7047,SIKKIM,2013,30,MENTAL HEALTH,0,0,0,2,0,2,0,0,2,0,0,2,0,0,0,0,0,0,4
7593,SIKKIM,2013,30,OTHERS,1,0,10,5,0,16,0,6,3,3,1,13,0,0,0,0,0,0,29
8177,SIKKIM,2013,30,"PHYSICAL ABUSE (RAPE,INCEST ETC.)",0,0,0,0,0,0,0,0,0,0,0,0,0,0,0,0,0,0,0
8684,SIKKIM,2013,30,SOCIETAL ISSUES,0,0,0,0,0,0,1,0,0,0,0,1,0,0,0,0,0,0,1
537,SIKKIM,2014,30,CAUSES NOT KNOWN,1,10,7,8,0,26,2,8,4,4,0,18,0,0,0,0,0,0,44
1083,SIKKIM,2014,30,DEATH OF DEAR PERSON,0,1,0,0,0,1,0,1,0,0,0,1,0,0,0,0,0,0,2
1629,SIKKIM,2014,30,DOWRY DISPUTE,0,0,0,0,0,0,0,0,0,0,0,0,0,0,0,0,0,0,0
2175,SIKKIM,2014,30,DRUG ABUSE,0,1,0,0,0,1,0,0,0,0,0,0,0,0,0,0,0,0,1
2721,SIKKIM,2014,30,ECONOMIC ISSUES,1,11,1,0,0,13,0,0,1,1,1,3,0,0,0,0,0,0,16
3267,SIKKIM,2014,30,EXAM FAILURE,0,2,0,0,0,2,1,5,0,0,0,6,0,0,0,0,0,0,8
3813,SIKKIM,2014,30,FAMILY PROBLEMS,0,10,6,1,0,17,0,4,4,1,0,9,0,0,0,0,0,0,26
4359,SIKKIM,2014,30,HEALTH ISSUES,0,5,3,4,4,16,0,4,2,2,2,10,0,0,0,0,0,0,26
4904,SIKKIM,2014,30,HERO WORSHIP,0,0,0,0,0,0,0,0,0,0,0,0,0,0,0,0,0,0,0
5449,SIKKIM,2014,30,ILLEGITIMATE PREGNANCY,0,0,0,0,0,0,0,0,0,0,0,0,0,0,0,0,0,0,0
5994,SIKKIM,2014,30,LOVE AFFAIRS,0,1,0,0,0,1,1,1,0,0,0,2,0,0,0,0,0,0,3
6540,SIKKIM,2014,30,MARITAL ISSUES,0,4,0,0,0,4,0,2,1,0,0,3,0,0,0,0,0,0,7
7086,SIKKIM,2014,30,MENTAL HEALTH,0,1,1,2,0,4,0,2,2,0,0,4,0,0,0,0,0,0,8
7632,SIKKIM,2014,30,OTHERS,4,20,35,21,7,87,2,13,14,5,2,36,0,0,0,0,0,0,123
7671,SIKKIM,2014,30,PHYSICAL ABUSE,0,0,0,0,0,0,0,0,0,0,0,0,0,0,0,0,0,0,0
8723,SIKKIM,2014,30,SOCIETAL ISSUES,0,1,0,0,0,1,0,0,0,0,0,0,0,0,0,0,0,0,1
31,TAMIL NADU,2001,31,CAUSES NOT KNOWN,35,202,309,229,61,836,40,104,159,112,26,441,0,0,0,0,0,0,1277
577,TAMIL NADU,2001,31,DEATH OF DEAR PERSON,0,7,24,11,3,45,2,4,9,8,0,23,0,0,0,0,0,0,68
1123,TAMIL NADU,2001,31,DOWRY DISPUTE,0,4,5,0,0,9,0,77,29,2,0,108,0,0,0,0,0,0,117
1669,TAMIL NADU,2001,31,DRUG ABUSE,0,15,29,15,0,59,0,2,1,2,1,6,0,0,0,0,0,0,65
2215,TAMIL NADU,2001,31,ECONOMIC ISSUES,7,216,369,177,35,804,7,63,112,65,12,259,0,0,0,0,0,0,1063
2761,TAMIL NADU,2001,31,EXAM FAILURE,17,76,7,0,0,100,19,64,5,0,0,88,0,0,0,0,0,0,188
3307,TAMIL NADU,2001,31,FAMILY PROBLEMS,22,650,765,401,118,1956,22,540,414,185,51,1212,0,0,0,0,0,0,3168
3853,TAMIL NADU,2001,31,HEALTH ISSUES,10,399,588,526,152,1675,5,360,339,146,74,924,0,0,0,0,0,0,2599
4399,TAMIL NADU,2001,31,HERO WORSHIP,0,0,1,0,0,1,0,0,0,0,0,0,0,0,0,0,0,0,1
4944,TAMIL NADU,2001,31,ILLEGITIMATE PREGNANCY,0,0,0,0,0,0,0,13,12,0,0,25,0,0,0,0,0,0,25
5489,TAMIL NADU,2001,31,LOVE AFFAIRS,10,161,56,3,0,230,2,115,52,9,0,178,0,0,0,0,0,0,408
6034,TAMIL NADU,2001,31,MARITAL ISSUES,0,40,41,8,0,89,0,62,51,4,0,117,0,0,0,0,0,0,206
6580,TAMIL NADU,2001,31,MENTAL HEALTH,2,37,47,54,46,186,3,27,48,35,15,128,0,0,0,0,0,0,314
7126,TAMIL NADU,2001,31,OTHERS,43,284,407,238,94,1066,43,246,190,86,34,599,0,0,0,0,0,0,1665
7711,TAMIL NADU,2001,31,"PHYSICAL ABUSE (RAPE,INCEST ETC.)",0,2,1,0,0,3,0,1,0,0,0,1,0,0,0,0,0,0,4
8217,TAMIL NADU,2001,31,SOCIETAL ISSUES,0,22,33,11,3,69,2,24,23,4,0,53,0,0,0,0,0,0,122
70,TAMIL NADU,2002,31,CAUSES NOT KNOWN,12,135,178,181,73,579,13,70,95,43,23,244,0,0,0,0,0,0,823
616,TAMIL NADU,2002,31,DEATH OF DEAR PERSON,0,3,8,3,0,14,0,8,5,3,0,16,0,0,0,0,0,0,30
1162,TAMIL NADU,2002,31,DOWRY DISPUTE,0,0,0,0,0,0,1,85,23,4,0,113,0,0,0,0,0,0,113
1708,TAMIL NADU,2002,31,DRUG ABUSE,1,25,37,20,2,85,0,13,10,10,6,39,0,0,0,0,0,0,124
2254,TAMIL NADU,2002,31,ECONOMIC ISSUES,1,154,201,133,21,510,4,106,69,52,11,242,0,0,0,0,0,0,752
2800,TAMIL NADU,2002,31,EXAM FAILURE,10,97,19,0,0,126,16,85,15,0,0,116,0,0,0,0,0,0,242
3346,TAMIL NADU,2002,31,FAMILY PROBLEMS,19,588,771,493,151,2022,36,571,432,215,69,1323,0,0,0,0,0,0,3345
3892,TAMIL NADU,2002,31,HEALTH ISSUES,6,406,646,558,141,1757,7,360,327,179,74,947,0,0,0,0,0,0,2704
4438,TAMIL NADU,2002,31,HERO WORSHIP,0,0,0,0,0,0,0,0,0,0,0,0,0,0,0,0,0,0,0
4983,TAMIL NADU,2002,31,ILLEGITIMATE PREGNANCY,0,0,0,0,0,0,0,9,7,0,0,16,0,0,0,0,0,0,16
5528,TAMIL NADU,2002,31,LOVE AFFAIRS,1,123,46,13,1,184,3,127,29,9,0,168,0,0,0,0,0,0,352
6073,TAMIL NADU,2002,31,MARITAL ISSUES,0,44,56,14,2,116,0,99,65,28,2,194,0,0,0,0,0,0,310
6619,TAMIL NADU,2002,31,MENTAL HEALTH,1,53,83,60,20,217,0,51,59,28,11,149,0,0,0,0,0,0,366
7165,TAMIL NADU,2002,31,OTHERS,48,337,480,305,129,1299,54,261,162,126,31,634,0,0,0,0,0,0,1933
7750,TAMIL NADU,2002,31,"PHYSICAL ABUSE (RAPE,INCEST ETC.)",0,18,11,9,2,40,11,11,8,6,4,40,0,0,0,0,0,0,80
8256,TAMIL NADU,2002,31,SOCIETAL ISSUES,0,10,16,7,1,34,0,3,12,4,1,20,0,0,0,0,0,0,54
109,TAMIL NADU,2003,31,CAUSES NOT KNOWN,37,294,419,257,189,1196,30,147,203,190,51,621,0,0,0,0,0,0,1817
655,TAMIL NADU,2003,31,DEATH OF DEAR PERSON,1,26,19,11,1,58,3,19,7,1,1,31,0,0,0,0,0,0,89
1201,TAMIL NADU,2003,31,DOWRY DISPUTE,0,1,0,0,1,2,0,101,72,16,0,189,0,0,0,0,0,0,191
1747,TAMIL NADU,2003,31,DRUG ABUSE,1,18,40,16,2,77,0,3,5,0,0,8,0,0,0,0,0,0,85
2293,TAMIL NADU,2003,31,ECONOMIC ISSUES,2,261,420,297,83,1063,4,119,158,97,29,407,0,0,0,0,0,0,1470
2839,TAMIL NADU,2003,31,EXAM FAILURE,22,74,15,0,0,111,17,55,14,0,0,86,0,0,0,0,0,0,197
3385,TAMIL NADU,2003,31,FAMILY PROBLEMS,26,490,700,523,148,1887,35,533,419,267,73,1327,0,0,0,0,0,0,3214
3931,TAMIL NADU,2003,31,HEALTH ISSUES,23,335,443,400,148,1349,9,305,318,201,90,923,0,0,0,0,0,0,2272
4477,TAMIL NADU,2003,31,HERO WORSHIP,0,0,0,0,0,0,0,0,0,0,0,0,0,0,0,0,0,0,0
5022,TAMIL NADU,2003,31,ILLEGITIMATE PREGNANCY,0,0,0,0,0,0,0,26,0,0,0,26,0,0,0,0,0,0,26
5567,TAMIL NADU,2003,31,LOVE AFFAIRS,7,161,60,26,0,254,15,166,61,13,0,255,0,0,0,0,0,0,509
6112,TAMIL NADU,2003,31,MARITAL ISSUES,0,72,74,25,1,172,0,102,108,24,1,235,0,0,0,0,0,0,407
6658,TAMIL NADU,2003,31,MENTAL HEALTH,4,64,69,47,22,206,9,58,53,37,19,176,0,0,0,0,0,0,382
7204,TAMIL NADU,2003,31,OTHERS,14,151,222,204,96,687,40,102,145,74,40,401,0,0,0,0,0,0,1088
7789,TAMIL NADU,2003,31,"PHYSICAL ABUSE (RAPE,INCEST ETC.)",0,5,15,13,2,35,4,3,6,5,0,18,0,0,0,0,0,0,53
8295,TAMIL NADU,2003,31,SOCIETAL ISSUES,0,13,22,22,0,57,0,5,8,1,1,15,0,0,0,0,0,0,72
148,TAMIL NADU,2004,31,CAUSES NOT KNOWN,22,127,208,198,150,705,27,102,113,107,38,387,0,0,0,0,0,0,1092
694,TAMIL NADU,2004,31,DEATH OF DEAR PERSON,0,13,13,10,0,36,0,19,7,6,0,32,0,0,0,0,0,0,68
1240,TAMIL NADU,2004,31,DOWRY DISPUTE,0,0,0,0,0,0,0,92,38,0,0,130,0,0,0,0,0,0,130
1786,TAMIL NADU,2004,31,DRUG ABUSE,0,11,42,15,6,74,0,3,10,2,0,15,0,0,0,0,0,0,89
2332,TAMIL NADU,2004,31,ECONOMIC ISSUES,16,261,387,300,49,1013,4,131,170,141,21,467,0,0,0,0,0,0,1480
2878,TAMIL NADU,2004,31,EXAM FAILURE,41,135,67,2,0,245,23,104,35,0,0,162,0,0,0,0,0,0,407
3424,TAMIL NADU,2004,31,FAMILY PROBLEMS,19,547,887,746,201,2400,32,621,554,357,96,1660,0,0,0,0,0,0,4060
3970,TAMIL NADU,2004,31,HEALTH ISSUES,22,343,578,522,220,1685,36,247,257,242,111,893,0,0,0,0,0,0,2578
4516,TAMIL NADU,2004,31,HERO WORSHIP,0,0,1,0,1,2,0,0,0,0,0,0,0,0,0,0,0,0,2
5061,TAMIL NADU,2004,31,ILLEGITIMATE PREGNANCY,0,0,0,0,0,0,0,5,3,0,0,8,0,0,0,0,0,0,8
5606,TAMIL NADU,2004,31,LOVE AFFAIRS,6,211,111,6,1,335,11,178,99,11,0,299,0,0,0,0,0,0,634
6151,TAMIL NADU,2004,31,MARITAL ISSUES,0,29,47,19,0,95,0,78,79,20,0,177,0,0,0,0,0,0,272
6697,TAMIL NADU,2004,31,MENTAL HEALTH,10,105,80,63,34,292,14,55,44,50,8,171,0,0,0,0,0,0,463
7243,TAMIL NADU,2004,31,OTHERS,54,216,317,284,150,1021,29,178,145,84,53,489,0,0,0,0,0,0,1510
7828,TAMIL NADU,2004,31,"PHYSICAL ABUSE (RAPE,INCEST ETC.)",0,20,15,0,0,35,0,1,1,0,0,2,0,0,0,0,0,0,37
8334,TAMIL NADU,2004,31,SOCIETAL ISSUES,0,2,0,5,1,8,0,0,0,1,0,1,0,0,0,0,0,0,9
187,TAMIL NADU,2005,31,CAUSES NOT KNOWN,5,92,204,155,126,582,21,102,125,125,56,429,0,0,0,0,0,0,1011
733,TAMIL NADU,2005,31,DEATH OF DEAR PERSON,0,5,7,16,0,28,1,10,20,4,0,35,0,0,0,0,0,0,63
1279,TAMIL NADU,2005,31,DOWRY DISPUTE,0,0,1,2,0,3,0,39,36,0,0,75,0,0,0,0,0,0,78
1825,TAMIL NADU,2005,31,DRUG ABUSE,0,17,27,19,3,66,0,9,6,1,1,17,0,0,0,0,0,0,83
2371,TAMIL NADU,2005,31,ECONOMIC ISSUES,5,216,325,195,27,768,3,82,127,66,17,295,0,0,0,0,0,0,1063
2917,TAMIL NADU,2005,31,EXAM FAILURE,20,93,36,10,0,159,54,80,16,5,0,155,0,0,0,0,0,0,314
3463,TAMIL NADU,2005,31,FAMILY PROBLEMS,6,585,861,699,168,2319,22,601,453,301,126,1503,0,0,0,0,0,0,3822
4009,TAMIL NADU,2005,31,HEALTH ISSUES,10,370,502,444,190,1516,11,266,156,152,70,655,0,0,0,0,0,0,2171
4555,TAMIL NADU,2005,31,HERO WORSHIP,0,0,0,0,0,0,0,0,0,0,0,0,0,0,0,0,0,0,0
5100,TAMIL NADU,2005,31,ILLEGITIMATE PREGNANCY,0,0,0,0,0,0,2,3,1,0,0,6,0,0,0,0,0,0,6
5645,TAMIL NADU,2005,31,LOVE AFFAIRS,10,163,36,4,4,217,8,143,40,0,0,191,0,0,0,0,0,0,408
6190,TAMIL NADU,2005,31,MARITAL ISSUES,0,42,60,20,3,125,12,77,78,27,0,194,0,0,0,0,0,0,319
6736,TAMIL NADU,2005,31,MENTAL HEALTH,2,53,66,31,14,166,2,53,44,30,10,139,0,0,0,0,0,0,305
7282,TAMIL NADU,2005,31,OTHERS,85,319,568,364,185,1521,34,257,260,209,94,854,0,0,0,0,0,0,2375
7867,TAMIL NADU,2005,31,"PHYSICAL ABUSE (RAPE,INCEST ETC.)",0,0,0,0,0,0,1,0,0,1,0,2,0,0,0,0,0,0,2
8373,TAMIL NADU,2005,31,SOCIETAL ISSUES,4,11,14,8,0,37,1,13,3,2,0,19,0,0,0,0,0,0,56
226,TAMIL NADU,2006,31,CAUSES NOT KNOWN,0,208,259,216,143,826,14,126,127,81,48,396,0,0,0,0,0,0,1222
772,TAMIL NADU,2006,31,DEATH OF DEAR PERSON,0,18,19,15,0,52,0,11,13,7,0,31,0,0,0,0,0,0,83
1318,TAMIL NADU,2006,31,DOWRY DISPUTE,0,0,0,0,0,0,0,63,29,0,0,92,0,0,0,0,0,0,92
1864,TAMIL NADU,2006,31,DRUG ABUSE,0,34,68,27,6,135,0,18,9,2,3,32,0,0,0,0,0,0,167
2410,TAMIL NADU,2006,31,ECONOMIC ISSUES,0,216,283,175,55,729,0,90,96,60,18,264,0,0,0,0,0,0,993
2956,TAMIL NADU,2006,31,EXAM FAILURE,26,65,8,0,0,99,36,84,7,0,0,127,0,0,0,0,0,0,226
3502,TAMIL NADU,2006,31,FAMILY PROBLEMS,0,461,910,680,261,2312,0,564,566,349,96,1575,0,0,0,0,0,0,3887
4048,TAMIL NADU,2006,31,HEALTH ISSUES,0,359,562,445,182,1548,18,392,363,178,82,1033,0,0,0,0,0,0,2581
4593,TAMIL NADU,2006,31,HERO WORSHIP,0,27,46,24,5,102,0,41,21,7,1,70,0,0,0,0,0,0,172
5138,TAMIL NADU,2006,31,ILLEGITIMATE PREGNANCY,0,0,0,0,0,0,0,14,2,0,0,16,0,0,0,0,0,0,16
5683,TAMIL NADU,2006,31,LOVE AFFAIRS,0,173,23,0,0,196,0,171,29,0,0,200,0,0,0,0,0,0,396
6229,TAMIL NADU,2006,31,MARITAL ISSUES,0,11,129,27,0,167,0,118,100,11,0,229,0,0,0,0,0,0,396
6775,TAMIL NADU,2006,31,MENTAL HEALTH,0,55,71,35,19,180,3,31,41,34,9,118,0,0,0,0,0,0,298
7321,TAMIL NADU,2006,31,OTHERS,0,316,357,259,72,1004,9,194,180,121,40,544,0,0,0,0,0,0,1548
7905,TAMIL NADU,2006,31,"PHYSICAL ABUSE (RAPE,INCEST ETC.)",0,0,0,0,0,0,0,11,2,0,0,13,0,0,0,0,0,0,13
8412,TAMIL NADU,2006,31,SOCIETAL ISSUES,0,53,62,32,12,159,0,67,36,20,9,132,0,0,0,0,0,0,291
265,TAMIL NADU,2007,31,CAUSES NOT KNOWN,0,240,300,250,166,956,15,133,133,85,50,416,0,0,0,0,0,0,1372
811,TAMIL NADU,2007,31,DEATH OF DEAR PERSON,0,21,22,17,0,60,0,12,14,7,0,33,0,0,0,0,0,0,93
1357,TAMIL NADU,2007,31,DOWRY DISPUTE,0,0,0,0,0,0,0,66,31,0,0,97,0,0,0,0,0,0,97
1903,TAMIL NADU,2007,31,DRUG ABUSE,0,39,79,31,7,156,0,18,9,4,3,34,0,0,0,0,0,0,190
2449,TAMIL NADU,2007,31,ECONOMIC ISSUES,0,251,327,203,63,844,0,95,100,65,18,278,0,0,0,0,0,0,1122
2995,TAMIL NADU,2007,31,EXAM FAILURE,30,76,6,1,2,115,38,89,7,0,0,134,0,0,0,0,0,0,249
3541,TAMIL NADU,2007,31,FAMILY PROBLEMS,0,533,1053,787,302,2675,0,593,595,367,101,1656,0,0,0,0,0,0,4331
4087,TAMIL NADU,2007,31,HEALTH ISSUES,0,416,656,512,207,1791,18,414,381,187,86,1086,0,0,0,0,0,0,2877
4632,TAMIL NADU,2007,31,HERO WORSHIP,0,31,53,28,6,118,0,43,22,7,1,73,0,0,0,0,0,0,191
5177,TAMIL NADU,2007,31,ILLEGITIMATE PREGNANCY,0,0,0,0,0,0,0,14,3,0,0,17,0,0,0,0,0,0,17
5722,TAMIL NADU,2007,31,LOVE AFFAIRS,0,200,27,0,0,227,0,180,30,0,0,210,0,0,0,0,0,0,437
6268,TAMIL NADU,2007,31,MARITAL ISSUES,0,13,149,31,0,193,0,125,104,12,0,241,0,0,0,0,0,0,434
6814,TAMIL NADU,2007,31,MENTAL HEALTH,0,64,82,40,22,208,3,33,43,36,9,124,0,0,0,0,0,0,332
7360,TAMIL NADU,2007,31,OTHERS,0,366,411,300,83,1160,9,205,189,127,42,572,0,0,0,0,0,0,1732
7944,TAMIL NADU,2007,31,"PHYSICAL ABUSE (RAPE,INCEST ETC.)",0,0,0,0,0,0,0,11,3,0,0,14,0,0,0,0,0,0,14
8451,TAMIL NADU,2007,31,SOCIETAL ISSUES,0,61,72,37,14,184,0,71,38,21,9,139,0,0,0,0,0,0,323
304,TAMIL NADU,2008,31,CAUSES NOT KNOWN,0,240,300,250,166,956,15,133,133,85,50,416,0,0,0,0,0,0,1372
850,TAMIL NADU,2008,31,DEATH OF DEAR PERSON,0,23,27,37,0,87,0,12,14,7,0,33,0,0,0,0,0,0,120
1396,TAMIL NADU,2008,31,DOWRY DISPUTE,0,0,0,0,0,0,0,85,45,0,0,130,0,0,0,0,0,0,130
1942,TAMIL NADU,2008,31,DRUG ABUSE,0,39,79,31,7,156,0,15,19,14,3,51,0,0,0,0,0,0,207
2488,TAMIL NADU,2008,31,ECONOMIC ISSUES,0,251,364,236,63,914,0,109,102,67,18,296,0,0,0,0,0,0,1210
3034,TAMIL NADU,2008,31,EXAM FAILURE,30,85,6,1,2,124,38,95,7,0,0,140,0,0,0,0,0,0,264
3580,TAMIL NADU,2008,31,FAMILY PROBLEMS,0,387,858,787,302,2334,0,486,597,367,101,1551,0,0,0,0,0,0,3885
4126,TAMIL NADU,2008,31,HEALTH ISSUES,0,765,750,525,206,2246,18,470,416,211,106,1221,0,0,0,0,0,0,3467
4671,TAMIL NADU,2008,31,HERO WORSHIP,0,31,53,28,6,118,0,43,22,7,1,73,0,0,0,0,0,0,191
5216,TAMIL NADU,2008,31,ILLEGITIMATE PREGNANCY,0,0,0,0,0,0,0,25,3,0,0,28,0,0,0,0,0,0,28
5761,TAMIL NADU,2008,31,LOVE AFFAIRS,0,197,27,0,0,224,0,295,30,0,0,325,0,0,0,0,0,0,549
6307,TAMIL NADU,2008,31,MARITAL ISSUES,0,13,224,34,0,271,0,123,113,22,0,258,0,0,0,0,0,0,529
6853,TAMIL NADU,2008,31,MENTAL HEALTH,0,67,87,40,22,216,3,33,43,36,9,124,0,0,0,0,0,0,340
7399,TAMIL NADU,2008,31,OTHERS,0,366,411,300,83,1160,9,205,189,127,42,572,0,0,0,0,0,0,1732
7983,TAMIL NADU,2008,31,"PHYSICAL ABUSE (RAPE,INCEST ETC.)",0,0,0,0,0,0,0,11,3,0,0,14,0,0,0,0,0,0,14
8490,TAMIL NADU,2008,31,SOCIETAL ISSUES,0,99,79,45,14,237,0,75,45,21,9,150,0,0,0,0,0,0,387
343,TAMIL NADU,2009,31,CAUSES NOT KNOWN,15,154,230,234,149,782,3,101,107,99,50,360,0,0,0,0,0,0,1142
889,TAMIL NADU,2009,31,DEATH OF DEAR PERSON,0,18,19,4,2,43,1,11,3,4,2,21,0,0,0,0,0,0,64
1435,TAMIL NADU,2009,31,DOWRY DISPUTE,0,1,1,1,0,3,0,41,14,4,0,59,0,0,0,0,0,0,62
1981,TAMIL NADU,2009,31,DRUG ABUSE,0,38,105,76,8,227,1,1,3,4,2,11,0,0,0,0,0,0,238
2527,TAMIL NADU,2009,31,ECONOMIC ISSUES,23,261,302,164,53,803,7,63,72,37,20,199,0,0,0,0,0,0,1002
3073,TAMIL NADU,2009,31,EXAM FAILURE,27,82,7,0,0,116,23,75,6,3,0,107,0,0,0,0,0,0,223
3619,TAMIL NADU,2009,31,FAMILY PROBLEMS,14,639,997,622,275,2547,22,641,627,307,119,1716,0,0,0,0,0,0,4263
4165,TAMIL NADU,2009,31,HEALTH ISSUES,8,309,560,427,265,1569,9,361,293,210,128,1001,0,0,0,0,0,0,2570
4710,TAMIL NADU,2009,31,HERO WORSHIP,0,0,0,0,0,0,0,0,0,0,0,0,0,0,0,0,0,0,0
5255,TAMIL NADU,2009,31,ILLEGITIMATE PREGNANCY,0,0,0,0,0,0,0,1,16,3,0,20,0,0,0,0,0,0,20
5800,TAMIL NADU,2009,31,LOVE AFFAIRS,0,164,39,1,3,207,0,167,48,1,0,216,0,0,0,0,0,0,423
6346,TAMIL NADU,2009,31,MARITAL ISSUES,0,59,78,26,3,166,5,103,90,14,1,213,0,0,0,0,0,0,379
6892,TAMIL NADU,2009,31,MENTAL HEALTH,2,169,93,46,38,348,3,38,46,34,21,142,0,0,0,0,0,0,490
7438,TAMIL NADU,2009,31,OTHERS,47,457,731,643,231,2109,69,471,434,287,121,1382,0,0,0,0,0,0,3491
8022,TAMIL NADU,2009,31,"PHYSICAL ABUSE (RAPE,INCEST ETC.)",0,3,2,0,1,6,1,0,5,4,1,11,0,0,0,0,0,0,17
8529,TAMIL NADU,2009,31,SOCIETAL ISSUES,0,7,10,5,2,24,0,3,5,8,0,16,0,0,0,0,0,0,40
382,TAMIL NADU,2010,31,CAUSES NOT KNOWN,11,159,204,198,136,708,7,77,94,75,53,306,0,0,0,0,0,0,1014
928,TAMIL NADU,2010,31,DEATH OF DEAR PERSON,3,7,2,9,4,25,3,7,9,3,4,26,0,0,0,0,0,0,51
1474,TAMIL NADU,2010,31,DOWRY DISPUTE,0,5,0,0,0,5,0,50,27,8,0,85,0,0,0,0,0,0,90
2020,TAMIL NADU,2010,31,DRUG ABUSE,0,36,91,61,13,201,0,0,2,1,0,3,0,0,0,0,0,0,204
2566,TAMIL NADU,2010,31,ECONOMIC ISSUES,21,334,418,310,154,1237,6,193,182,116,26,523,0,0,0,0,0,0,1760
3112,TAMIL NADU,2010,31,EXAM FAILURE,25,82,5,3,1,116,32,90,1,1,0,124,0,0,0,0,0,0,240
3658,TAMIL NADU,2010,31,FAMILY PROBLEMS,30,970,1287,877,358,3522,32,1010,655,410,166,2273,0,0,0,0,0,0,5795
4204,TAMIL NADU,2010,31,HEALTH ISSUES,30,496,600,527,307,1960,67,411,317,175,114,1084,0,0,0,0,0,0,3044
4749,TAMIL NADU,2010,31,HERO WORSHIP,0,3,0,0,0,3,0,1,0,0,0,1,0,0,0,0,0,0,4
5294,TAMIL NADU,2010,31,ILLEGITIMATE PREGNANCY,0,0,0,0,0,0,0,7,0,0,0,7,0,0,0,0,0,0,7
5839,TAMIL NADU,2010,31,LOVE AFFAIRS,1,241,59,15,0,316,3,212,52,4,1,272,0,0,0,0,0,0,588
6385,TAMIL NADU,2010,31,MARITAL ISSUES,0,62,69,25,4,160,0,91,93,11,2,197,0,0,0,0,0,0,357
6931,TAMIL NADU,2010,31,MENTAL HEALTH,4,93,104,70,34,305,1,77,87,41,28,234,0,0,0,0,0,0,539
7477,TAMIL NADU,2010,31,OTHERS,74,455,658,479,283,1949,33,262,270,172,102,839,0,0,0,0,0,0,2788
8061,TAMIL NADU,2010,31,"PHYSICAL ABUSE (RAPE,INCEST ETC.)",0,4,0,0,0,4,1,1,0,0,0,2,0,0,0,0,0,0,6
8568,TAMIL NADU,2010,31,SOCIETAL ISSUES,0,19,15,5,2,41,0,15,5,12,1,33,0,0,0,0,0,0,74
421,TAMIL NADU,2011,31,CAUSES NOT KNOWN,8,227,875,230,107,1447,17,96,93,85,29,320,0,0,0,0,0,0,1767
967,TAMIL NADU,2011,31,DEATH OF DEAR PERSON,0,11,16,11,6,44,2,47,60,9,4,122,0,0,0,0,0,0,166
1513,TAMIL NADU,2011,31,DOWRY DISPUTE,0,3,4,1,0,8,0,49,31,4,0,84,0,0,0,0,0,0,92
2059,TAMIL NADU,2011,31,DRUG ABUSE,0,62,117,57,13,249,0,5,2,2,0,9,0,0,0,0,0,0,258
2605,TAMIL NADU,2011,31,ECONOMIC ISSUES,0,219,158,102,19,498,1,54,42,31,13,141,0,0,0,0,0,0,639
3151,TAMIL NADU,2011,31,EXAM FAILURE,28,84,6,0,0,118,24,78,3,0,0,105,0,0,0,0,0,0,223
3697,TAMIL NADU,2011,31,FAMILY PROBLEMS,25,864,1168,741,215,3013,30,920,717,267,104,2038,0,0,0,0,0,0,5051
4243,TAMIL NADU,2011,31,HEALTH ISSUES,27,385,586,556,278,1832,31,429,332,192,137,1121,0,0,0,0,0,0,2953
4788,TAMIL NADU,2011,31,HERO WORSHIP,0,1,1,0,0,2,4,2,0,0,0,6,0,0,0,0,0,0,8
5333,TAMIL NADU,2011,31,ILLEGITIMATE PREGNANCY,0,0,0,0,0,0,0,47,14,2,0,63,0,0,0,0,0,0,63
5878,TAMIL NADU,2011,31,LOVE AFFAIRS,0,218,41,3,0,262,9,181,22,17,1,230,0,0,0,0,0,0,492
6424,TAMIL NADU,2011,31,MARITAL ISSUES,0,53,79,22,2,156,0,68,50,5,1,124,0,0,0,0,0,0,280
6970,TAMIL NADU,2011,31,MENTAL HEALTH,3,66,126,97,61,353,10,63,80,49,23,225,0,0,0,0,0,0,578
7516,TAMIL NADU,2011,31,OTHERS,68,537,678,518,287,2088,68,324,330,131,94,947,0,0,0,0,0,0,3035
8100,TAMIL NADU,2011,31,"PHYSICAL ABUSE (RAPE,INCEST ETC.)",0,1,1,0,0,2,0,0,1,0,0,1,0,0,0,0,0,0,3
8607,TAMIL NADU,2011,31,SOCIETAL ISSUES,0,5,121,67,17,210,0,56,49,32,8,145,0,0,0,0,0,0,355
460,TAMIL NADU,2012,31,CAUSES NOT KNOWN,10,90,655,179,88,1022,8,87,102,138,70,405,0,0,0,0,0,0,1427
1006,TAMIL NADU,2012,31,DEATH OF DEAR PERSON,1,9,17,8,17,52,2,23,15,6,1,47,0,0,0,0,0,0,99
1552,TAMIL NADU,2012,31,DOWRY DISPUTE,0,0,0,1,0,1,0,30,8,3,0,41,0,0,0,0,0,0,42
2098,TAMIL NADU,2012,31,DRUG ABUSE,0,39,100,76,24,239,0,2,1,0,0,3,0,0,0,0,0,0,242
2644,TAMIL NADU,2012,31,ECONOMIC ISSUES,0,142,126,66,65,399,2,15,35,20,13,85,0,0,0,0,0,0,484
3190,TAMIL NADU,2012,31,EXAM FAILURE,19,95,0,0,0,114,14,94,16,0,0,124,0,0,0,0,0,0,238
3736,TAMIL NADU,2012,31,FAMILY PROBLEMS,13,661,1012,820,268,2774,47,879,632,374,136,2068,0,0,0,0,0,0,4842
4282,TAMIL NADU,2012,31,HEALTH ISSUES,13,424,580,503,374,1894,21,393,381,259,148,1202,0,0,0,0,0,0,3096
4827,TAMIL NADU,2012,31,HERO WORSHIP,0,1,0,2,0,3,0,2,0,0,1,3,0,0,0,0,0,0,6
5372,TAMIL NADU,2012,31,ILLEGITIMATE PREGNANCY,0,0,0,0,0,0,0,12,8,1,0,21,0,0,0,0,0,0,21
5917,TAMIL NADU,2012,31,LOVE AFFAIRS,0,171,48,19,0,238,10,173,56,11,0,250,0,0,0,0,0,0,488
6463,TAMIL NADU,2012,31,MARITAL ISSUES,0,33,48,18,3,102,0,74,61,14,1,150,0,0,0,0,0,0,252
7009,TAMIL NADU,2012,31,MENTAL HEALTH,0,117,101,78,54,350,5,63,78,43,28,217,0,0,0,0,0,0,567
7555,TAMIL NADU,2012,31,OTHERS,93,979,1209,881,396,3558,73,693,382,245,161,1554,0,0,0,0,0,0,5112
8139,TAMIL NADU,2012,31,"PHYSICAL ABUSE (RAPE,INCEST ETC.)",0,0,0,0,0,0,0,3,2,0,0,5,0,0,0,0,0,0,5
8646,TAMIL NADU,2012,31,SOCIETAL ISSUES,0,2,0,0,0,2,0,4,0,0,0,4,0,0,0,0,0,0,6
499,TAMIL NADU,2013,31,CAUSES NOT KNOWN,4,90,154,113,62,423,7,49,43,32,22,153,0,0,0,0,0,0,576
1045,TAMIL NADU,2013,31,DEATH OF DEAR PERSON,0,20,21,8,9,58,0,14,5,10,0,29,0,0,0,0,0,0,87
1591,TAMIL NADU,2013,31,DOWRY DISPUTE,0,0,4,5,2,11,0,26,12,7,1,46,0,0,0,0,0,0,57
2137,TAMIL NADU,2013,31,DRUG ABUSE,1,83,153,162,27,426,0,2,3,4,2,11,0,0,0,0,0,0,437
2683,TAMIL NADU,2013,31,ECONOMIC ISSUES,0,182,175,160,56,573,0,29,31,28,13,101,0,0,0,0,0,0,674
3229,TAMIL NADU,2013,31,EXAM FAILURE,47,115,0,0,0,162,18,97,0,0,0,115,0,0,0,0,0,0,277
3775,TAMIL NADU,2013,31,FAMILY PROBLEMS,16,830,1330,901,288,3365,20,770,618,262,106,1776,0,0,0,0,0,0,5141
4321,TAMIL NADU,2013,31,HEALTH ISSUES,24,454,708,736,460,2382,27,517,352,231,150,1277,0,0,0,0,0,0,3659
4866,TAMIL NADU,2013,31,HERO WORSHIP,1,7,1,0,0,9,0,4,1,0,0,5,0,0,0,0,0,0,14
5411,TAMIL NADU,2013,31,ILLEGITIMATE PREGNANCY,0,0,0,0,0,0,0,12,4,0,0,16,0,0,0,0,0,0,16
5956,TAMIL NADU,2013,31,LOVE AFFAIRS,4,209,57,3,0,273,12,181,35,0,0,228,0,0,0,0,0,0,501
6502,TAMIL NADU,2013,31,MARITAL ISSUES,0,42,88,40,5,175,0,73,41,19,2,135,0,0,0,0,0,0,310
7048,TAMIL NADU,2013,31,MENTAL HEALTH,1,110,161,112,64,448,0,62,96,64,33,255,0,0,0,0,0,0,703
7594,TAMIL NADU,2013,31,OTHERS,92,557,860,724,318,2551,71,399,318,214,111,1113,0,0,0,0,0,0,3664
8178,TAMIL NADU,2013,31,"PHYSICAL ABUSE (RAPE,INCEST ETC.)",0,0,0,0,0,0,0,0,0,0,0,0,0,0,0,0,0,0,0
8685,TAMIL NADU,2013,31,SOCIETAL ISSUES,0,117,104,82,23,326,0,51,74,19,15,159,0,0,0,0,0,0,485
538,TAMIL NADU,2014,31,CAUSES NOT KNOWN,2,143,131,93,63,432,5,63,41,20,16,145,0,0,0,0,0,0,577
1084,TAMIL NADU,2014,31,DEATH OF DEAR PERSON,0,29,37,17,21,104,0,27,12,5,7,51,0,0,0,0,0,0,155
1630,TAMIL NADU,2014,31,DOWRY DISPUTE,0,0,0,0,0,0,0,30,6,0,0,36,0,0,0,0,0,0,36
2176,TAMIL NADU,2014,31,DRUG ABUSE,0,137,243,140,30,550,0,1,0,0,1,2,0,0,0,0,0,0,552
2722,TAMIL NADU,2014,31,ECONOMIC ISSUES,0,205,215,131,16,567,0,43,48,28,5,124,0,0,0,0,0,0,691
3268,TAMIL NADU,2014,31,EXAM FAILURE,12,122,0,0,0,134,13,100,0,0,0,113,0,0,0,0,0,0,247
3814,TAMIL NADU,2014,31,FAMILY PROBLEMS,11,1084,1431,893,239,3658,13,917,619,267,97,1913,0,1,0,0,0,1,5572
4360,TAMIL NADU,2014,31,HEALTH ISSUES,33,1322,1667,1501,894,5417,50,1087,672,509,336,2654,0,4,0,0,0,4,8075
4905,TAMIL NADU,2014,31,HERO WORSHIP,0,18,0,3,1,22,0,1,0,0,0,1,0,0,0,0,0,0,23
5450,TAMIL NADU,2014,31,ILLEGITIMATE PREGNANCY,0,0,0,0,0,0,0,0,0,0,0,0,0,0,0,0,0,0,0
5995,TAMIL NADU,2014,31,LOVE AFFAIRS,0,263,64,0,0,327,0,161,18,0,0,179,0,0,0,0,0,0,506
6541,TAMIL NADU,2014,31,MARITAL ISSUES,0,157,108,66,7,338,1,172,94,24,4,295,0,0,0,0,0,0,633
7087,TAMIL NADU,2014,31,MENTAL HEALTH,1,166,195,183,104,649,4,117,94,53,36,304,0,0,0,0,0,0,953
7633,TAMIL NADU,2014,31,OTHERS,59,633,628,501,156,1977,112,409,241,156,81,999,0,1,0,0,0,1,2977
7672,TAMIL NADU,2014,31,PHYSICAL ABUSE,0,0,0,0,0,0,0,0,0,0,0,0,0,0,0,0,0,0,0
8724,TAMIL NADU,2014,31,SOCIETAL ISSUES,0,0,3,4,0,7,0,0,0,0,1,1,0,0,0,0,0,0,8
32,TELANGANA,2001,32,CAUSES NOT KNOWN,0,0,0,0,0,0,0,0,0,0,0,0,0,0,0,0,0,0,0
578,TELANGANA,2001,32,DEATH OF DEAR PERSON,0,0,0,0,0,0,0,0,0,0,0,0,0,0,0,0,0,0,0
1124,TELANGANA,2001,32,DOWRY DISPUTE,0,0,0,0,0,0,0,0,0,0,0,0,0,0,0,0,0,0,0
1670,TELANGANA,2001,32,DRUG ABUSE,0,0,0,0,0,0,0,0,0,0,0,0,0,0,0,0,0,0,0
2216,TELANGANA,2001,32,ECONOMIC ISSUES,0,0,0,0,0,0,0,0,0,0,0,0,0,0,0,0,0,0,0
2762,TELANGANA,2001,32,EXAM FAILURE,0,0,0,0,0,0,0,0,0,0,0,0,0,0,0,0,0,0,0
3308,TELANGANA,2001,32,FAMILY PROBLEMS,0,0,0,0,0,0,0,0,0,0,0,0,0,0,0,0,0,0,0
3854,TELANGANA,2001,32,HEALTH ISSUES,0,0,0,0,0,0,0,0,0,0,0,0,0,0,0,0,0,0,0
4400,TELANGANA,2001,32,HERO WORSHIP,0,0,0,0,0,0,0,0,0,0,0,0,0,0,0,0,0,0,0
4945,TELANGANA,2001,32,ILLEGITIMATE PREGNANCY,0,0,0,0,0,0,0,0,0,0,0,0,0,0,0,0,0,0,0
5490,TELANGANA,2001,32,LOVE AFFAIRS,0,0,0,0,0,0,0,0,0,0,0,0,0,0,0,0,0,0,0
6035,TELANGANA,2001,32,MARITAL ISSUES,0,0,0,0,0,0,0,0,0,0,0,0,0,0,0,0,0,0,0
6581,TELANGANA,2001,32,MENTAL HEALTH,0,0,0,0,0,0,0,0,0,0,0,0,0,0,0,0,0,0,0
7127,TELANGANA,2001,32,OTHERS,0,0,0,0,0,0,0,0,0,0,0,0,0,0,0,0,0,0,0
7712,TELANGANA,2001,32,"PHYSICAL ABUSE (RAPE,INCEST ETC.)",0,0,0,0,0,0,0,0,0,0,0,0,0,0,0,0,0,0,0
8218,TELANGANA,2001,32,SOCIETAL ISSUES,0,0,0,0,0,0,0,0,0,0,0,0,0,0,0,0,0,0,0
71,TELANGANA,2002,32,CAUSES NOT KNOWN,0,0,0,0,0,0,0,0,0,0,0,0,0,0,0,0,0,0,0
617,TELANGANA,2002,32,DEATH OF DEAR PERSON,0,0,0,0,0,0,0,0,0,0,0,0,0,0,0,0,0,0,0
1163,TELANGANA,2002,32,DOWRY DISPUTE,0,0,0,0,0,0,0,0,0,0,0,0,0,0,0,0,0,0,0
1709,TELANGANA,2002,32,DRUG ABUSE,0,0,0,0,0,0,0,0,0,0,0,0,0,0,0,0,0,0,0
2255,TELANGANA,2002,32,ECONOMIC ISSUES,0,0,0,0,0,0,0,0,0,0,0,0,0,0,0,0,0,0,0
2801,TELANGANA,2002,32,EXAM FAILURE,0,0,0,0,0,0,0,0,0,0,0,0,0,0,0,0,0,0,0
3347,TELANGANA,2002,32,FAMILY PROBLEMS,0,0,0,0,0,0,0,0,0,0,0,0,0,0,0,0,0,0,0
3893,TELANGANA,2002,32,HEALTH ISSUES,0,0,0,0,0,0,0,0,0,0,0,0,0,0,0,0,0,0,0
4439,TELANGANA,2002,32,HERO WORSHIP,0,0,0,0,0,0,0,0,0,0,0,0,0,0,0,0,0,0,0
4984,TELANGANA,2002,32,ILLEGITIMATE PREGNANCY,0,0,0,0,0,0,0,0,0,0,0,0,0,0,0,0,0,0,0
5529,TELANGANA,2002,32,LOVE AFFAIRS,0,0,0,0,0,0,0,0,0,0,0,0,0,0,0,0,0,0,0
6074,TELANGANA,2002,32,MARITAL ISSUES,0,0,0,0,0,0,0,0,0,0,0,0,0,0,0,0,0,0,0
6620,TELANGANA,2002,32,MENTAL HEALTH,0,0,0,0,0,0,0,0,0,0,0,0,0,0,0,0,0,0,0
7166,TELANGANA,2002,32,OTHERS,0,0,0,0,0,0,0,0,0,0,0,0,0,0,0,0,0,0,0
7751,TELANGANA,2002,32,"PHYSICAL ABUSE (RAPE,INCEST ETC.)",0,0,0,0,0,0,0,0,0,0,0,0,0,0,0,0,0,0,0
8257,TELANGANA,2002,32,SOCIETAL ISSUES,0,0,0,0,0,0,0,0,0,0,0,0,0,0,0,0,0,0,0
110,TELANGANA,2003,32,CAUSES NOT KNOWN,0,0,0,0,0,0,0,0,0,0,0,0,0,0,0,0,0,0,0
656,TELANGANA,2003,32,DEATH OF DEAR PERSON,0,0,0,0,0,0,0,0,0,0,0,0,0,0,0,0,0,0,0
1202,TELANGANA,2003,32,DOWRY DISPUTE,0,0,0,0,0,0,0,0,0,0,0,0,0,0,0,0,0,0,0
1748,TELANGANA,2003,32,DRUG ABUSE,0,0,0,0,0,0,0,0,0,0,0,0,0,0,0,0,0,0,0
2294,TELANGANA,2003,32,ECONOMIC ISSUES,0,0,0,0,0,0,0,0,0,0,0,0,0,0,0,0,0,0,0
2840,TELANGANA,2003,32,EXAM FAILURE,0,0,0,0,0,0,0,0,0,0,0,0,0,0,0,0,0,0,0
3386,TELANGANA,2003,32,FAMILY PROBLEMS,0,0,0,0,0,0,0,0,0,0,0,0,0,0,0,0,0,0,0
3932,TELANGANA,2003,32,HEALTH ISSUES,0,0,0,0,0,0,0,0,0,0,0,0,0,0,0,0,0,0,0
4478,TELANGANA,2003,32,HERO WORSHIP,0,0,0,0,0,0,0,0,0,0,0,0,0,0,0,0,0,0,0
5023,TELANGANA,2003,32,ILLEGITIMATE PREGNANCY,0,0,0,0,0,0,0,0,0,0,0,0,0,0,0,0,0,0,0
5568,TELANGANA,2003,32,LOVE AFFAIRS,0,0,0,0,0,0,0,0,0,0,0,0,0,0,0,0,0,0,0
6113,TELANGANA,2003,32,MARITAL ISSUES,0,0,0,0,0,0,0,0,0,0,0,0,0,0,0,0,0,0,0
6659,TELANGANA,2003,32,MENTAL HEALTH,0,0,0,0,0,0,0,0,0,0,0,0,0,0,0,0,0,0,0
7205,TELANGANA,2003,32,OTHERS,0,0,0,0,0,0,0,0,0,0,0,0,0,0,0,0,0,0,0
7790,TELANGANA,2003,32,"PHYSICAL ABUSE (RAPE,INCEST ETC.)",0,0,0,0,0,0,0,0,0,0,0,0,0,0,0,0,0,0,0
8296,TELANGANA,2003,32,SOCIETAL ISSUES,0,0,0,0,0,0,0,0,0,0,0,0,0,0,0,0,0,0,0
149,TELANGANA,2004,32,CAUSES NOT KNOWN,0,0,0,0,0,0,0,0,0,0,0,0,0,0,0,0,0,0,0
695,TELANGANA,2004,32,DEATH OF DEAR PERSON,0,0,0,0,0,0,0,0,0,0,0,0,0,0,0,0,0,0,0
1241,TELANGANA,2004,32,DOWRY DISPUTE,0,0,0,0,0,0,0,0,0,0,0,0,0,0,0,0,0,0,0
1787,TELANGANA,2004,32,DRUG ABUSE,0,0,0,0,0,0,0,0,0,0,0,0,0,0,0,0,0,0,0
2333,TELANGANA,2004,32,ECONOMIC ISSUES,0,0,0,0,0,0,0,0,0,0,0,0,0,0,0,0,0,0,0
2879,TELANGANA,2004,32,EXAM FAILURE,0,0,0,0,0,0,0,0,0,0,0,0,0,0,0,0,0,0,0
3425,TELANGANA,2004,32,FAMILY PROBLEMS,0,0,0,0,0,0,0,0,0,0,0,0,0,0,0,0,0,0,0
3971,TELANGANA,2004,32,HEALTH ISSUES,0,0,0,0,0,0,0,0,0,0,0,0,0,0,0,0,0,0,0
4517,TELANGANA,2004,32,HERO WORSHIP,0,0,0,0,0,0,0,0,0,0,0,0,0,0,0,0,0,0,0
5062,TELANGANA,2004,32,ILLEGITIMATE PREGNANCY,0,0,0,0,0,0,0,0,0,0,0,0,0,0,0,0,0,0,0
5607,TELANGANA,2004,32,LOVE AFFAIRS,0,0,0,0,0,0,0,0,0,0,0,0,0,0,0,0,0,0,0
6152,TELANGANA,2004,32,MARITAL ISSUES,0,0,0,0,0,0,0,0,0,0,0,0,0,0,0,0,0,0,0
6698,TELANGANA,2004,32,MENTAL HEALTH,0,0,0,0,0,0,0,0,0,0,0,0,0,0,0,0,0,0,0
7244,TELANGANA,2004,32,OTHERS,0,0,0,0,0,0,0,0,0,0,0,0,0,0,0,0,0,0,0
7829,TELANGANA,2004,32,"PHYSICAL ABUSE (RAPE,INCEST ETC.)",0,0,0,0,0,0,0,0,0,0,0,0,0,0,0,0,0,0,0
8335,TELANGANA,2004,32,SOCIETAL ISSUES,0,0,0,0,0,0,0,0,0,0,0,0,0,0,0,0,0,0,0
188,TELANGANA,2005,32,CAUSES NOT KNOWN,0,0,0,0,0,0,0,0,0,0,0,0,0,0,0,0,0,0,0
734,TELANGANA,2005,32,DEATH OF DEAR PERSON,0,0,0,0,0,0,0,0,0,0,0,0,0,0,0,0,0,0,0
1280,TELANGANA,2005,32,DOWRY DISPUTE,0,0,0,0,0,0,0,0,0,0,0,0,0,0,0,0,0,0,0
1826,TELANGANA,2005,32,DRUG ABUSE,0,0,0,0,0,0,0,0,0,0,0,0,0,0,0,0,0,0,0
2372,TELANGANA,2005,32,ECONOMIC ISSUES,0,0,0,0,0,0,0,0,0,0,0,0,0,0,0,0,0,0,0
2918,TELANGANA,2005,32,EXAM FAILURE,0,0,0,0,0,0,0,0,0,0,0,0,0,0,0,0,0,0,0
3464,TELANGANA,2005,32,FAMILY PROBLEMS,0,0,0,0,0,0,0,0,0,0,0,0,0,0,0,0,0,0,0
4010,TELANGANA,2005,32,HEALTH ISSUES,0,0,0,0,0,0,0,0,0,0,0,0,0,0,0,0,0,0,0
4556,TELANGANA,2005,32,HERO WORSHIP,0,0,0,0,0,0,0,0,0,0,0,0,0,0,0,0,0,0,0
5101,TELANGANA,2005,32,ILLEGITIMATE PREGNANCY,0,0,0,0,0,0,0,0,0,0,0,0,0,0,0,0,0,0,0
5646,TELANGANA,2005,32,LOVE AFFAIRS,0,0,0,0,0,0,0,0,0,0,0,0,0,0,0,0,0,0,0
6191,TELANGANA,2005,32,MARITAL ISSUES,0,0,0,0,0,0,0,0,0,0,0,0,0,0,0,0,0,0,0
6737,TELANGANA,2005,32,MENTAL HEALTH,0,0,0,0,0,0,0,0,0,0,0,0,0,0,0,0,0,0,0
7283,TELANGANA,2005,32,OTHERS,0,0,0,0,0,0,0,0,0,0,0,0,0,0,0,0,0,0,0
7868,TELANGANA,2005,32,"PHYSICAL ABUSE (RAPE,INCEST ETC.)",0,0,0,0,0,0,0,0,0,0,0,0,0,0,0,0,0,0,0
8374,TELANGANA,2005,32,SOCIETAL ISSUES,0,0,0,0,0,0,0,0,0,0,0,0,0,0,0,0,0,0,0
227,TELANGANA,2006,32,CAUSES NOT KNOWN,0,0,0,0,0,0,0,0,0,0,0,0,0,0,0,0,0,0,0
773,TELANGANA,2006,32,DEATH OF DEAR PERSON,0,0,0,0,0,0,0,0,0,0,0,0,0,0,0,0,0,0,0
1319,TELANGANA,2006,32,DOWRY DISPUTE,0,0,0,0,0,0,0,0,0,0,0,0,0,0,0,0,0,0,0
1865,TELANGANA,2006,32,DRUG ABUSE,0,0,0,0,0,0,0,0,0,0,0,0,0,0,0,0,0,0,0
2411,TELANGANA,2006,32,ECONOMIC ISSUES,0,0,0,0,0,0,0,0,0,0,0,0,0,0,0,0,0,0,0
2957,TELANGANA,2006,32,EXAM FAILURE,0,0,0,0,0,0,0,0,0,0,0,0,0,0,0,0,0,0,0
3503,TELANGANA,2006,32,FAMILY PROBLEMS,0,0,0,0,0,0,0,0,0,0,0,0,0,0,0,0,0,0,0
4049,TELANGANA,2006,32,HEALTH ISSUES,0,0,0,0,0,0,0,0,0,0,0,0,0,0,0,0,0,0,0
4594,TELANGANA,2006,32,HERO WORSHIP,0,0,0,0,0,0,0,0,0,0,0,0,0,0,0,0,0,0,0
5139,TELANGANA,2006,32,ILLEGITIMATE PREGNANCY,0,0,0,0,0,0,0,0,0,0,0,0,0,0,0,0,0,0,0
5684,TELANGANA,2006,32,LOVE AFFAIRS,0,0,0,0,0,0,0,0,0,0,0,0,0,0,0,0,0,0,0
6230,TELANGANA,2006,32,MARITAL ISSUES,0,0,0,0,0,0,0,0,0,0,0,0,0,0,0,0,0,0,0
6776,TELANGANA,2006,32,MENTAL HEALTH,0,0,0,0,0,0,0,0,0,0,0,0,0,0,0,0,0,0,0
7322,TELANGANA,2006,32,OTHERS,0,0,0,0,0,0,0,0,0,0,0,0,0,0,0,0,0,0,0
7906,TELANGANA,2006,32,"PHYSICAL ABUSE (RAPE,INCEST ETC.)",0,0,0,0,0,0,0,0,0,0,0,0,0,0,0,0,0,0,0
8413,TELANGANA,2006,32,SOCIETAL ISSUES,0,0,0,0,0,0,0,0,0,0,0,0,0,0,0,0,0,0,0
266,TELANGANA,2007,32,CAUSES NOT KNOWN,0,0,0,0,0,0,0,0,0,0,0,0,0,0,0,0,0,0,0
812,TELANGANA,2007,32,DEATH OF DEAR PERSON,0,0,0,0,0,0,0,0,0,0,0,0,0,0,0,0,0,0,0
1358,TELANGANA,2007,32,DOWRY DISPUTE,0,0,0,0,0,0,0,0,0,0,0,0,0,0,0,0,0,0,0
1904,TELANGANA,2007,32,DRUG ABUSE,0,0,0,0,0,0,0,0,0,0,0,0,0,0,0,0,0,0,0
2450,TELANGANA,2007,32,ECONOMIC ISSUES,0,0,0,0,0,0,0,0,0,0,0,0,0,0,0,0,0,0,0
2996,TELANGANA,2007,32,EXAM FAILURE,0,0,0,0,0,0,0,0,0,0,0,0,0,0,0,0,0,0,0
3542,TELANGANA,2007,32,FAMILY PROBLEMS,0,0,0,0,0,0,0,0,0,0,0,0,0,0,0,0,0,0,0
4088,TELANGANA,2007,32,HEALTH ISSUES,0,0,0,0,0,0,0,0,0,0,0,0,0,0,0,0,0,0,0
4633,TELANGANA,2007,32,HERO WORSHIP,0,0,0,0,0,0,0,0,0,0,0,0,0,0,0,0,0,0,0
5178,TELANGANA,2007,32,ILLEGITIMATE PREGNANCY,0,0,0,0,0,0,0,0,0,0,0,0,0,0,0,0,0,0,0
5723,TELANGANA,2007,32,LOVE AFFAIRS,0,0,0,0,0,0,0,0,0,0,0,0,0,0,0,0,0,0,0
6269,TELANGANA,2007,32,MARITAL ISSUES,0,0,0,0,0,0,0,0,0,0,0,0,0,0,0,0,0,0,0
6815,TELANGANA,2007,32,MENTAL HEALTH,0,0,0,0,0,0,0,0,0,0,0,0,0,0,0,0,0,0,0
7361,TELANGANA,2007,32,OTHERS,0,0,0,0,0,0,0,0,0,0,0,0,0,0,0,0,0,0,0
7945,TELANGANA,2007,32,"PHYSICAL ABUSE (RAPE,INCEST ETC.)",0,0,0,0,0,0,0,0,0,0,0,0,0,0,0,0,0,0,0
8452,TELANGANA,2007,32,SOCIETAL ISSUES,0,0,0,0,0,0,0,0,0,0,0,0,0,0,0,0,0,0,0
305,TELANGANA,2008,32,CAUSES NOT KNOWN,0,0,0,0,0,0,0,0,0,0,0,0,0,0,0,0,0,0,0
851,TELANGANA,2008,32,DEATH OF DEAR PERSON,0,0,0,0,0,0,0,0,0,0,0,0,0,0,0,0,0,0,0
1397,TELANGANA,2008,32,DOWRY DISPUTE,0,0,0,0,0,0,0,0,0,0,0,0,0,0,0,0,0,0,0
1943,TELANGANA,2008,32,DRUG ABUSE,0,0,0,0,0,0,0,0,0,0,0,0,0,0,0,0,0,0,0
2489,TELANGANA,2008,32,ECONOMIC ISSUES,0,0,0,0,0,0,0,0,0,0,0,0,0,0,0,0,0,0,0
3035,TELANGANA,2008,32,EXAM FAILURE,0,0,0,0,0,0,0,0,0,0,0,0,0,0,0,0,0,0,0
3581,TELANGANA,2008,32,FAMILY PROBLEMS,0,0,0,0,0,0,0,0,0,0,0,0,0,0,0,0,0,0,0
4127,TELANGANA,2008,32,HEALTH ISSUES,0,0,0,0,0,0,0,0,0,0,0,0,0,0,0,0,0,0,0
4672,TELANGANA,2008,32,HERO WORSHIP,0,0,0,0,0,0,0,0,0,0,0,0,0,0,0,0,0,0,0
5217,TELANGANA,2008,32,ILLEGITIMATE PREGNANCY,0,0,0,0,0,0,0,0,0,0,0,0,0,0,0,0,0,0,0
5762,TELANGANA,2008,32,LOVE AFFAIRS,0,0,0,0,0,0,0,0,0,0,0,0,0,0,0,0,0,0,0
6308,TELANGANA,2008,32,MARITAL ISSUES,0,0,0,0,0,0,0,0,0,0,0,0,0,0,0,0,0,0,0
6854,TELANGANA,2008,32,MENTAL HEALTH,0,0,0,0,0,0,0,0,0,0,0,0,0,0,0,0,0,0,0
7400,TELANGANA,2008,32,OTHERS,0,0,0,0,0,0,0,0,0,0,0,0,0,0,0,0,0,0,0
7984,TELANGANA,2008,32,"PHYSICAL ABUSE (RAPE,INCEST ETC.)",0,0,0,0,0,0,0,0,0,0,0,0,0,0,0,0,0,0,0
8491,TELANGANA,2008,32,SOCIETAL ISSUES,0,0,0,0,0,0,0,0,0,0,0,0,0,0,0,0,0,0,0
344,TELANGANA,2009,32,CAUSES NOT KNOWN,0,0,0,0,0,0,0,0,0,0,0,0,0,0,0,0,0,0,0
890,TELANGANA,2009,32,DEATH OF DEAR PERSON,0,0,0,0,0,0,0,0,0,0,0,0,0,0,0,0,0,0,0
1436,TELANGANA,2009,32,DOWRY DISPUTE,0,0,0,0,0,0,0,0,0,0,0,0,0,0,0,0,0,0,0
1982,TELANGANA,2009,32,DRUG ABUSE,0,0,0,0,0,0,0,0,0,0,0,0,0,0,0,0,0,0,0
2528,TELANGANA,2009,32,ECONOMIC ISSUES,0,0,0,0,0,0,0,0,0,0,0,0,0,0,0,0,0,0,0
3074,TELANGANA,2009,32,EXAM FAILURE,0,0,0,0,0,0,0,0,0,0,0,0,0,0,0,0,0,0,0
3620,TELANGANA,2009,32,FAMILY PROBLEMS,0,0,0,0,0,0,0,0,0,0,0,0,0,0,0,0,0,0,0
4166,TELANGANA,2009,32,HEALTH ISSUES,0,0,0,0,0,0,0,0,0,0,0,0,0,0,0,0,0,0,0
4711,TELANGANA,2009,32,HERO WORSHIP,0,0,0,0,0,0,0,0,0,0,0,0,0,0,0,0,0,0,0
5256,TELANGANA,2009,32,ILLEGITIMATE PREGNANCY,0,0,0,0,0,0,0,0,0,0,0,0,0,0,0,0,0,0,0
5801,TELANGANA,2009,32,LOVE AFFAIRS,0,0,0,0,0,0,0,0,0,0,0,0,0,0,0,0,0,0,0
6347,TELANGANA,2009,32,MARITAL ISSUES,0,0,0,0,0,0,0,0,0,0,0,0,0,0,0,0,0,0,0
6893,TELANGANA,2009,32,MENTAL HEALTH,0,0,0,0,0,0,0,0,0,0,0,0,0,0,0,0,0,0,0
7439,TELANGANA,2009,32,OTHERS,0,0,0,0,0,0,0,0,0,0,0,0,0,0,0,0,0,0,0
8023,TELANGANA,2009,32,"PHYSICAL ABUSE (RAPE,INCEST ETC.)",0,0,0,0,0,0,0,0,0,0,0,0,0,0,0,0,0,0,0
8530,TELANGANA,2009,32,SOCIETAL ISSUES,0,0,0,0,0,0,0,0,0,0,0,0,0,0,0,0,0,0,0
383,TELANGANA,2010,32,CAUSES NOT KNOWN,0,0,0,0,0,0,0,0,0,0,0,0,0,0,0,0,0,0,0
929,TELANGANA,2010,32,DEATH OF DEAR PERSON,0,0,0,0,0,0,0,0,0,0,0,0,0,0,0,0,0,0,0
1475,TELANGANA,2010,32,DOWRY DISPUTE,0,0,0,0,0,0,0,0,0,0,0,0,0,0,0,0,0,0,0
2021,TELANGANA,2010,32,DRUG ABUSE,0,0,0,0,0,0,0,0,0,0,0,0,0,0,0,0,0,0,0
2567,TELANGANA,2010,32,ECONOMIC ISSUES,0,0,0,0,0,0,0,0,0,0,0,0,0,0,0,0,0,0,0
3113,TELANGANA,2010,32,EXAM FAILURE,0,0,0,0,0,0,0,0,0,0,0,0,0,0,0,0,0,0,0
3659,TELANGANA,2010,32,FAMILY PROBLEMS,0,0,0,0,0,0,0,0,0,0,0,0,0,0,0,0,0,0,0
4205,TELANGANA,2010,32,HEALTH ISSUES,0,0,0,0,0,0,0,0,0,0,0,0,0,0,0,0,0,0,0
4750,TELANGANA,2010,32,HERO WORSHIP,0,0,0,0,0,0,0,0,0,0,0,0,0,0,0,0,0,0,0
5295,TELANGANA,2010,32,ILLEGITIMATE PREGNANCY,0,0,0,0,0,0,0,0,0,0,0,0,0,0,0,0,0,0,0
5840,TELANGANA,2010,32,LOVE AFFAIRS,0,0,0,0,0,0,0,0,0,0,0,0,0,0,0,0,0,0,0
6386,TELANGANA,2010,32,MARITAL ISSUES,0,0,0,0,0,0,0,0,0,0,0,0,0,0,0,0,0,0,0
6932,TELANGANA,2010,32,MENTAL HEALTH,0,0,0,0,0,0,0,0,0,0,0,0,0,0,0,0,0,0,0
7478,TELANGANA,2010,32,OTHERS,0,0,0,0,0,0,0,0,0,0,0,0,0,0,0,0,0,0,0
8062,TELANGANA,2010,32,"PHYSICAL ABUSE (RAPE,INCEST ETC.)",0,0,0,0,0,0,0,0,0,0,0,0,0,0,0,0,0,0,0
8569,TELANGANA,2010,32,SOCIETAL ISSUES,0,0,0,0,0,0,0,0,0,0,0,0,0,0,0,0,0,0,0
422,TELANGANA,2011,32,CAUSES NOT KNOWN,0,0,0,0,0,0,0,0,0,0,0,0,0,0,0,0,0,0,0
968,TELANGANA,2011,32,DEATH OF DEAR PERSON,0,0,0,0,0,0,0,0,0,0,0,0,0,0,0,0,0,0,0
1514,TELANGANA,2011,32,DOWRY DISPUTE,0,0,0,0,0,0,0,0,0,0,0,0,0,0,0,0,0,0,0
2060,TELANGANA,2011,32,DRUG ABUSE,0,0,0,0,0,0,0,0,0,0,0,0,0,0,0,0,0,0,0
2606,TELANGANA,2011,32,ECONOMIC ISSUES,0,0,0,0,0,0,0,0,0,0,0,0,0,0,0,0,0,0,0
3152,TELANGANA,2011,32,EXAM FAILURE,0,0,0,0,0,0,0,0,0,0,0,0,0,0,0,0,0,0,0
3698,TELANGANA,2011,32,FAMILY PROBLEMS,0,0,0,0,0,0,0,0,0,0,0,0,0,0,0,0,0,0,0
4244,TELANGANA,2011,32,HEALTH ISSUES,0,0,0,0,0,0,0,0,0,0,0,0,0,0,0,0,0,0,0
4789,TELANGANA,2011,32,HERO WORSHIP,0,0,0,0,0,0,0,0,0,0,0,0,0,0,0,0,0,0,0
5334,TELANGANA,2011,32,ILLEGITIMATE PREGNANCY,0,0,0,0,0,0,0,0,0,0,0,0,0,0,0,0,0,0,0
5879,TELANGANA,2011,32,LOVE AFFAIRS,0,0,0,0,0,0,0,0,0,0,0,0,0,0,0,0,0,0,0
6425,TELANGANA,2011,32,MARITAL ISSUES,0,0,0,0,0,0,0,0,0,0,0,0,0,0,0,0,0,0,0
6971,TELANGANA,2011,32,MENTAL HEALTH,0,0,0,0,0,0,0,0,0,0,0,0,0,0,0,0,0,0,0
7517,TELANGANA,2011,32,OTHERS,0,0,0,0,0,0,0,0,0,0,0,0,0,0,0,0,0,0,0
8101,TELANGANA,2011,32,"PHYSICAL ABUSE (RAPE,INCEST ETC.)",0,0,0,0,0,0,0,0,0,0,0,0,0,0,0,0,0,0,0
8608,TELANGANA,2011,32,SOCIETAL ISSUES,0,0,0,0,0,0,0,0,0,0,0,0,0,0,0,0,0,0,0
461,TELANGANA,2012,32,CAUSES NOT KNOWN,0,0,0,0,0,0,0,0,0,0,0,0,0,0,0,0,0,0,0
1007,TELANGANA,2012,32,DEATH OF DEAR PERSON,0,0,0,0,0,0,0,0,0,0,0,0,0,0,0,0,0,0,0
1553,TELANGANA,2012,32,DOWRY DISPUTE,0,0,0,0,0,0,0,0,0,0,0,0,0,0,0,0,0,0,0
2099,TELANGANA,2012,32,DRUG ABUSE,0,0,0,0,0,0,0,0,0,0,0,0,0,0,0,0,0,0,0
2645,TELANGANA,2012,32,ECONOMIC ISSUES,0,0,0,0,0,0,0,0,0,0,0,0,0,0,0,0,0,0,0
3191,TELANGANA,2012,32,EXAM FAILURE,0,0,0,0,0,0,0,0,0,0,0,0,0,0,0,0,0,0,0
3737,TELANGANA,2012,32,FAMILY PROBLEMS,0,0,0,0,0,0,0,0,0,0,0,0,0,0,0,0,0,0,0
4283,TELANGANA,2012,32,HEALTH ISSUES,0,0,0,0,0,0,0,0,0,0,0,0,0,0,0,0,0,0,0
4828,TELANGANA,2012,32,HERO WORSHIP,0,0,0,0,0,0,0,0,0,0,0,0,0,0,0,0,0,0,0
5373,TELANGANA,2012,32,ILLEGITIMATE PREGNANCY,0,0,0,0,0,0,0,0,0,0,0,0,0,0,0,0,0,0,0
5918,TELANGANA,2012,32,LOVE AFFAIRS,0,0,0,0,0,0,0,0,0,0,0,0,0,0,0,0,0,0,0
6464,TELANGANA,2012,32,MARITAL ISSUES,0,0,0,0,0,0,0,0,0,0,0,0,0,0,0,0,0,0,0
7010,TELANGANA,2012,32,MENTAL HEALTH,0,0,0,0,0,0,0,0,0,0,0,0,0,0,0,0,0,0,0
7556,TELANGANA,2012,32,OTHERS,0,0,0,0,0,0,0,0,0,0,0,0,0,0,0,0,0,0,0
8140,TELANGANA,2012,32,"PHYSICAL ABUSE (RAPE,INCEST ETC.)",0,0,0,0,0,0,0,0,0,0,0,0,0,0,0,0,0,0,0
8647,TELANGANA,2012,32,SOCIETAL ISSUES,0,0,0,0,0,0,0,0,0,0,0,0,0,0,0,0,0,0,0
500,TELANGANA,2013,32,CAUSES NOT KNOWN,0,0,0,0,0,0,0,0,0,0,0,0,0,0,0,0,0,0,0
1046,TELANGANA,2013,32,DEATH OF DEAR PERSON,0,0,0,0,0,0,0,0,0,0,0,0,0,0,0,0,0,0,0
1592,TELANGANA,2013,32,DOWRY DISPUTE,0,0,0,0,0,0,0,0,0,0,0,0,0,0,0,0,0,0,0
2138,TELANGANA,2013,32,DRUG ABUSE,0,0,0,0,0,0,0,0,0,0,0,0,0,0,0,0,0,0,0
2684,TELANGANA,2013,32,ECONOMIC ISSUES,0,0,0,0,0,0,0,0,0,0,0,0,0,0,0,0,0,0,0
3230,TELANGANA,2013,32,EXAM FAILURE,0,0,0,0,0,0,0,0,0,0,0,0,0,0,0,0,0,0,0
3776,TELANGANA,2013,32,FAMILY PROBLEMS,0,0,0,0,0,0,0,0,0,0,0,0,0,0,0,0,0,0,0
4322,TELANGANA,2013,32,HEALTH ISSUES,0,0,0,0,0,0,0,0,0,0,0,0,0,0,0,0,0,0,0
4867,TELANGANA,2013,32,HERO WORSHIP,0,0,0,0,0,0,0,0,0,0,0,0,0,0,0,0,0,0,0
5412,TELANGANA,2013,32,ILLEGITIMATE PREGNANCY,0,0,0,0,0,0,0,0,0,0,0,0,0,0,0,0,0,0,0
5957,TELANGANA,2013,32,LOVE AFFAIRS,0,0,0,0,0,0,0,0,0,0,0,0,0,0,0,0,0,0,0
6503,TELANGANA,2013,32,MARITAL ISSUES,0,0,0,0,0,0,0,0,0,0,0,0,0,0,0,0,0,0,0
7049,TELANGANA,2013,32,MENTAL HEALTH,0,0,0,0,0,0,0,0,0,0,0,0,0,0,0,0,0,0,0
7595,TELANGANA,2013,32,OTHERS,0,0,0,0,0,0,0,0,0,0,0,0,0,0,0,0,0,0,0
8179,TELANGANA,2013,32,"PHYSICAL ABUSE (RAPE,INCEST ETC.)",0,0,0,0,0,0,0,0,0,0,0,0,0,0,0,0,0,0,0
8686,TELANGANA,2013,32,SOCIETAL ISSUES,0,0,0,0,0,0,0,0,0,0,0,0,0,0,0,0,0,0,0
539,TELANGANA,2014,32,CAUSES NOT KNOWN,0,156,116,52,13,337,2,29,16,12,3,62,0,0,0,0,0,0,399
1085,TELANGANA,2014,32,DEATH OF DEAR PERSON,0,11,12,12,4,39,0,7,3,0,7,17,0,0,0,0,0,0,56
1631,TELANGANA,2014,32,DOWRY DISPUTE,0,1,0,0,0,1,0,51,11,0,0,62,0,0,0,0,0,0,63
2177,TELANGANA,2014,32,DRUG ABUSE,0,38,38,29,4,109,1,1,4,3,1,10,0,0,0,0,0,0,119
2723,TELANGANA,2014,32,ECONOMIC ISSUES,0,366,613,367,102,1448,1,70,82,29,5,187,0,0,0,0,0,0,1635
3269,TELANGANA,2014,32,EXAM FAILURE,1,51,1,0,0,53,2,42,0,0,0,44,0,0,0,0,0,0,97
3815,TELANGANA,2014,32,FAMILY PROBLEMS,2,361,420,156,60,999,10,241,182,61,33,527,0,0,0,0,0,0,1526
4361,TELANGANA,2014,32,HEALTH ISSUES,7,577,650,511,462,2207,18,529,336,210,274,1367,0,0,0,0,0,0,3574
4906,TELANGANA,2014,32,HERO WORSHIP,0,0,0,0,0,0,0,0,0,0,0,0,0,0,0,0,0,0,0
5451,TELANGANA,2014,32,ILLEGITIMATE PREGNANCY,0,0,0,0,0,0,0,0,0,0,0,0,0,0,0,0,0,0,0
5996,TELANGANA,2014,32,LOVE AFFAIRS,0,77,10,0,0,87,0,49,2,0,0,51,0,0,0,0,0,0,138
6542,TELANGANA,2014,32,MARITAL ISSUES,0,67,48,8,0,123,0,126,82,7,10,225,0,0,0,0,0,0,348
7088,TELANGANA,2014,32,MENTAL HEALTH,1,73,70,65,18,227,2,63,42,36,16,159,0,0,0,0,0,0,386
7634,TELANGANA,2014,32,OTHERS,18,742,783,584,197,2324,12,437,330,229,150,1158,0,0,0,0,0,0,3482
7673,TELANGANA,2014,32,PHYSICAL ABUSE,0,0,0,0,0,0,0,0,0,0,0,0,0,0,0,0,0,0,0
8725,TELANGANA,2014,32,SOCIETAL ISSUES,0,0,3,3,0,6,0,1,0,0,0,1,0,0,0,0,0,0,7
33,TOTAL (ALL INDIA),2001,37,CAUSES NOT KNOWN,484,3908,4781,2773,1081,13027,441,3149,2340,1144,484,7558,0,0,0,0,0,0,20585
579,TOTAL (ALL INDIA),2001,37,DEATH OF DEAR PERSON,6,107,145,109,74,441,13,179,136,69,33,430,0,0,0,0,0,0,871
1125,TOTAL (ALL INDIA),2001,37,DOWRY DISPUTE,0,26,16,2,0,44,1,1784,562,23,0,2370,0,0,0,0,0,0,2414
1671,TOTAL (ALL INDIA),2001,37,DRUG ABUSE,13,339,588,333,64,1337,6,33,18,16,4,77,0,0,0,0,0,0,1414
2217,TOTAL (ALL INDIA),2001,37,ECONOMIC ISSUES,41,2278,3467,2134,567,8487,27,692,813,484,154,2170,0,0,0,0,0,0,10657
2763,TOTAL (ALL INDIA),2001,37,EXAM FAILURE,224,887,59,8,0,1178,163,684,34,3,0,884,0,0,0,0,0,0,2062
3309,TOTAL (ALL INDIA),2001,37,FAMILY PROBLEMS,170,4437,5310,3044,938,13899,195,4616,3601,1397,454,10263,0,0,0,0,0,0,24162
3855,TOTAL (ALL INDIA),2001,37,HEALTH ISSUES,111,2602,3688,3567,1791,11759,134,2150,1948,1466,783,6481,0,0,0,0,0,0,18240
4401,TOTAL (ALL INDIA),2001,37,HERO WORSHIP,1,18,15,20,1,55,0,33,10,6,0,49,0,0,0,0,0,0,104
4946,TOTAL (ALL INDIA),2001,37,ILLEGITIMATE PREGNANCY,0,21,9,0,0,30,5,244,83,7,0,339,0,0,0,0,0,0,369
5491,TOTAL (ALL INDIA),2001,37,LOVE AFFAIRS,26,1130,401,43,1,1601,71,1142,273,27,0,1513,0,0,0,0,0,0,3114
6036,TOTAL (ALL INDIA),2001,37,MARITAL ISSUES,7,559,478,144,32,1220,22,1169,665,136,5,1997,0,0,0,0,0,0,3217
6582,TOTAL (ALL INDIA),2001,37,MENTAL HEALTH,41,948,1332,922,434,3677,43,682,710,466,280,2181,0,0,0,0,0,0,5858
7128,TOTAL (ALL INDIA),2001,37,OTHERS,362,2443,2927,2089,851,8672,370,2013,1530,866,403,5182,0,0,0,0,0,0,13854
7713,TOTAL (ALL INDIA),2001,37,"PHYSICAL ABUSE (RAPE,INCEST ETC.)",1,43,34,23,8,109,10,173,69,11,4,267,0,0,0,0,0,0,376
8219,TOTAL (ALL INDIA),2001,37,SOCIETAL ISSUES,11,235,253,197,82,778,8,186,153,50,34,431,0,0,0,0,0,0,1209
72,TOTAL (ALL INDIA),2002,37,CAUSES NOT KNOWN,391,4135,4540,2894,1168,13128,360,2605,2051,1091,471,6578,0,0,0,0,0,0,19706
618,TOTAL (ALL INDIA),2002,37,DEATH OF DEAR PERSON,5,109,137,91,49,391,6,128,88,59,29,310,0,0,0,0,0,0,701
1164,TOTAL (ALL INDIA),2002,37,DOWRY DISPUTE,0,18,10,4,0,32,116,1712,508,39,3,2378,0,0,0,0,0,0,2410
1710,TOTAL (ALL INDIA),2002,37,DRUG ABUSE,5,403,717,400,74,1599,8,40,30,21,11,110,0,0,0,0,0,0,1709
2256,TOTAL (ALL INDIA),2002,37,ECONOMIC ISSUES,32,2115,3176,2032,501,7856,24,626,641,328,101,1720,0,0,0,0,0,0,9576
2802,TOTAL (ALL INDIA),2002,37,EXAM FAILURE,181,1016,68,3,0,1268,176,754,50,2,0,982,0,0,0,0,0,0,2250
3348,TOTAL (ALL INDIA),2002,37,FAMILY PROBLEMS,190,4537,5672,3249,1104,14752,251,4780,3422,1421,459,10333,0,0,0,0,0,0,25085
3894,TOTAL (ALL INDIA),2002,37,HEALTH ISSUES,84,2632,4255,3745,2131,12847,153,2169,2065,1478,814,6679,0,0,0,0,0,0,19526
4440,TOTAL (ALL INDIA),2002,37,HERO WORSHIP,0,19,10,13,9,51,0,14,11,7,4,36,0,0,0,0,0,0,87
4985,TOTAL (ALL INDIA),2002,37,ILLEGITIMATE PREGNANCY,0,7,0,1,0,8,9,166,79,5,0,259,0,0,0,0,0,0,267
5530,TOTAL (ALL INDIA),2002,37,LOVE AFFAIRS,5,1132,448,35,2,1622,58,1076,324,21,0,1479,0,0,0,0,0,0,3101
6075,TOTAL (ALL INDIA),2002,37,MARITAL ISSUES,3,595,468,188,16,1270,5,1221,764,164,11,2165,0,0,0,0,0,0,3435
6621,TOTAL (ALL INDIA),2002,37,MENTAL HEALTH,39,1148,1526,982,467,4162,45,713,799,483,238,2278,0,0,0,0,0,0,6440
7167,TOTAL (ALL INDIA),2002,37,OTHERS,351,2820,3485,2142,778,9576,342,2108,1692,727,375,5244,0,0,0,0,0,0,14820
7752,TOTAL (ALL INDIA),2002,37,"PHYSICAL ABUSE (RAPE,INCEST ETC.)",0,76,63,30,6,175,18,140,72,19,6,255,0,0,0,0,0,0,430
8258,TOTAL (ALL INDIA),2002,37,SOCIETAL ISSUES,20,155,236,146,38,595,3,119,105,37,15,279,0,0,0,0,0,0,874
111,TOTAL (ALL INDIA),2003,37,CAUSES NOT KNOWN,364,3885,4025,2467,1024,11765,328,2359,1742,1025,412,5866,0,0,0,0,0,0,17631
657,TOTAL (ALL INDIA),2003,37,DEATH OF DEAR PERSON,6,187,179,155,56,583,12,194,135,59,27,427,0,0,0,0,0,0,1010
1203,TOTAL (ALL INDIA),2003,37,DOWRY DISPUTE,4,15,47,33,1,100,11,1732,555,47,2,2347,0,0,0,0,0,0,2447
1749,TOTAL (ALL INDIA),2003,37,DRUG ABUSE,4,369,726,447,121,1667,2,45,29,15,5,96,0,0,0,0,0,0,1763
2295,TOTAL (ALL INDIA),2003,37,ECONOMIC ISSUES,31,2322,3564,2143,550,8610,29,668,735,400,134,1966,0,0,0,0,0,0,10576
2841,TOTAL (ALL INDIA),2003,37,EXAM FAILURE,150,940,91,0,0,1181,164,866,43,1,0,1074,0,0,0,0,0,0,2255
3387,TOTAL (ALL INDIA),2003,37,FAMILY PROBLEMS,185,4882,5892,3656,1163,15778,194,4623,3432,1686,595,10530,0,0,0,0,0,0,26308
3933,TOTAL (ALL INDIA),2003,37,HEALTH ISSUES,110,2487,3562,3206,1899,11264,133,1982,2020,1352,820,6307,0,0,0,0,0,0,17571
4479,TOTAL (ALL INDIA),2003,37,HERO WORSHIP,0,58,71,40,8,177,2,41,12,9,1,65,0,0,0,0,0,0,242
5024,TOTAL (ALL INDIA),2003,37,ILLEGITIMATE PREGNANCY,0,0,2,0,1,3,1,172,62,11,0,246,0,0,0,0,0,0,249
5569,TOTAL (ALL INDIA),2003,37,LOVE AFFAIRS,28,1465,577,61,1,2132,58,1351,421,34,0,1864,0,0,0,0,0,0,3996
6114,TOTAL (ALL INDIA),2003,37,MARITAL ISSUES,8,536,555,193,16,1308,13,1039,733,166,5,1956,0,0,0,0,0,0,3264
6660,TOTAL (ALL INDIA),2003,37,MENTAL HEALTH,42,1255,1739,1130,544,4710,58,802,875,598,280,2613,0,0,0,0,0,0,7323
7206,TOTAL (ALL INDIA),2003,37,OTHERS,332,3079,3305,2398,1009,10123,262,1969,1371,734,342,4678,0,0,0,0,0,0,14801
7791,TOTAL (ALL INDIA),2003,37,"PHYSICAL ABUSE (RAPE,INCEST ETC.)",6,65,92,41,23,227,14,150,74,28,10,276,0,0,0,0,0,0,503
8297,TOTAL (ALL INDIA),2003,37,SOCIETAL ISSUES,8,152,252,141,40,593,17,138,99,56,9,319,0,0,0,0,0,0,912
150,TOTAL (ALL INDIA),2004,37,CAUSES NOT KNOWN,342,3865,4515,2947,1162,12831,316,2519,1858,900,388,5981,0,0,0,0,0,0,18812
696,TOTAL (ALL INDIA),2004,37,DEATH OF DEAR PERSON,7,127,138,106,64,442,10,114,94,58,31,307,0,0,0,0,0,0,749
1242,TOTAL (ALL INDIA),2004,37,DOWRY DISPUTE,0,27,17,7,2,53,10,2010,533,32,0,2585,0,0,0,0,0,0,2638
1788,TOTAL (ALL INDIA),2004,37,DRUG ABUSE,7,452,831,458,95,1843,0,37,34,11,2,84,0,0,0,0,0,0,1927
2334,TOTAL (ALL INDIA),2004,37,ECONOMIC ISSUES,37,2523,3834,2524,596,9514,23,688,867,531,135,2244,0,0,0,0,0,0,11758
2880,TOTAL (ALL INDIA),2004,37,EXAM FAILURE,223,1058,136,17,2,1436,233,773,51,3,0,1060,0,0,0,0,0,0,2496
3426,TOTAL (ALL INDIA),2004,37,FAMILY PROBLEMS,192,4448,5956,3672,1056,15324,194,4660,3399,1470,484,10207,0,0,0,0,0,0,25531
3972,TOTAL (ALL INDIA),2004,37,HEALTH ISSUES,94,2589,3846,3327,2069,11925,129,2068,1940,1428,845,6410,0,0,0,0,0,0,18335
4518,TOTAL (ALL INDIA),2004,37,HERO WORSHIP,1,13,22,7,6,49,2,20,9,0,1,32,0,0,0,0,0,0,81
5063,TOTAL (ALL INDIA),2004,37,ILLEGITIMATE PREGNANCY,0,5,4,2,0,11,6,121,61,5,0,193,0,0,0,0,0,0,204
5608,TOTAL (ALL INDIA),2004,37,LOVE AFFAIRS,22,1398,541,55,2,2018,58,1248,444,31,0,1781,0,0,0,0,0,0,3799
6153,TOTAL (ALL INDIA),2004,37,MARITAL ISSUES,5,569,471,145,12,1202,8,1084,634,108,3,1837,0,0,0,0,0,0,3039
6699,TOTAL (ALL INDIA),2004,37,MENTAL HEALTH,66,1253,1588,1203,551,4661,57,803,826,538,232,2456,0,0,0,0,0,0,7117
7245,TOTAL (ALL INDIA),2004,37,OTHERS,467,3073,3733,2476,986,10735,394,2168,1557,910,431,5460,0,0,0,0,0,0,16195
7830,TOTAL (ALL INDIA),2004,37,"PHYSICAL ABUSE (RAPE,INCEST ETC.)",0,41,39,11,10,101,1,112,71,17,4,205,0,0,0,0,0,0,306
8336,TOTAL (ALL INDIA),2004,37,SOCIETAL ISSUES,4,176,179,108,39,506,5,94,68,32,5,204,0,0,0,0,0,0,710
189,TOTAL (ALL INDIA),2005,37,CAUSES NOT KNOWN,276,3901,4075,2626,911,11789,223,2494,1699,959,281,5656,0,0,0,0,0,0,17445
735,TOTAL (ALL INDIA),2005,37,DEATH OF DEAR PERSON,4,106,185,120,59,474,7,95,154,68,22,346,0,0,0,0,0,0,820
1281,TOTAL (ALL INDIA),2005,37,DOWRY DISPUTE,2,17,24,3,0,46,0,1727,536,39,3,2305,0,0,0,0,0,0,2351
1827,TOTAL (ALL INDIA),2005,37,DRUG ABUSE,7,460,896,484,104,1951,2,30,28,10,11,81,0,0,0,0,0,0,2032
2373,TOTAL (ALL INDIA),2005,37,ECONOMIC ISSUES,21,2021,3383,2381,538,8344,26,550,702,386,101,1765,0,0,0,0,0,0,10109
2919,TOTAL (ALL INDIA),2005,37,EXAM FAILURE,185,1002,79,14,0,1280,265,687,43,6,2,1003,0,0,0,0,0,0,2283
3465,TOTAL (ALL INDIA),2005,37,FAMILY PROBLEMS,161,4450,5876,3781,1089,15357,163,4625,3171,1577,548,10084,0,0,0,0,0,0,25441
4011,TOTAL (ALL INDIA),2005,37,HEALTH ISSUES,90,2334,3488,3201,2149,11262,121,1994,1757,1362,961,6195,0,0,0,0,0,0,17457
4557,TOTAL (ALL INDIA),2005,37,HERO WORSHIP,5,29,45,42,20,141,1,40,18,10,5,74,0,0,0,0,0,0,215
5102,TOTAL (ALL INDIA),2005,37,ILLEGITIMATE PREGNANCY,1,4,2,0,0,7,3,116,41,4,0,164,0,0,0,0,0,0,171
5647,TOTAL (ALL INDIA),2005,37,LOVE AFFAIRS,37,1251,491,43,4,1826,59,1281,315,14,1,1670,0,0,0,0,0,0,3496
6192,TOTAL (ALL INDIA),2005,37,MARITAL ISSUES,17,589,497,194,30,1327,30,1052,706,150,4,1942,0,0,0,0,0,0,3269
6738,TOTAL (ALL INDIA),2005,37,MENTAL HEALTH,33,1334,1757,1266,557,4947,40,845,832,623,317,2657,0,0,0,0,0,0,7604
7284,TOTAL (ALL INDIA),2005,37,OTHERS,479,3906,4763,2845,1070,13063,271,2518,2052,1109,434,6384,0,0,0,0,0,0,19447
7869,TOTAL (ALL INDIA),2005,37,"PHYSICAL ABUSE (RAPE,INCEST ETC.)",2,25,26,13,1,67,5,94,26,9,1,135,0,0,0,0,0,0,202
8375,TOTAL (ALL INDIA),2005,37,SOCIETAL ISSUES,8,394,345,223,65,1035,11,263,171,63,29,537,0,0,0,0,0,0,1572
228,TOTAL (ALL INDIA),2006,37,CAUSES NOT KNOWN,298,4052,4151,2476,842,11819,249,2434,1641,737,279,5340,0,0,0,0,0,0,17159
774,TOTAL (ALL INDIA),2006,37,DEATH OF DEAR PERSON,5,104,188,135,48,480,7,122,121,124,25,399,0,0,0,0,0,0,879
1320,TOTAL (ALL INDIA),2006,37,DOWRY DISPUTE,0,32,27,1,0,60,1,1720,533,21,1,2276,0,0,0,0,0,0,2336
1866,TOTAL (ALL INDIA),2006,37,DRUG ABUSE,3,451,1045,482,116,2097,5,30,36,11,9,91,0,0,0,0,0,0,2188
2412,TOTAL (ALL INDIA),2006,37,ECONOMIC ISSUES,19,2194,3861,2537,568,9179,27,550,782,541,110,2010,0,0,0,0,0,0,11189
2958,TOTAL (ALL INDIA),2006,37,EXAM FAILURE,242,1038,48,6,1,1335,270,747,23,3,0,1043,0,0,0,0,0,0,2378
3504,TOTAL (ALL INDIA),2006,37,FAMILY PROBLEMS,129,5366,7293,4440,1444,18672,166,5656,3874,1851,552,12099,0,0,0,0,0,0,30771
4050,TOTAL (ALL INDIA),2006,37,HEALTH ISSUES,83,2540,3847,3363,2118,11951,133,2266,2027,1356,841,6623,0,0,0,0,0,0,18574
4595,TOTAL (ALL INDIA),2006,37,HERO WORSHIP,3,56,81,29,11,180,3,58,38,9,1,109,0,0,0,0,0,0,289
5140,TOTAL (ALL INDIA),2006,37,ILLEGITIMATE PREGNANCY,0,10,0,0,0,10,10,171,68,8,0,257,0,0,0,0,0,0,267
5685,TOTAL (ALL INDIA),2006,37,LOVE AFFAIRS,18,1542,599,36,0,2195,42,1458,350,18,1,1869,0,0,0,0,0,0,4064
6231,TOTAL (ALL INDIA),2006,37,MARITAL ISSUES,3,517,515,153,17,1205,11,1057,653,106,3,1830,0,0,0,0,0,0,3035
6777,TOTAL (ALL INDIA),2006,37,MENTAL HEALTH,45,1475,1878,1265,619,5282,69,877,899,575,343,2763,0,0,0,0,0,0,8045
7323,TOTAL (ALL INDIA),2006,37,OTHERS,339,3139,3850,2183,751,10262,257,1997,1627,798,337,5016,0,0,0,0,0,0,15278
7907,TOTAL (ALL INDIA),2006,37,"PHYSICAL ABUSE (RAPE,INCEST ETC.)",1,23,39,20,3,86,9,130,80,6,4,229,0,0,0,0,0,0,315
8414,TOTAL (ALL INDIA),2006,37,SOCIETAL ISSUES,6,218,387,219,59,889,11,186,138,97,24,456,0,0,0,0,0,0,1345
267,TOTAL (ALL INDIA),2007,37,CAUSES NOT KNOWN,314,4495,4748,3266,1056,13879,300,2745,2058,1055,372,6530,0,0,0,0,0,0,20409
813,TOTAL (ALL INDIA),2007,37,DEATH OF DEAR PERSON,4,93,132,94,41,364,10,145,115,59,26,355,0,0,0,0,0,0,719
1359,TOTAL (ALL INDIA),2007,37,DOWRY DISPUTE,0,22,14,0,2,38,13,2242,812,43,0,3110,0,0,0,0,0,0,3148
1905,TOTAL (ALL INDIA),2007,37,DRUG ABUSE,9,523,1009,570,139,2250,1,32,28,15,6,82,0,0,0,0,0,0,2332
2451,TOTAL (ALL INDIA),2007,37,ECONOMIC ISSUES,18,2431,3814,2492,701,9456,43,644,624,357,75,1743,0,0,0,0,0,0,11199
2997,TOTAL (ALL INDIA),2007,37,EXAM FAILURE,179,848,53,4,2,1086,179,684,19,8,0,890,0,0,0,0,0,0,1976
3543,TOTAL (ALL INDIA),2007,37,FAMILY PROBLEMS,145,5152,7173,4498,1368,18336,162,4871,3632,1739,498,10902,0,0,0,0,0,0,29238
4089,TOTAL (ALL INDIA),2007,37,HEALTH ISSUES,76,2587,3758,3493,2178,12092,121,2179,1966,1420,916,6602,0,0,0,0,0,0,18694
4634,TOTAL (ALL INDIA),2007,37,HERO WORSHIP,0,45,75,32,9,161,2,60,27,10,1,100,0,0,0,0,0,0,261
5179,TOTAL (ALL INDIA),2007,37,ILLEGITIMATE PREGNANCY,0,6,2,5,1,14,3,107,33,1,0,144,0,0,0,0,0,0,158
5724,TOTAL (ALL INDIA),2007,37,LOVE AFFAIRS,17,1233,444,42,9,1745,75,1289,261,12,1,1638,0,0,0,0,0,0,3383
6270,TOTAL (ALL INDIA),2007,37,MARITAL ISSUES,11,562,609,163,17,1362,13,1148,758,127,11,2057,0,0,0,0,0,0,3419
6816,TOTAL (ALL INDIA),2007,37,MENTAL HEALTH,37,1445,2014,1575,540,5611,59,1014,1028,634,292,3027,0,0,0,0,0,0,8638
7362,TOTAL (ALL INDIA),2007,37,OTHERS,369,3745,4371,2709,891,12085,310,2245,1724,910,379,5568,0,0,0,0,0,0,17653
7946,TOTAL (ALL INDIA),2007,37,"PHYSICAL ABUSE (RAPE,INCEST ETC.)",0,47,39,32,3,121,3,115,44,19,3,184,0,0,0,0,0,0,305
8453,TOTAL (ALL INDIA),2007,37,SOCIETAL ISSUES,5,212,296,138,44,695,1,194,152,49,14,410,0,0,0,0,0,0,1105
306,TOTAL (ALL INDIA),2008,37,CAUSES NOT KNOWN,341,4628,4759,2943,1024,13695,309,2816,1983,936,385,6429,0,0,0,0,0,0,20124
852,TOTAL (ALL INDIA),2008,37,DEATH OF DEAR PERSON,8,128,165,139,56,496,9,316,116,59,23,523,0,0,0,0,0,0,1019
1398,TOTAL (ALL INDIA),2008,37,DOWRY DISPUTE,2,31,19,4,1,57,10,2184,740,46,1,2981,0,0,0,0,0,0,3038
1944,TOTAL (ALL INDIA),2008,37,DRUG ABUSE,5,637,1135,654,173,2604,2,31,54,30,9,126,0,0,0,0,0,0,2730
2490,TOTAL (ALL INDIA),2008,37,ECONOMIC ISSUES,14,2227,3690,2410,587,8928,18,611,621,361,87,1698,0,0,0,0,0,0,10626
3036,TOTAL (ALL INDIA),2008,37,EXAM FAILURE,154,1011,53,10,3,1231,159,770,25,4,0,958,0,0,0,0,0,0,2189
3582,TOTAL (ALL INDIA),2008,37,FAMILY PROBLEMS,137,5215,7368,4434,1348,18502,193,4812,3995,1709,566,11275,0,0,0,0,0,0,29777
4128,TOTAL (ALL INDIA),2008,37,HEALTH ISSUES,57,2694,3956,3550,2027,12284,97,2166,2110,1341,861,6575,0,0,0,0,0,0,18859
4673,TOTAL (ALL INDIA),2008,37,HERO WORSHIP,0,60,106,51,15,232,0,77,56,23,4,160,0,0,0,0,0,0,392
5218,TOTAL (ALL INDIA),2008,37,ILLEGITIMATE PREGNANCY,0,10,10,0,0,20,5,147,62,4,0,218,0,0,0,0,0,0,238
5763,TOTAL (ALL INDIA),2008,37,LOVE AFFAIRS,17,1417,435,39,4,1912,75,1468,291,27,1,1862,0,0,0,0,0,0,3774
6309,TOTAL (ALL INDIA),2008,37,MARITAL ISSUES,8,580,683,187,16,1474,17,1009,729,125,12,1892,0,0,0,0,0,0,3366
6855,TOTAL (ALL INDIA),2008,37,MENTAL HEALTH,51,1483,2039,1403,573,5549,62,1034,1045,694,315,3150,0,0,0,0,0,0,8699
7401,TOTAL (ALL INDIA),2008,37,OTHERS,368,3982,4759,2808,753,12670,249,2474,2026,942,307,5998,0,0,0,0,0,0,18668
7985,TOTAL (ALL INDIA),2008,37,"PHYSICAL ABUSE (RAPE,INCEST ETC.)",1,32,47,16,4,100,6,168,71,21,1,267,0,0,0,0,0,0,367
8492,TOTAL (ALL INDIA),2008,37,SOCIETAL ISSUES,2,261,295,171,61,790,5,173,119,51,13,361,0,0,0,0,0,0,1151
345,TOTAL (ALL INDIA),2009,37,CAUSES NOT KNOWN,480,4269,5230,3176,1179,14334,323,2890,2196,1096,474,6979,0,0,0,0,0,0,21313
891,TOTAL (ALL INDIA),2009,37,DEATH OF DEAR PERSON,6,119,177,94,64,460,14,155,106,47,21,343,0,0,0,0,0,0,803
1437,TOTAL (ALL INDIA),2009,37,DOWRY DISPUTE,1,29,33,11,0,74,10,2053,733,44,7,2847,0,0,0,0,0,0,2921
1983,TOTAL (ALL INDIA),2009,37,DRUG ABUSE,7,682,1244,751,160,2844,2,29,37,18,12,98,0,0,0,0,0,0,2942
2529,TOTAL (ALL INDIA),2009,37,ECONOMIC ISSUES,39,2428,3894,2578,590,9529,25,606,646,344,108,1729,0,0,0,0,0,0,11258
3075,TOTAL (ALL INDIA),2009,37,EXAM FAILURE,146,872,74,15,0,1107,145,719,33,6,0,903,0,0,0,0,0,0,2010
3621,TOTAL (ALL INDIA),2009,37,FAMILY PROBLEMS,164,5437,7259,4262,1319,18441,182,5194,3956,1773,536,11641,0,0,0,0,0,0,30082
4167,TOTAL (ALL INDIA),2009,37,HEALTH ISSUES,76,2272,3621,3667,2335,11971,90,1939,1914,1389,959,6291,0,0,0,0,0,0,18262
4712,TOTAL (ALL INDIA),2009,37,HERO WORSHIP,1,21,17,76,1,116,0,9,2,1,0,12,0,0,0,0,0,0,128
5257,TOTAL (ALL INDIA),2009,37,ILLEGITIMATE PREGNANCY,0,0,0,0,0,0,6,91,39,5,0,141,0,0,0,0,0,0,141
5802,TOTAL (ALL INDIA),2009,37,LOVE AFFAIRS,34,1415,431,43,4,1927,92,1360,320,11,1,1784,0,0,0,0,0,0,3711
6348,TOTAL (ALL INDIA),2009,37,MARITAL ISSUES,6,601,529,189,18,1343,21,1047,625,128,30,1851,0,0,0,0,0,0,3194
6894,TOTAL (ALL INDIA),2009,37,MENTAL HEALTH,65,1529,1837,1413,572,5416,43,969,1055,667,319,3053,0,0,0,0,0,0,8469
7440,TOTAL (ALL INDIA),2009,37,OTHERS,470,3844,4706,3135,987,13142,478,2792,2275,1380,407,7332,0,0,0,0,0,0,20474
8024,TOTAL (ALL INDIA),2009,37,"PHYSICAL ABUSE (RAPE,INCEST ETC.)",3,48,23,13,8,95,8,137,55,19,6,225,0,0,0,0,0,0,320
8531,TOTAL (ALL INDIA),2009,37,SOCIETAL ISSUES,3,180,260,173,56,672,11,184,161,79,16,451,0,0,0,0,0,0,1123
384,TOTAL (ALL INDIA),2010,37,CAUSES NOT KNOWN,455,4806,5444,3398,1323,15426,372,2881,2281,1255,470,7259,0,0,0,0,0,0,22685
930,TOTAL (ALL INDIA),2010,37,DEATH OF DEAR PERSON,72,152,165,136,69,594,20,184,126,63,48,441,0,0,0,0,0,0,1035
1476,TOTAL (ALL INDIA),2010,37,DOWRY DISPUTE,1,33,37,7,2,80,4,2122,838,43,6,3013,0,0,0,0,0,0,3093
2022,TOTAL (ALL INDIA),2010,37,DRUG ABUSE,6,741,1398,861,232,3238,3,33,32,27,10,105,0,0,0,0,0,0,3343
2568,TOTAL (ALL INDIA),2010,37,ECONOMIC ISSUES,39,2471,3554,2322,623,9009,28,695,685,333,93,1834,0,0,0,0,0,0,10843
3114,TOTAL (ALL INDIA),2010,37,EXAM FAILURE,159,1115,62,11,3,1350,158,942,28,1,0,1129,0,0,0,0,0,0,2479
3660,TOTAL (ALL INDIA),2010,37,FAMILY PROBLEMS,193,5755,7617,4756,1507,19828,190,5559,3831,1818,630,12028,0,0,0,0,0,0,31856
4206,TOTAL (ALL INDIA),2010,37,HEALTH ISSUES,88,2557,3704,3776,2282,12407,165,2018,1911,1499,999,6592,0,0,0,0,0,0,18999
4751,TOTAL (ALL INDIA),2010,37,HERO WORSHIP,0,27,17,7,3,54,1,27,14,4,2,48,0,0,0,0,0,0,102
5296,TOTAL (ALL INDIA),2010,37,ILLEGITIMATE PREGNANCY,0,0,0,0,0,0,7,105,40,1,0,153,0,0,0,0,0,0,153
5841,TOTAL (ALL INDIA),2010,37,LOVE AFFAIRS,37,1599,524,55,1,2216,98,1499,332,20,1,1950,0,0,0,0,0,0,4166
6387,TOTAL (ALL INDIA),2010,37,MARITAL ISSUES,6,657,547,148,26,1384,21,1108,671,125,10,1935,0,0,0,0,0,0,3319
6933,TOTAL (ALL INDIA),2010,37,MENTAL HEALTH,83,1651,2111,1607,673,6125,86,1162,1077,669,346,3340,0,0,0,0,0,0,9465
7479,TOTAL (ALL INDIA),2010,37,OTHERS,489,4492,4953,3473,1142,14549,317,2543,2304,1188,537,6889,0,0,0,0,0,0,21438
8063,TOTAL (ALL INDIA),2010,37,"PHYSICAL ABUSE (RAPE,INCEST ETC.)",2,37,25,12,1,77,13,127,62,20,2,224,0,0,0,0,0,0,301
8570,TOTAL (ALL INDIA),2010,37,SOCIETAL ISSUES,10,294,286,199,54,843,7,233,170,55,14,479,0,0,0,0,0,0,1322
423,TOTAL (ALL INDIA),2011,37,CAUSES NOT KNOWN,439,4756,5809,3288,1416,15708,359,2796,2298,1331,532,7316,0,0,0,0,0,0,23024
969,TOTAL (ALL INDIA),2011,37,DEATH OF DEAR PERSON,7,133,152,124,46,462,16,182,142,62,32,434,0,0,0,0,0,0,896
1515,TOTAL (ALL INDIA),2011,37,DOWRY DISPUTE,0,48,72,18,1,139,2,2037,965,96,0,3100,0,0,0,0,0,0,3239
2061,TOTAL (ALL INDIA),2011,37,DRUG ABUSE,8,920,1503,877,220,3528,1,43,40,36,10,130,0,0,0,0,0,0,3658
2607,TOTAL (ALL INDIA),2011,37,ECONOMIC ISSUES,17,2265,3470,2290,506,8548,30,609,687,373,101,1800,0,0,0,0,0,0,10348
3153,TOTAL (ALL INDIA),2011,37,EXAM FAILURE,161,1112,54,9,1,1337,122,888,29,5,0,1044,0,0,0,0,0,0,2381
3699,TOTAL (ALL INDIA),2011,37,FAMILY PROBLEMS,145,5987,7940,4850,1423,20345,199,5781,4222,1809,553,12564,0,0,0,0,0,0,32909
4245,TOTAL (ALL INDIA),2011,37,HEALTH ISSUES,84,2258,3547,3466,2121,11476,86,2035,1848,1350,973,6292,0,0,0,0,0,0,17768
4790,TOTAL (ALL INDIA),2011,37,HERO WORSHIP,2,5,12,4,2,25,4,6,6,0,0,16,0,0,0,0,0,0,41
5335,TOTAL (ALL INDIA),2011,37,ILLEGITIMATE PREGNANCY,0,0,0,0,0,0,10,129,39,6,0,184,0,0,0,0,0,0,184
5880,TOTAL (ALL INDIA),2011,37,LOVE AFFAIRS,136,1745,554,47,1,2483,79,1629,335,59,1,2103,0,0,0,0,0,0,4586
6426,TOTAL (ALL INDIA),2011,37,MARITAL ISSUES,9,831,681,243,29,1793,17,1047,675,122,15,1876,0,0,0,0,0,0,3669
6972,TOTAL (ALL INDIA),2011,37,MENTAL HEALTH,34,1424,1944,1509,670,5581,58,1054,1091,709,309,3221,0,0,0,0,0,0,8802
7518,TOTAL (ALL INDIA),2011,37,OTHERS,530,4942,5305,3573,1288,15638,470,2855,2192,994,485,6996,0,0,0,0,0,0,22634
8102,TOTAL (ALL INDIA),2011,37,"PHYSICAL ABUSE (RAPE,INCEST ETC.)",1,45,31,7,1,85,5,114,74,5,3,201,0,0,0,0,0,0,286
8609,TOTAL (ALL INDIA),2011,37,SOCIETAL ISSUES,1,133,326,202,29,691,3,205,172,72,17,469,0,0,0,0,0,0,1160
462,TOTAL (ALL INDIA),2012,37,CAUSES NOT KNOWN,305,3843,4814,2801,1006,12769,255,2284,1565,917,386,5407,0,0,0,0,0,0,18176
1008,TOTAL (ALL INDIA),2012,37,DEATH OF DEAR PERSON,3,97,145,99,83,427,10,144,123,75,40,392,0,0,0,0,0,0,819
1554,TOTAL (ALL INDIA),2012,37,DOWRY DISPUTE,1,21,15,4,0,41,2,1378,452,62,0,1894,0,0,0,0,0,0,1935
2100,TOTAL (ALL INDIA),2012,37,DRUG ABUSE,5,983,1618,1021,256,3883,3,35,47,33,7,125,0,0,0,0,0,0,4008
2646,TOTAL (ALL INDIA),2012,37,ECONOMIC ISSUES,15,1929,2888,1825,463,7120,13,474,523,306,90,1406,0,0,0,0,0,0,8526
3192,TOTAL (ALL INDIA),2012,37,EXAM FAILURE,122,990,44,6,0,1162,104,925,55,0,0,1084,0,0,0,0,0,0,2246
3738,TOTAL (ALL INDIA),2012,37,FAMILY PROBLEMS,141,5462,7541,4899,1494,19537,213,5122,3703,1674,543,11255,0,0,0,0,0,0,30792
4284,TOTAL (ALL INDIA),2012,37,HEALTH ISSUES,64,2135,3469,3403,2197,11268,82,1940,1859,1320,878,6079,0,0,0,0,0,0,17347
4829,TOTAL (ALL INDIA),2012,37,HERO WORSHIP,5,50,26,17,3,101,1,39,23,8,4,75,0,0,0,0,0,0,176
5374,TOTAL (ALL INDIA),2012,37,ILLEGITIMATE PREGNANCY,0,0,0,0,0,0,1,70,18,4,0,93,0,0,0,0,0,0,93
5919,TOTAL (ALL INDIA),2012,37,LOVE AFFAIRS,26,1506,441,49,1,2023,82,1389,314,40,1,1826,0,0,0,0,0,0,3849
6465,TOTAL (ALL INDIA),2012,37,MARITAL ISSUES,1,529,494,168,27,1219,14,811,538,109,11,1483,0,0,0,0,0,0,2702
7011,TOTAL (ALL INDIA),2012,37,MENTAL HEALTH,29,1416,1732,1276,703,5156,38,943,772,541,319,2613,0,0,0,0,0,0,7769
7557,TOTAL (ALL INDIA),2012,37,OTHERS,397,4222,4989,3411,1281,14300,362,2599,1984,1047,496,6488,0,0,0,0,0,0,20788
8141,TOTAL (ALL INDIA),2012,37,"PHYSICAL ABUSE (RAPE,INCEST ETC.)",2,17,27,18,23,87,9,106,56,20,3,194,0,0,0,0,0,0,281
8648,TOTAL (ALL INDIA),2012,37,SOCIETAL ISSUES,4,198,243,200,35,680,5,136,97,51,12,301,0,0,0,0,0,0,981
501,TOTAL (ALL INDIA),2013,37,CAUSES NOT KNOWN,406,4753,5179,3274,1092,14704,317,2709,1920,955,360,6261,0,0,0,0,0,0,20965
1047,TOTAL (ALL INDIA),2013,37,DEATH OF DEAR PERSON,5,177,182,124,84,572,4,171,130,79,40,424,0,0,0,0,0,0,996
1593,TOTAL (ALL INDIA),2013,37,DOWRY DISPUTE,0,26,15,22,2,65,10,1630,506,53,3,2202,0,0,0,0,0,0,2267
2139,TOTAL (ALL INDIA),2013,37,DRUG ABUSE,10,1058,1842,1257,312,4479,1,28,43,30,10,112,0,0,0,0,0,0,4591
2685,TOTAL (ALL INDIA),2013,37,ECONOMIC ISSUES,15,2085,3146,2014,375,7635,7,469,514,321,115,1426,0,0,0,0,0,0,9061
3231,TOTAL (ALL INDIA),2013,37,EXAM FAILURE,159,1122,99,9,3,1392,100,926,52,1,0,1079,0,0,0,0,0,0,2471
3777,TOTAL (ALL INDIA),2013,37,FAMILY PROBLEMS,139,5805,8171,5201,1780,21096,172,4917,3841,1676,623,11229,0,0,0,0,0,0,32325
4323,TOTAL (ALL INDIA),2013,37,HEALTH ISSUES,71,2211,3813,3742,2485,12322,128,1936,1734,1283,1017,6098,0,0,0,0,0,0,18420
4868,TOTAL (ALL INDIA),2013,37,HERO WORSHIP,5,72,38,17,7,139,2,54,19,5,2,82,0,0,0,0,0,0,221
5413,TOTAL (ALL INDIA),2013,37,ILLEGITIMATE PREGNANCY,0,0,0,0,0,0,7,115,30,1,0,153,0,0,0,0,0,0,153
5958,TOTAL (ALL INDIA),2013,37,LOVE AFFAIRS,43,1766,665,91,0,2565,77,1464,343,45,1,1930,0,0,0,0,0,0,4495
6504,TOTAL (ALL INDIA),2013,37,MARITAL ISSUES,2,740,622,221,39,1624,13,905,563,136,13,1630,0,0,0,0,0,0,3254
7050,TOTAL (ALL INDIA),2013,37,MENTAL HEALTH,52,1454,1787,1349,566,5208,49,916,915,609,309,2798,0,0,0,0,0,0,8006
7596,TOTAL (ALL INDIA),2013,37,OTHERS,636,5151,6115,4212,1543,17657,444,3128,2657,1378,574,8181,0,0,0,0,0,0,25838
8180,TOTAL (ALL INDIA),2013,37,"PHYSICAL ABUSE (RAPE,INCEST ETC.)",0,18,23,30,3,74,7,103,69,16,1,196,0,0,0,0,0,0,270
8687,TOTAL (ALL INDIA),2013,37,SOCIETAL ISSUES,3,278,402,262,66,1011,7,181,171,72,24,455,0,0,0,0,0,0,1466
540,TOTAL (ALL INDIA),2014,37,CAUSES NOT KNOWN,179,4405,3787,2145,792,11308,138,2659,1308,624,226,4955,0,1,0,0,0,1,16264
1086,TOTAL (ALL INDIA),2014,37,DEATH OF DEAR PERSON,1,182,218,174,83,658,3,152,75,47,46,323,0,0,0,0,0,0,981
1632,TOTAL (ALL INDIA),2014,37,DOWRY DISPUTE,1,19,12,5,2,39,0,1739,427,44,12,2222,0,0,0,0,0,0,2261
2178,TOTAL (ALL INDIA),2014,37,DRUG ABUSE,5,1018,1419,893,220,3555,6,29,35,15,6,91,0,1,0,0,0,1,3647
2724,TOTAL (ALL INDIA),2014,37,ECONOMIC ISSUES,2,2192,2881,1659,414,7148,8,414,422,155,37,1036,0,0,0,0,0,0,8184
3270,TOTAL (ALL INDIA),2014,37,EXAM FAILURE,91,1237,28,2,0,1358,72,946,25,2,0,1045,0,0,0,0,0,0,2403
3816,TOTAL (ALL INDIA),2014,37,FAMILY PROBLEMS,129,6166,7041,3990,1297,18623,116,4937,3238,1228,458,9977,0,2,0,0,0,2,28602
4362,TOTAL (ALL INDIA),2014,37,HEALTH ISSUES,136,6799,8506,7174,4780,27395,147,4687,3460,2551,2140,12985,0,5,3,0,0,8,40388
4907,TOTAL (ALL INDIA),2014,37,HERO WORSHIP,1,23,10,7,2,43,2,8,3,0,0,13,0,0,0,0,0,0,56
5452,TOTAL (ALL INDIA),2014,37,ILLEGITIMATE PREGNANCY,0,0,0,0,0,0,1,44,11,0,0,56,0,0,0,0,0,0,56
5997,TOTAL (ALL INDIA),2014,37,LOVE AFFAIRS,12,1927,429,63,10,2441,30,1496,193,8,0,1727,0,0,0,0,0,0,4168
6543,TOTAL (ALL INDIA),2014,37,MARITAL ISSUES,12,1836,1292,393,76,3609,17,3993,1587,219,43,5859,0,0,0,0,0,0,9468
7089,TOTAL (ALL INDIA),2014,37,MENTAL HEALTH,56,1569,1548,1120,468,4761,23,903,706,441,268,2341,0,1,1,0,0,2,7104
7635,TOTAL (ALL INDIA),2014,37,OTHERS,378,9925,9203,5146,1612,26264,342,5856,3365,1558,647,11768,0,6,0,1,0,7,38039
7674,TOTAL (ALL INDIA),2014,37,PHYSICAL ABUSE,0,3,0,3,0,6,4,49,12,2,1,68,0,0,0,0,0,0,74
8726,TOTAL (ALL INDIA),2014,37,SOCIETAL ISSUES,2,92,136,98,33,361,7,70,34,12,6,129,0,0,0,0,0,0,490
34,TOTAL (STATES),2001,,CAUSES NOT KNOWN,479,3783,4669,2705,1065,12701,433,3041,2273,1131,477,7355,0,0,0,0,0,0,20056
580,TOTAL (STATES),2001,,DEATH OF DEAR PERSON,6,104,144,106,74,434,13,174,132,69,33,421,0,0,0,0,0,0,855
1126,TOTAL (STATES),2001,,DOWRY DISPUTE,0,25,16,2,0,43,1,1758,554,23,0,2336,0,0,0,0,0,0,2379
1672,TOTAL (STATES),2001,,DRUG ABUSE,13,337,578,329,63,1320,6,32,18,16,4,76,0,0,0,0,0,0,1396
2218,TOTAL (STATES),2001,,ECONOMIC ISSUES,38,2218,3412,2119,566,8353,25,675,790,482,154,2126,0,0,0,0,0,0,10479
2764,TOTAL (STATES),2001,,EXAM FAILURE,221,873,59,8,0,1161,161,670,34,3,0,868,0,0,0,0,0,0,2029
3310,TOTAL (STATES),2001,,FAMILY PROBLEMS,165,4311,5175,2997,915,13563,179,4471,3529,1372,451,10002,0,0,0,0,0,0,23565
3856,TOTAL (STATES),2001,,HEALTH ISSUES,110,2566,3632,3498,1759,11565,129,2084,1925,1452,775,6365,0,0,0,0,0,0,17930
4402,TOTAL (STATES),2001,,HERO WORSHIP,1,18,15,19,1,54,0,33,9,6,0,48,0,0,0,0,0,0,102
4947,TOTAL (STATES),2001,,ILLEGITIMATE PREGNANCY,0,21,9,0,0,30,5,240,83,7,0,335,0,0,0,0,0,0,365
5492,TOTAL (STATES),2001,,LOVE AFFAIRS,26,1109,399,43,1,1578,69,1122,273,27,0,1491,0,0,0,0,0,0,3069
6037,TOTAL (STATES),2001,,MARITAL ISSUES,7,553,472,141,32,1205,22,1146,658,136,5,1967,0,0,0,0,0,0,3172
6583,TOTAL (STATES),2001,,MENTAL HEALTH,41,941,1324,917,433,3656,43,672,699,463,277,2154,0,0,0,0,0,0,5810
7129,TOTAL (STATES),2001,,OTHERS,360,2394,2885,2078,842,8559,368,1993,1514,862,403,5140,0,0,0,0,0,0,13699
7714,TOTAL (STATES),2001,,"PHYSICAL ABUSE (RAPE,INCEST ETC.)",1,43,34,23,8,109,10,169,69,11,4,263,0,0,0,0,0,0,372
8220,TOTAL (STATES),2001,,SOCIETAL ISSUES,11,229,251,194,82,767,8,185,153,50,34,430,0,0,0,0,0,0,1197
73,TOTAL (STATES),2002,,CAUSES NOT KNOWN,383,4025,4451,2849,1158,12866,356,2537,2020,1081,467,6461,0,0,0,0,0,0,19327
619,TOTAL (STATES),2002,,DEATH OF DEAR PERSON,5,105,136,89,48,383,6,124,88,57,28,303,0,0,0,0,0,0,686
1165,TOTAL (STATES),2002,,DOWRY DISPUTE,0,16,10,4,0,30,116,1678,493,38,3,2328,0,0,0,0,0,0,2358
1711,TOTAL (STATES),2002,,DRUG ABUSE,5,385,713,398,74,1575,8,40,29,21,11,109,0,0,0,0,0,0,1684
2257,TOTAL (STATES),2002,,ECONOMIC ISSUES,32,2083,3134,2011,500,7760,23,620,638,324,101,1706,0,0,0,0,0,0,9466
2803,TOTAL (STATES),2002,,EXAM FAILURE,174,1001,68,3,0,1246,169,737,50,2,0,958,0,0,0,0,0,0,2204
3349,TOTAL (STATES),2002,,FAMILY PROBLEMS,183,4378,5499,3177,1091,14328,243,4653,3351,1407,456,10110,0,0,0,0,0,0,24438
3895,TOTAL (STATES),2002,,HEALTH ISSUES,84,2599,4196,3682,2100,12661,153,2134,2028,1462,801,6578,0,0,0,0,0,0,19239
4441,TOTAL (STATES),2002,,HERO WORSHIP,0,19,10,13,9,51,0,14,11,7,4,36,0,0,0,0,0,0,87
4986,TOTAL (STATES),2002,,ILLEGITIMATE PREGNANCY,0,7,0,1,0,8,9,163,77,5,0,254,0,0,0,0,0,0,262
5531,TOTAL (STATES),2002,,LOVE AFFAIRS,5,1105,442,35,2,1589,58,1049,321,21,0,1449,0,0,0,0,0,0,3038
6076,TOTAL (STATES),2002,,MARITAL ISSUES,3,588,462,187,16,1256,5,1208,758,164,11,2146,0,0,0,0,0,0,3402
6622,TOTAL (STATES),2002,,MENTAL HEALTH,38,1127,1500,969,459,4093,44,703,787,479,237,2250,0,0,0,0,0,0,6343
7168,TOTAL (STATES),2002,,OTHERS,350,2792,3447,2126,768,9483,341,2082,1683,723,370,5199,0,0,0,0,0,0,14682
7753,TOTAL (STATES),2002,,"PHYSICAL ABUSE (RAPE,INCEST ETC.)",0,76,63,30,6,175,18,135,72,19,6,250,0,0,0,0,0,0,425
8259,TOTAL (STATES),2002,,SOCIETAL ISSUES,20,149,232,145,38,584,3,116,103,37,15,274,0,0,0,0,0,0,858
112,TOTAL (STATES),2003,,CAUSES NOT KNOWN,355,3770,3932,2420,1017,11494,319,2285,1704,1010,410,5728,0,0,0,0,0,0,17222
658,TOTAL (STATES),2003,,DEATH OF DEAR PERSON,6,181,175,153,55,570,11,193,134,59,27,424,0,0,0,0,0,0,994
1204,TOTAL (STATES),2003,,DOWRY DISPUTE,4,14,47,33,1,99,10,1700,550,40,2,2302,0,0,0,0,0,0,2401
1750,TOTAL (STATES),2003,,DRUG ABUSE,4,358,716,446,121,1645,2,45,29,15,5,96,0,0,0,0,0,0,1741
2296,TOTAL (STATES),2003,,ECONOMIC ISSUES,31,2284,3526,2135,547,8523,29,661,730,399,134,1953,0,0,0,0,0,0,10476
2842,TOTAL (STATES),2003,,EXAM FAILURE,147,921,90,0,0,1158,158,846,43,1,0,1048,0,0,0,0,0,0,2206
3388,TOTAL (STATES),2003,,FAMILY PROBLEMS,178,4726,5715,3588,1151,15358,190,4478,3376,1668,592,10304,0,0,0,0,0,0,25662
3934,TOTAL (STATES),2003,,HEALTH ISSUES,110,2456,3500,3149,1866,11081,133,1934,1998,1329,804,6198,0,0,0,0,0,0,17279
4480,TOTAL (STATES),2003,,HERO WORSHIP,0,58,71,40,8,177,2,41,12,9,1,65,0,0,0,0,0,0,242
5025,TOTAL (STATES),2003,,ILLEGITIMATE PREGNANCY,0,0,2,0,1,3,1,171,62,11,0,245,0,0,0,0,0,0,248
5570,TOTAL (STATES),2003,,LOVE AFFAIRS,28,1438,575,61,1,2103,58,1329,421,34,0,1842,0,0,0,0,0,0,3945
6115,TOTAL (STATES),2003,,MARITAL ISSUES,8,522,550,193,16,1289,12,1025,725,166,5,1933,0,0,0,0,0,0,3222
6661,TOTAL (STATES),2003,,MENTAL HEALTH,42,1235,1718,1127,539,4661,58,787,863,594,277,2579,0,0,0,0,0,0,7240
7207,TOTAL (STATES),2003,,OTHERS,326,3013,3236,2374,992,9941,260,1930,1350,729,340,4609,0,0,0,0,0,0,14550
7792,TOTAL (STATES),2003,,"PHYSICAL ABUSE (RAPE,INCEST ETC.)",6,64,92,41,23,226,14,147,74,28,10,273,0,0,0,0,0,0,499
8298,TOTAL (STATES),2003,,SOCIETAL ISSUES,7,147,244,139,40,577,17,138,98,56,9,318,0,0,0,0,0,0,895
151,TOTAL (STATES),2004,,CAUSES NOT KNOWN,336,3731,4393,2909,1156,12525,312,2432,1832,893,384,5853,0,0,0,0,0,0,18378
697,TOTAL (STATES),2004,,DEATH OF DEAR PERSON,7,125,134,103,64,433,10,109,93,56,31,299,0,0,0,0,0,0,732
1243,TOTAL (STATES),2004,,DOWRY DISPUTE,0,27,17,7,2,53,10,1962,527,32,0,2531,0,0,0,0,0,0,2584
1789,TOTAL (STATES),2004,,DRUG ABUSE,7,441,821,454,95,1818,0,36,32,11,1,80,0,0,0,0,0,0,1898
2335,TOTAL (STATES),2004,,ECONOMIC ISSUES,34,2468,3793,2511,594,9400,23,670,864,530,134,2221,0,0,0,0,0,0,11621
2881,TOTAL (STATES),2004,,EXAM FAILURE,219,1028,136,17,2,1402,226,752,51,3,0,1032,0,0,0,0,0,0,2434
3427,TOTAL (STATES),2004,,FAMILY PROBLEMS,191,4340,5804,3605,1043,14983,192,4555,3319,1455,471,9992,0,0,0,0,0,0,24975
3973,TOTAL (STATES),2004,,HEALTH ISSUES,93,2545,3800,3256,2036,11730,127,2012,1904,1416,836,6295,0,0,0,0,0,0,18025
4519,TOTAL (STATES),2004,,HERO WORSHIP,1,12,22,7,6,48,2,19,8,0,1,30,0,0,0,0,0,0,78
5064,TOTAL (STATES),2004,,ILLEGITIMATE PREGNANCY,0,5,4,2,0,11,6,121,61,5,0,193,0,0,0,0,0,0,204
5609,TOTAL (STATES),2004,,LOVE AFFAIRS,22,1380,540,54,2,1998,57,1226,443,31,0,1757,0,0,0,0,0,0,3755
6154,TOTAL (STATES),2004,,MARITAL ISSUES,5,561,468,145,12,1191,8,1054,629,108,3,1802,0,0,0,0,0,0,2993
6700,TOTAL (STATES),2004,,MENTAL HEALTH,66,1231,1568,1190,547,4602,55,791,817,535,230,2428,0,0,0,0,0,0,7030
7246,TOTAL (STATES),2004,,OTHERS,462,3020,3667,2442,979,10570,390,2136,1527,900,428,5381,0,0,0,0,0,0,15951
7831,TOTAL (STATES),2004,,"PHYSICAL ABUSE (RAPE,INCEST ETC.)",0,41,39,11,10,101,1,111,70,17,4,203,0,0,0,0,0,0,304
8337,TOTAL (STATES),2004,,SOCIETAL ISSUES,4,173,171,104,39,491,5,91,67,32,5,200,0,0,0,0,0,0,691
190,TOTAL (STATES),2005,,CAUSES NOT KNOWN,273,3740,3973,2578,903,11467,216,2399,1652,950,280,5497,0,0,0,0,0,0,16964
736,TOTAL (STATES),2005,,DEATH OF DEAR PERSON,4,102,180,118,59,463,7,92,151,68,19,337,0,0,0,0,0,0,800
1282,TOTAL (STATES),2005,,DOWRY DISPUTE,2,13,24,3,0,42,0,1683,530,38,3,2254,0,0,0,0,0,0,2296
1828,TOTAL (STATES),2005,,DRUG ABUSE,7,451,884,479,104,1925,2,30,27,10,11,80,0,0,0,0,0,0,2005
2374,TOTAL (STATES),2005,,ECONOMIC ISSUES,21,1980,3340,2379,536,8256,26,539,696,384,101,1746,0,0,0,0,0,0,10002
2920,TOTAL (STATES),2005,,EXAM FAILURE,182,987,77,14,0,1260,263,670,43,6,2,984,0,0,0,0,0,0,2244
3466,TOTAL (STATES),2005,,FAMILY PROBLEMS,160,4310,5718,3672,1067,14927,162,4498,3088,1563,544,9855,0,0,0,0,0,0,24782
4012,TOTAL (STATES),2005,,HEALTH ISSUES,90,2302,3457,3149,2118,11116,121,1951,1728,1344,944,6088,0,0,0,0,0,0,17204
4558,TOTAL (STATES),2005,,HERO WORSHIP,5,29,45,42,20,141,1,39,18,10,5,73,0,0,0,0,0,0,214
5103,TOTAL (STATES),2005,,ILLEGITIMATE PREGNANCY,1,4,2,0,0,7,3,116,41,4,0,164,0,0,0,0,0,0,171
5648,TOTAL (STATES),2005,,LOVE AFFAIRS,36,1223,484,43,4,1790,58,1260,313,14,1,1646,0,0,0,0,0,0,3436
6193,TOTAL (STATES),2005,,MARITAL ISSUES,17,583,492,194,30,1316,30,1042,700,150,4,1926,0,0,0,0,0,0,3242
6739,TOTAL (STATES),2005,,MENTAL HEALTH,32,1319,1740,1254,554,4899,39,831,826,614,314,2624,0,0,0,0,0,0,7523
7285,TOTAL (STATES),2005,,OTHERS,471,3857,4700,2812,1059,12899,264,2467,2028,1097,428,6284,0,0,0,0,0,0,19183
7870,TOTAL (STATES),2005,,"PHYSICAL ABUSE (RAPE,INCEST ETC.)",2,25,26,13,1,67,5,94,26,9,1,135,0,0,0,0,0,0,202
8376,TOTAL (STATES),2005,,SOCIETAL ISSUES,8,379,338,219,65,1009,11,259,164,62,29,525,0,0,0,0,0,0,1534
229,TOTAL (STATES),2006,,CAUSES NOT KNOWN,293,3849,3986,2410,829,11367,237,2306,1574,727,276,5120,0,0,0,0,0,0,16487
775,TOTAL (STATES),2006,,DEATH OF DEAR PERSON,5,100,184,132,48,469,7,121,120,122,24,394,0,0,0,0,0,0,863
1321,TOTAL (STATES),2006,,DOWRY DISPUTE,0,32,27,1,0,60,1,1658,525,21,1,2206,0,0,0,0,0,0,2266
1867,TOTAL (STATES),2006,,DRUG ABUSE,3,442,1033,479,113,2070,5,29,32,11,9,86,0,0,0,0,0,0,2156
2413,TOTAL (STATES),2006,,ECONOMIC ISSUES,19,2138,3816,2520,568,9061,27,541,780,540,110,1998,0,0,0,0,0,0,11059
2959,TOTAL (STATES),2006,,EXAM FAILURE,241,1026,48,6,1,1322,266,733,23,3,0,1025,0,0,0,0,0,0,2347
3505,TOTAL (STATES),2006,,FAMILY PROBLEMS,125,5215,7146,4383,1430,18299,160,5535,3798,1840,549,11882,0,0,0,0,0,0,30181
4051,TOTAL (STATES),2006,,HEALTH ISSUES,83,2507,3779,3305,2089,11763,129,2207,2007,1341,833,6517,0,0,0,0,0,0,18280
4596,TOTAL (STATES),2006,,HERO WORSHIP,3,56,81,29,11,180,3,58,38,9,1,109,0,0,0,0,0,0,289
5141,TOTAL (STATES),2006,,ILLEGITIMATE PREGNANCY,0,2,0,0,0,2,10,168,68,8,0,254,0,0,0,0,0,0,256
5686,TOTAL (STATES),2006,,LOVE AFFAIRS,17,1506,596,36,0,2155,38,1437,347,18,1,1841,0,0,0,0,0,0,3996
6232,TOTAL (STATES),2006,,MARITAL ISSUES,3,513,511,151,17,1195,11,1045,649,105,3,1813,0,0,0,0,0,0,3008
6778,TOTAL (STATES),2006,,MENTAL HEALTH,45,1456,1853,1247,612,5213,69,861,893,571,340,2734,0,0,0,0,0,0,7947
7324,TOTAL (STATES),2006,,OTHERS,332,3082,3787,2150,744,10095,256,1960,1614,794,332,4956,0,0,0,0,0,0,15051
7908,TOTAL (STATES),2006,,"PHYSICAL ABUSE (RAPE,INCEST ETC.)",1,23,39,20,3,86,9,130,80,6,4,229,0,0,0,0,0,0,315
8415,TOTAL (STATES),2006,,SOCIETAL ISSUES,6,215,375,212,58,866,11,184,133,96,24,448,0,0,0,0,0,0,1314
268,TOTAL (STATES),2007,,CAUSES NOT KNOWN,309,4288,4573,3205,1043,13418,293,2623,2011,1047,367,6341,0,0,0,0,0,0,19759
814,TOTAL (STATES),2007,,DEATH OF DEAR PERSON,4,92,127,93,38,354,10,143,114,59,26,352,0,0,0,0,0,0,706
1360,TOTAL (STATES),2007,,DOWRY DISPUTE,0,20,14,0,2,36,13,2177,807,43,0,3040,0,0,0,0,0,0,3076
1906,TOTAL (STATES),2007,,DRUG ABUSE,9,513,1001,569,138,2230,1,31,28,14,5,79,0,0,0,0,0,0,2309
2452,TOTAL (STATES),2007,,ECONOMIC ISSUES,18,2371,3785,2481,700,9355,43,629,621,357,75,1725,0,0,0,0,0,0,11080
2998,TOTAL (STATES),2007,,EXAM FAILURE,175,819,52,4,2,1052,174,654,19,8,0,855,0,0,0,0,0,0,1907
3544,TOTAL (STATES),2007,,FAMILY PROBLEMS,142,5035,6970,4423,1355,17925,160,4732,3539,1730,494,10655,0,0,0,0,0,0,28580
4090,TOTAL (STATES),2007,,HEALTH ISSUES,75,2561,3718,3456,2151,11961,119,2141,1951,1413,907,6531,0,0,0,0,0,0,18492
4635,TOTAL (STATES),2007,,HERO WORSHIP,0,45,75,32,9,161,2,57,25,8,1,93,0,0,0,0,0,0,254
5180,TOTAL (STATES),2007,,ILLEGITIMATE PREGNANCY,0,6,2,5,1,14,3,107,33,1,0,144,0,0,0,0,0,0,158
5725,TOTAL (STATES),2007,,LOVE AFFAIRS,17,1203,441,42,9,1712,74,1249,258,11,1,1593,0,0,0,0,0,0,3305
6271,TOTAL (STATES),2007,,MARITAL ISSUES,11,553,603,163,17,1347,12,1132,753,127,11,2035,0,0,0,0,0,0,3382
6817,TOTAL (STATES),2007,,MENTAL HEALTH,37,1434,1994,1554,537,5556,59,1006,1012,628,290,2995,0,0,0,0,0,0,8551
7363,TOTAL (STATES),2007,,OTHERS,365,3673,4293,2671,876,11878,301,2193,1707,903,375,5479,0,0,0,0,0,0,17357
7947,TOTAL (STATES),2007,,"PHYSICAL ABUSE (RAPE,INCEST ETC.)",0,41,37,31,3,112,3,115,44,19,3,184,0,0,0,0,0,0,296
8454,TOTAL (STATES),2007,,SOCIETAL ISSUES,5,208,295,137,43,688,1,192,151,49,14,407,0,0,0,0,0,0,1095
307,TOTAL (STATES),2008,,CAUSES NOT KNOWN,338,4479,4625,2902,1012,13356,306,2710,1945,925,382,6268,0,0,0,0,0,0,19624
853,TOTAL (STATES),2008,,DEATH OF DEAR PERSON,8,127,161,137,54,487,9,309,115,57,22,512,0,0,0,0,0,0,999
1399,TOTAL (STATES),2008,,DOWRY DISPUTE,2,31,19,4,1,57,10,2145,730,46,1,2932,0,0,0,0,0,0,2989
1945,TOTAL (STATES),2008,,DRUG ABUSE,5,623,1125,653,173,2579,2,29,53,29,9,122,0,0,0,0,0,0,2701
2491,TOTAL (STATES),2008,,ECONOMIC ISSUES,14,2163,3638,2390,585,8790,17,597,616,359,87,1676,0,0,0,0,0,0,10466
3037,TOTAL (STATES),2008,,EXAM FAILURE,145,979,52,10,2,1188,155,744,21,4,0,924,0,0,0,0,0,0,2112
3583,TOTAL (STATES),2008,,FAMILY PROBLEMS,132,5114,7253,4361,1337,18197,193,4670,3926,1697,564,11050,0,0,0,0,0,0,29247
4129,TOTAL (STATES),2008,,HEALTH ISSUES,56,2673,3895,3499,2002,12125,96,2124,2083,1332,851,6486,0,0,0,0,0,0,18611
4674,TOTAL (STATES),2008,,HERO WORSHIP,0,60,105,51,15,231,0,77,56,23,4,160,0,0,0,0,0,0,391
5219,TOTAL (STATES),2008,,ILLEGITIMATE PREGNANCY,0,10,10,0,0,20,3,146,62,4,0,215,0,0,0,0,0,0,235
5764,TOTAL (STATES),2008,,LOVE AFFAIRS,17,1375,433,39,4,1868,74,1427,290,27,1,1819,0,0,0,0,0,0,3687
6310,TOTAL (STATES),2008,,MARITAL ISSUES,8,564,681,185,16,1454,16,982,722,123,12,1855,0,0,0,0,0,0,3309
6856,TOTAL (STATES),2008,,MENTAL HEALTH,51,1472,2016,1374,571,5484,61,1023,1038,690,312,3124,0,0,0,0,0,0,8608
7402,TOTAL (STATES),2008,,OTHERS,367,3908,4701,2790,742,12508,245,2426,2012,937,302,5922,0,0,0,0,0,0,18430
7986,TOTAL (STATES),2008,,"PHYSICAL ABUSE (RAPE,INCEST ETC.)",1,32,47,16,4,100,6,167,71,21,1,266,0,0,0,0,0,0,366
8493,TOTAL (STATES),2008,,SOCIETAL ISSUES,2,257,284,166,60,769,5,173,116,51,13,358,0,0,0,0,0,0,1127
346,TOTAL (STATES),2009,,CAUSES NOT KNOWN,474,4116,5123,3131,1160,14004,319,2779,2146,1084,471,6799,0,0,0,0,0,0,20803
892,TOTAL (STATES),2009,,DEATH OF DEAR PERSON,6,116,172,93,60,447,14,150,102,47,21,334,0,0,0,0,0,0,781
1438,TOTAL (STATES),2009,,DOWRY DISPUTE,1,29,32,11,0,73,10,2011,726,44,7,2798,0,0,0,0,0,0,2871
1984,TOTAL (STATES),2009,,DRUG ABUSE,7,666,1227,746,160,2806,2,29,37,18,12,98,0,0,0,0,0,0,2904
2530,TOTAL (STATES),2009,,ECONOMIC ISSUES,39,2360,3854,2560,588,9401,24,586,643,342,106,1701,0,0,0,0,0,0,11102
3076,TOTAL (STATES),2009,,EXAM FAILURE,142,846,74,15,0,1077,144,690,32,6,0,872,0,0,0,0,0,0,1949
3622,TOTAL (STATES),2009,,FAMILY PROBLEMS,162,5296,7133,4186,1305,18082,174,5046,3888,1756,532,11396,0,0,0,0,0,0,29478
4168,TOTAL (STATES),2009,,HEALTH ISSUES,75,2239,3577,3612,2309,11812,89,1905,1899,1369,945,6207,0,0,0,0,0,0,18019
4713,TOTAL (STATES),2009,,HERO WORSHIP,1,21,17,76,1,116,0,9,2,1,0,12,0,0,0,0,0,0,128
5258,TOTAL (STATES),2009,,ILLEGITIMATE PREGNANCY,0,0,0,0,0,0,6,91,39,5,0,141,0,0,0,0,0,0,141
5803,TOTAL (STATES),2009,,LOVE AFFAIRS,34,1379,430,43,3,1889,89,1319,320,11,1,1740,0,0,0,0,0,0,3629
6349,TOTAL (STATES),2009,,MARITAL ISSUES,6,587,514,188,18,1313,19,1025,615,128,30,1817,0,0,0,0,0,0,3130
6895,TOTAL (STATES),2009,,MENTAL HEALTH,65,1507,1821,1401,565,5359,42,967,1044,662,316,3031,0,0,0,0,0,0,8390
7441,TOTAL (STATES),2009,,OTHERS,465,3744,4610,3095,983,12897,467,2733,2241,1369,403,7213,0,0,0,0,0,0,20110
8025,TOTAL (STATES),2009,,"PHYSICAL ABUSE (RAPE,INCEST ETC.)",3,48,21,12,7,91,8,137,55,19,6,225,0,0,0,0,0,0,316
8532,TOTAL (STATES),2009,,SOCIETAL ISSUES,3,179,260,172,56,670,11,182,161,79,16,449,0,0,0,0,0,0,1119
385,TOTAL (STATES),2010,,CAUSES NOT KNOWN,448,4611,5290,3339,1289,14977,359,2736,2231,1241,466,7033,0,0,0,0,0,0,22010
931,TOTAL (STATES),2010,,DEATH OF DEAR PERSON,72,147,161,131,67,578,19,174,123,61,48,425,0,0,0,0,0,0,1003
1477,TOTAL (STATES),2010,,DOWRY DISPUTE,1,33,37,7,2,80,4,2093,833,43,6,2979,0,0,0,0,0,0,3059
2023,TOTAL (STATES),2010,,DRUG ABUSE,5,731,1388,856,230,3210,3,33,31,26,10,103,0,0,0,0,0,0,3313
2569,TOTAL (STATES),2010,,ECONOMIC ISSUES,39,2419,3508,2306,621,8893,28,684,683,331,93,1819,0,0,0,0,0,0,10712
3115,TOTAL (STATES),2010,,EXAM FAILURE,157,1095,60,11,3,1326,154,919,27,1,0,1101,0,0,0,0,0,0,2427
3661,TOTAL (STATES),2010,,FAMILY PROBLEMS,191,5650,7472,4682,1496,19491,185,5417,3754,1804,624,11784,0,0,0,0,0,0,31275
4207,TOTAL (STATES),2010,,HEALTH ISSUES,88,2528,3653,3731,2259,12259,163,1975,1895,1489,985,6507,0,0,0,0,0,0,18766
4752,TOTAL (STATES),2010,,HERO WORSHIP,0,27,17,7,3,54,1,27,14,4,2,48,0,0,0,0,0,0,102
5297,TOTAL (STATES),2010,,ILLEGITIMATE PREGNANCY,0,0,0,0,0,0,7,105,40,1,0,153,0,0,0,0,0,0,153
5842,TOTAL (STATES),2010,,LOVE AFFAIRS,36,1562,520,55,1,2174,98,1468,330,19,1,1916,0,0,0,0,0,0,4090
6388,TOTAL (STATES),2010,,MARITAL ISSUES,6,646,534,147,26,1359,21,1092,658,124,10,1905,0,0,0,0,0,0,3264
6934,TOTAL (STATES),2010,,MENTAL HEALTH,81,1629,2082,1593,667,6052,86,1154,1066,667,345,3318,0,0,0,0,0,0,9370
7480,TOTAL (STATES),2010,,OTHERS,479,4415,4874,3440,1127,14335,315,2471,2271,1182,530,6769,0,0,0,0,0,0,21104
8064,TOTAL (STATES),2010,,"PHYSICAL ABUSE (RAPE,INCEST ETC.)",2,36,25,12,1,76,12,125,61,20,2,220,0,0,0,0,0,0,296
8571,TOTAL (STATES),2010,,SOCIETAL ISSUES,10,284,280,196,53,823,6,222,165,52,14,459,0,0,0,0,0,0,1282
424,TOTAL (STATES),2011,,CAUSES NOT KNOWN,428,4515,5684,3237,1403,15267,348,2679,2249,1310,529,7115,0,0,0,0,0,0,22382
970,TOTAL (STATES),2011,,DEATH OF DEAR PERSON,7,131,149,120,45,452,16,181,141,62,32,432,0,0,0,0,0,0,884
1516,TOTAL (STATES),2011,,DOWRY DISPUTE,0,46,71,18,1,136,2,2017,959,96,0,3074,0,0,0,0,0,0,3210
2062,TOTAL (STATES),2011,,DRUG ABUSE,6,903,1486,868,219,3482,1,39,35,34,10,119,0,0,0,0,0,0,3601
2608,TOTAL (STATES),2011,,ECONOMIC ISSUES,17,2193,3405,2277,505,8397,30,589,686,371,101,1777,0,0,0,0,0,0,10174
3154,TOTAL (STATES),2011,,EXAM FAILURE,158,1083,54,9,1,1305,120,871,29,5,0,1025,0,0,0,0,0,0,2330
3700,TOTAL (STATES),2011,,FAMILY PROBLEMS,141,5806,7763,4790,1405,19905,192,5633,4159,1793,549,12326,0,0,0,0,0,0,32231
4246,TOTAL (STATES),2011,,HEALTH ISSUES,84,2223,3483,3383,2091,11264,83,2007,1818,1338,959,6205,0,0,0,0,0,0,17469
4791,TOTAL (STATES),2011,,HERO WORSHIP,2,4,12,4,2,24,4,6,6,0,0,16,0,0,0,0,0,0,40
5336,TOTAL (STATES),2011,,ILLEGITIMATE PREGNANCY,0,0,0,0,0,0,10,126,39,6,0,181,0,0,0,0,0,0,181
5881,TOTAL (STATES),2011,,LOVE AFFAIRS,136,1705,551,47,1,2440,78,1599,333,59,1,2070,0,0,0,0,0,0,4510
6427,TOTAL (STATES),2011,,MARITAL ISSUES,9,793,676,239,29,1746,16,1021,670,122,14,1843,0,0,0,0,0,0,3589
6973,TOTAL (STATES),2011,,MENTAL HEALTH,34,1407,1915,1492,665,5513,57,1036,1083,702,305,3183,0,0,0,0,0,0,8696
7519,TOTAL (STATES),2011,,OTHERS,528,4823,5218,3522,1278,15369,466,2785,2162,986,478,6877,0,0,0,0,0,0,22246
8103,TOTAL (STATES),2011,,"PHYSICAL ABUSE (RAPE,INCEST ETC.)",1,45,31,7,1,85,5,114,74,5,3,201,0,0,0,0,0,0,286
8610,TOTAL (STATES),2011,,SOCIETAL ISSUES,1,130,323,199,27,680,3,202,172,72,17,466,0,0,0,0,0,0,1146
463,TOTAL (STATES),2012,,CAUSES NOT KNOWN,297,3591,4629,2733,991,12241,242,2149,1506,902,384,5183,0,0,0,0,0,0,17424
1009,TOTAL (STATES),2012,,DEATH OF DEAR PERSON,3,93,142,96,81,415,10,140,118,74,39,381,0,0,0,0,0,0,796
1555,TOTAL (STATES),2012,,DOWRY DISPUTE,1,21,14,4,0,40,2,1330,443,59,0,1834,0,0,0,0,0,0,1874
2101,TOTAL (STATES),2012,,DRUG ABUSE,4,957,1598,1017,256,3832,3,35,47,33,7,125,0,0,0,0,0,0,3957
2647,TOTAL (STATES),2012,,ECONOMIC ISSUES,15,1834,2827,1812,463,6951,12,454,517,305,89,1377,0,0,0,0,0,0,8328
3193,TOTAL (STATES),2012,,EXAM FAILURE,113,946,44,6,0,1109,94,892,54,0,0,1040,0,0,0,0,0,0,2149
3739,TOTAL (STATES),2012,,FAMILY PROBLEMS,137,5290,7354,4836,1478,19095,210,4989,3617,1659,533,11008,0,0,0,0,0,0,30103
4285,TOTAL (STATES),2012,,HEALTH ISSUES,62,2110,3407,3335,2159,11073,80,1902,1831,1305,864,5982,0,0,0,0,0,0,17055
4830,TOTAL (STATES),2012,,HERO WORSHIP,5,50,26,17,3,101,1,39,23,8,4,75,0,0,0,0,0,0,176
5375,TOTAL (STATES),2012,,ILLEGITIMATE PREGNANCY,0,0,0,0,0,0,1,70,18,4,0,93,0,0,0,0,0,0,93
5920,TOTAL (STATES),2012,,LOVE AFFAIRS,26,1454,439,49,1,1969,78,1337,312,40,1,1768,0,0,0,0,0,0,3737
6466,TOTAL (STATES),2012,,MARITAL ISSUES,1,518,479,162,27,1187,14,800,532,108,11,1465,0,0,0,0,0,0,2652
7012,TOTAL (STATES),2012,,MENTAL HEALTH,27,1402,1710,1261,697,5097,37,934,763,537,317,2588,0,0,0,0,0,0,7685
7558,TOTAL (STATES),2012,,OTHERS,392,4136,4914,3374,1262,14078,358,2529,1958,1038,487,6370,0,0,0,0,0,0,20448
8142,TOTAL (STATES),2012,,"PHYSICAL ABUSE (RAPE,INCEST ETC.)",2,17,27,18,23,87,9,106,56,20,3,194,0,0,0,0,0,0,281
8649,TOTAL (STATES),2012,,SOCIETAL ISSUES,4,188,236,198,32,658,5,134,94,49,12,294,0,0,0,0,0,0,952
502,TOTAL (STATES),2013,,CAUSES NOT KNOWN,395,4481,4974,3143,1033,14026,304,2541,1858,941,358,6002,0,0,0,0,0,0,20028
1048,TOTAL (STATES),2013,,DEATH OF DEAR PERSON,5,172,182,122,83,564,4,169,127,77,39,416,0,0,0,0,0,0,980
1594,TOTAL (STATES),2013,,DOWRY DISPUTE,0,25,15,22,2,64,10,1587,501,53,3,2154,0,0,0,0,0,0,2218
2140,TOTAL (STATES),2013,,DRUG ABUSE,10,1049,1831,1255,312,4457,1,28,43,30,10,112,0,0,0,0,0,0,4569
2686,TOTAL (STATES),2013,,ECONOMIC ISSUES,15,2040,3085,2005,375,7520,7,465,513,319,115,1419,0,0,0,0,0,0,8939
3232,TOTAL (STATES),2013,,EXAM FAILURE,158,1092,99,9,3,1361,97,894,52,1,0,1044,0,0,0,0,0,0,2405
3778,TOTAL (STATES),2013,,FAMILY PROBLEMS,136,5654,7929,5071,1764,20554,168,4773,3756,1660,613,10970,0,0,0,0,0,0,31524
4324,TOTAL (STATES),2013,,HEALTH ISSUES,71,2178,3778,3684,2448,12159,127,1919,1717,1272,1006,6041,0,0,0,0,0,0,18200
4869,TOTAL (STATES),2013,,HERO WORSHIP,5,72,38,17,7,139,2,54,19,5,2,82,0,0,0,0,0,0,221
5414,TOTAL (STATES),2013,,ILLEGITIMATE PREGNANCY,0,0,0,0,0,0,7,114,30,1,0,152,0,0,0,0,0,0,152
5959,TOTAL (STATES),2013,,LOVE AFFAIRS,42,1707,653,91,0,2493,74,1418,339,45,1,1877,0,0,0,0,0,0,4370
6505,TOTAL (STATES),2013,,MARITAL ISSUES,2,728,616,220,39,1605,13,891,559,136,13,1612,0,0,0,0,0,0,3217
7051,TOTAL (STATES),2013,,MENTAL HEALTH,52,1432,1771,1336,558,5149,49,907,907,607,301,2771,0,0,0,0,0,0,7920
7597,TOTAL (STATES),2013,,OTHERS,624,5030,6009,4157,1506,17326,439,3060,2623,1363,572,8057,0,0,0,0,0,0,25383
8181,TOTAL (STATES),2013,,"PHYSICAL ABUSE (RAPE,INCEST ETC.)",0,18,23,30,3,74,7,102,69,16,1,195,0,0,0,0,0,0,269
8688,TOTAL (STATES),2013,,SOCIETAL ISSUES,3,271,393,256,65,988,7,174,170,72,24,447,0,0,0,0,0,0,1435
541,TOTAL (STATES),2014,,CAUSES NOT KNOWN,174,4181,3628,2070,759,10812,134,2544,1265,621,218,4782,0,1,0,0,0,1,15595
1087,TOTAL (STATES),2014,,DEATH OF DEAR PERSON,1,181,216,173,82,653,3,151,74,47,46,321,0,0,0,0,0,0,974
1633,TOTAL (STATES),2014,,DOWRY DISPUTE,1,19,12,5,2,39,0,1671,421,44,12,2148,0,0,0,0,0,0,2187
2179,TOTAL (STATES),2014,,DRUG ABUSE,4,997,1395,884,215,3495,6,29,34,15,6,90,0,1,0,0,0,1,3586
2725,TOTAL (STATES),2014,,ECONOMIC ISSUES,2,2162,2867,1647,414,7092,8,406,420,154,37,1025,0,0,0,0,0,0,8117
3271,TOTAL (STATES),2014,,EXAM FAILURE,89,1200,26,2,0,1317,66,933,25,2,0,1026,0,0,0,0,0,0,2343
3817,TOTAL (STATES),2014,,FAMILY PROBLEMS,126,6028,6891,3910,1271,18226,110,4839,3187,1211,451,9798,0,2,0,0,0,2,28026
4363,TOTAL (STATES),2014,,HEALTH ISSUES,132,6696,8383,7102,4710,27023,145,4639,3404,2537,2102,12827,0,5,3,0,0,8,39858
4908,TOTAL (STATES),2014,,HERO WORSHIP,1,23,10,7,2,43,2,8,3,0,0,13,0,0,0,0,0,0,56
5453,TOTAL (STATES),2014,,ILLEGITIMATE PREGNANCY,0,0,0,0,0,0,1,44,11,0,0,56,0,0,0,0,0,0,56
5998,TOTAL (STATES),2014,,LOVE AFFAIRS,12,1867,422,63,10,2374,29,1454,193,8,0,1684,0,0,0,0,0,0,4058
6544,TOTAL (STATES),2014,,MARITAL ISSUES,12,1782,1268,391,74,3527,16,3831,1561,215,43,5666,0,0,0,0,0,0,9193
7090,TOTAL (STATES),2014,,MENTAL HEALTH,56,1560,1531,1112,460,4719,23,897,702,439,264,2325,0,1,1,0,0,2,7046
7636,TOTAL (STATES),2014,,OTHERS,367,9579,8969,4970,1567,25452,334,5663,3298,1535,631,11461,0,6,0,1,0,7,36920
7675,TOTAL (STATES),2014,,PHYSICAL ABUSE,0,3,0,3,0,6,4,48,11,2,1,66,0,0,0,0,0,0,72
8727,TOTAL (STATES),2014,,SOCIETAL ISSUES,2,92,134,98,33,359,7,69,33,12,6,127,0,0,0,0,0,0,486
35,TOTAL (UTs),2001,,CAUSES NOT KNOWN,5,125,112,68,16,326,8,108,67,13,7,203,0,0,0,0,0,0,529
581,TOTAL (UTs),2001,,DEATH OF DEAR PERSON,0,3,1,3,0,7,0,5,4,0,0,9,0,0,0,0,0,0,16
1127,TOTAL (UTs),2001,,DOWRY DISPUTE,0,1,0,0,0,1,0,26,8,0,0,34,0,0,0,0,0,0,35
1673,TOTAL (UTs),2001,,DRUG ABUSE,0,2,10,4,1,17,0,1,0,0,0,1,0,0,0,0,0,0,18
2219,TOTAL (UTs),2001,,ECONOMIC ISSUES,3,60,55,15,1,134,2,17,23,2,0,44,0,0,0,0,0,0,178
2765,TOTAL (UTs),2001,,EXAM FAILURE,3,14,0,0,0,17,2,14,0,0,0,16,0,0,0,0,0,0,33
3311,TOTAL (UTs),2001,,FAMILY PROBLEMS,5,126,135,47,23,336,16,145,72,25,3,261,0,0,0,0,0,0,597
3857,TOTAL (UTs),2001,,HEALTH ISSUES,1,36,56,69,32,194,5,66,23,14,8,116,0,0,0,0,0,0,310
4403,TOTAL (UTs),2001,,HERO WORSHIP,0,0,0,1,0,1,0,0,1,0,0,1,0,0,0,0,0,0,2
4948,TOTAL (UTs),2001,,ILLEGITIMATE PREGNANCY,0,0,0,0,0,0,0,4,0,0,0,4,0,0,0,0,0,0,4
5493,TOTAL (UTs),2001,,LOVE AFFAIRS,0,21,2,0,0,23,2,20,0,0,0,22,0,0,0,0,0,0,45
6038,TOTAL (UTs),2001,,MARITAL ISSUES,0,6,6,3,0,15,0,23,7,0,0,30,0,0,0,0,0,0,45
6584,TOTAL (UTs),2001,,MENTAL HEALTH,0,7,8,5,1,21,0,10,11,3,3,27,0,0,0,0,0,0,48
7130,TOTAL (UTs),2001,,OTHERS,2,49,42,11,9,113,2,20,16,4,0,42,0,0,0,0,0,0,155
7715,TOTAL (UTs),2001,,"PHYSICAL ABUSE (RAPE,INCEST ETC.)",0,0,0,0,0,0,0,4,0,0,0,4,0,0,0,0,0,0,4
8221,TOTAL (UTs),2001,,SOCIETAL ISSUES,0,6,2,3,0,11,0,1,0,0,0,1,0,0,0,0,0,0,12
74,TOTAL (UTs),2002,,CAUSES NOT KNOWN,8,110,89,45,10,262,4,68,31,10,4,117,0,0,0,0,0,0,379
620,TOTAL (UTs),2002,,DEATH OF DEAR PERSON,0,4,1,2,1,8,0,4,0,2,1,7,0,0,0,0,0,0,15
1166,TOTAL (UTs),2002,,DOWRY DISPUTE,0,2,0,0,0,2,0,34,15,1,0,50,0,0,0,0,0,0,52
1712,TOTAL (UTs),2002,,DRUG ABUSE,0,18,4,2,0,24,0,0,1,0,0,1,0,0,0,0,0,0,25
2258,TOTAL (UTs),2002,,ECONOMIC ISSUES,0,32,42,21,1,96,1,6,3,4,0,14,0,0,0,0,0,0,110
2804,TOTAL (UTs),2002,,EXAM FAILURE,7,15,0,0,0,22,7,17,0,0,0,24,0,0,0,0,0,0,46
3350,TOTAL (UTs),2002,,FAMILY PROBLEMS,7,159,173,72,13,424,8,127,71,14,3,223,0,0,0,0,0,0,647
3896,TOTAL (UTs),2002,,HEALTH ISSUES,0,33,59,63,31,186,0,35,37,16,13,101,0,0,0,0,0,0,287
4442,TOTAL (UTs),2002,,HERO WORSHIP,0,0,0,0,0,0,0,0,0,0,0,0,0,0,0,0,0,0,0
4987,TOTAL (UTs),2002,,ILLEGITIMATE PREGNANCY,0,0,0,0,0,0,0,3,2,0,0,5,0,0,0,0,0,0,5
5532,TOTAL (UTs),2002,,LOVE AFFAIRS,0,27,6,0,0,33,0,27,3,0,0,30,0,0,0,0,0,0,63
6077,TOTAL (UTs),2002,,MARITAL ISSUES,0,7,6,1,0,14,0,13,6,0,0,19,0,0,0,0,0,0,33
6623,TOTAL (UTs),2002,,MENTAL HEALTH,1,21,26,13,8,69,1,10,12,4,1,28,0,0,0,0,0,0,97
7169,TOTAL (UTs),2002,,OTHERS,1,28,38,16,10,93,1,26,9,4,5,45,0,0,0,0,0,0,138
7754,TOTAL (UTs),2002,,"PHYSICAL ABUSE (RAPE,INCEST ETC.)",0,0,0,0,0,0,0,5,0,0,0,5,0,0,0,0,0,0,5
8260,TOTAL (UTs),2002,,SOCIETAL ISSUES,0,6,4,1,0,11,0,3,2,0,0,5,0,0,0,0,0,0,16
113,TOTAL (UTs),2003,,CAUSES NOT KNOWN,9,115,93,47,7,271,9,74,38,15,2,138,0,0,0,0,0,0,409
659,TOTAL (UTs),2003,,DEATH OF DEAR PERSON,0,6,4,2,1,13,1,1,1,0,0,3,0,0,0,0,0,0,16
1205,TOTAL (UTs),2003,,DOWRY DISPUTE,0,1,0,0,0,1,1,32,5,7,0,45,0,0,0,0,0,0,46
1751,TOTAL (UTs),2003,,DRUG ABUSE,0,11,10,1,0,22,0,0,0,0,0,0,0,0,0,0,0,0,22
2297,TOTAL (UTs),2003,,ECONOMIC ISSUES,0,38,38,8,3,87,0,7,5,1,0,13,0,0,0,0,0,0,100
2843,TOTAL (UTs),2003,,EXAM FAILURE,3,19,1,0,0,23,6,20,0,0,0,26,0,0,0,0,0,0,49
3389,TOTAL (UTs),2003,,FAMILY PROBLEMS,7,156,177,68,12,420,4,145,56,18,3,226,0,0,0,0,0,0,646
3935,TOTAL (UTs),2003,,HEALTH ISSUES,0,31,62,57,33,183,0,48,22,23,16,109,0,0,0,0,0,0,292
4481,TOTAL (UTs),2003,,HERO WORSHIP,0,0,0,0,0,0,0,0,0,0,0,0,0,0,0,0,0,0,0
5026,TOTAL (UTs),2003,,ILLEGITIMATE PREGNANCY,0,0,0,0,0,0,0,1,0,0,0,1,0,0,0,0,0,0,1
5571,TOTAL (UTs),2003,,LOVE AFFAIRS,0,27,2,0,0,29,0,22,0,0,0,22,0,0,0,0,0,0,51
6116,TOTAL (UTs),2003,,MARITAL ISSUES,0,14,5,0,0,19,1,14,8,0,0,23,0,0,0,0,0,0,42
6662,TOTAL (UTs),2003,,MENTAL HEALTH,0,20,21,3,5,49,0,15,12,4,3,34,0,0,0,0,0,0,83
7208,TOTAL (UTs),2003,,OTHERS,6,66,69,24,17,182,2,39,21,5,2,69,0,0,0,0,0,0,251
7793,TOTAL (UTs),2003,,"PHYSICAL ABUSE (RAPE,INCEST ETC.)",0,1,0,0,0,1,0,3,0,0,0,3,0,0,0,0,0,0,4
8299,TOTAL (UTs),2003,,SOCIETAL ISSUES,1,5,8,2,0,16,0,0,1,0,0,1,0,0,0,0,0,0,17
152,TOTAL (UTs),2004,,CAUSES NOT KNOWN,6,134,122,38,6,306,4,87,26,7,4,128,0,0,0,0,0,0,434
698,TOTAL (UTs),2004,,DEATH OF DEAR PERSON,0,2,4,3,0,9,0,5,1,2,0,8,0,0,0,0,0,0,17
1244,TOTAL (UTs),2004,,DOWRY DISPUTE,0,0,0,0,0,0,0,48,6,0,0,54,0,0,0,0,0,0,54
1790,TOTAL (UTs),2004,,DRUG ABUSE,0,11,10,4,0,25,0,1,2,0,1,4,0,0,0,0,0,0,29
2336,TOTAL (UTs),2004,,ECONOMIC ISSUES,3,55,41,13,2,114,0,18,3,1,1,23,0,0,0,0,0,0,137
2882,TOTAL (UTs),2004,,EXAM FAILURE,4,30,0,0,0,34,7,21,0,0,0,28,0,0,0,0,0,0,62
3428,TOTAL (UTs),2004,,FAMILY PROBLEMS,1,108,152,67,13,341,2,105,80,15,13,215,0,0,0,0,0,0,556
3974,TOTAL (UTs),2004,,HEALTH ISSUES,1,44,46,71,33,195,2,56,36,12,9,115,0,0,0,0,0,0,310
4520,TOTAL (UTs),2004,,HERO WORSHIP,0,1,0,0,0,1,0,1,1,0,0,2,0,0,0,0,0,0,3
5065,TOTAL (UTs),2004,,ILLEGITIMATE PREGNANCY,0,0,0,0,0,0,0,0,0,0,0,0,0,0,0,0,0,0,0
5610,TOTAL (UTs),2004,,LOVE AFFAIRS,0,18,1,1,0,20,1,22,1,0,0,24,0,0,0,0,0,0,44
6155,TOTAL (UTs),2004,,MARITAL ISSUES,0,8,3,0,0,11,0,30,5,0,0,35,0,0,0,0,0,0,46
6701,TOTAL (UTs),2004,,MENTAL HEALTH,0,22,20,13,4,59,2,12,9,3,2,28,0,0,0,0,0,0,87
7247,TOTAL (UTs),2004,,OTHERS,5,53,66,34,7,165,4,32,30,10,3,79,0,0,0,0,0,0,244
7832,TOTAL (UTs),2004,,"PHYSICAL ABUSE (RAPE,INCEST ETC.)",0,0,0,0,0,0,0,1,1,0,0,2,0,0,0,0,0,0,2
8338,TOTAL (UTs),2004,,SOCIETAL ISSUES,0,3,8,4,0,15,0,3,1,0,0,4,0,0,0,0,0,0,19
191,TOTAL (UTs),2005,,CAUSES NOT KNOWN,3,161,102,48,8,322,7,95,47,9,1,159,0,0,0,0,0,0,481
737,TOTAL (UTs),2005,,DEATH OF DEAR PERSON,0,4,5,2,0,11,0,3,3,0,3,9,0,0,0,0,0,0,20
1283,TOTAL (UTs),2005,,DOWRY DISPUTE,0,4,0,0,0,4,0,44,6,1,0,51,0,0,0,0,0,0,55
1829,TOTAL (UTs),2005,,DRUG ABUSE,0,9,12,5,0,26,0,0,1,0,0,1,0,0,0,0,0,0,27
2375,TOTAL (UTs),2005,,ECONOMIC ISSUES,0,41,43,2,2,88,0,11,6,2,0,19,0,0,0,0,0,0,107
2921,TOTAL (UTs),2005,,EXAM FAILURE,3,15,2,0,0,20,2,17,0,0,0,19,0,0,0,0,0,0,39
3467,TOTAL (UTs),2005,,FAMILY PROBLEMS,1,140,158,109,22,430,1,127,83,14,4,229,0,0,0,0,0,0,659
4013,TOTAL (UTs),2005,,HEALTH ISSUES,0,32,31,52,31,146,0,43,29,18,17,107,0,0,0,0,0,0,253
4559,TOTAL (UTs),2005,,HERO WORSHIP,0,0,0,0,0,0,0,1,0,0,0,1,0,0,0,0,0,0,1
5104,TOTAL (UTs),2005,,ILLEGITIMATE PREGNANCY,0,0,0,0,0,0,0,0,0,0,0,0,0,0,0,0,0,0,0
5649,TOTAL (UTs),2005,,LOVE AFFAIRS,1,28,7,0,0,36,1,21,2,0,0,24,0,0,0,0,0,0,60
6194,TOTAL (UTs),2005,,MARITAL ISSUES,0,6,5,0,0,11,0,10,6,0,0,16,0,0,0,0,0,0,27
6740,TOTAL (UTs),2005,,MENTAL HEALTH,1,15,17,12,3,48,1,14,6,9,3,33,0,0,0,0,0,0,81
7286,TOTAL (UTs),2005,,OTHERS,8,49,63,33,11,164,7,51,24,12,6,100,0,0,0,0,0,0,264
7871,TOTAL (UTs),2005,,"PHYSICAL ABUSE (RAPE,INCEST ETC.)",0,0,0,0,0,0,0,0,0,0,0,0,0,0,0,0,0,0,0
8377,TOTAL (UTs),2005,,SOCIETAL ISSUES,0,15,7,4,0,26,0,4,7,1,0,12,0,0,0,0,0,0,38
230,TOTAL (UTs),2006,,CAUSES NOT KNOWN,5,203,165,66,13,452,12,128,67,10,3,220,0,0,0,0,0,0,672
776,TOTAL (UTs),2006,,DEATH OF DEAR PERSON,0,4,4,3,0,11,0,1,1,2,1,5,0,0,0,0,0,0,16
1322,TOTAL (UTs),2006,,DOWRY DISPUTE,0,0,0,0,0,0,0,62,8,0,0,70,0,0,0,0,0,0,70
1868,TOTAL (UTs),2006,,DRUG ABUSE,0,9,12,3,3,27,0,1,4,0,0,5,0,0,0,0,0,0,32
2414,TOTAL (UTs),2006,,ECONOMIC ISSUES,0,56,45,17,0,118,0,9,2,1,0,12,0,0,0,0,0,0,130
2960,TOTAL (UTs),2006,,EXAM FAILURE,1,12,0,0,0,13,4,14,0,0,0,18,0,0,0,0,0,0,31
3506,TOTAL (UTs),2006,,FAMILY PROBLEMS,4,151,147,57,14,373,6,121,76,11,3,217,0,0,0,0,0,0,590
4052,TOTAL (UTs),2006,,HEALTH ISSUES,0,33,68,58,29,188,4,59,20,15,8,106,0,0,0,0,0,0,294
4597,TOTAL (UTs),2006,,HERO WORSHIP,0,0,0,0,0,0,0,0,0,0,0,0,0,0,0,0,0,0,0
5142,TOTAL (UTs),2006,,ILLEGITIMATE PREGNANCY,0,8,0,0,0,8,0,3,0,0,0,3,0,0,0,0,0,0,11
5687,TOTAL (UTs),2006,,LOVE AFFAIRS,1,36,3,0,0,40,4,21,3,0,0,28,0,0,0,0,0,0,68
6233,TOTAL (UTs),2006,,MARITAL ISSUES,0,4,4,2,0,10,0,12,4,1,0,17,0,0,0,0,0,0,27
6779,TOTAL (UTs),2006,,MENTAL HEALTH,0,19,25,18,7,69,0,16,6,4,3,29,0,0,0,0,0,0,98
7325,TOTAL (UTs),2006,,OTHERS,7,57,63,33,7,167,1,37,13,4,5,60,0,0,0,0,0,0,227
7909,TOTAL (UTs),2006,,"PHYSICAL ABUSE (RAPE,INCEST ETC.)",0,0,0,0,0,0,0,0,0,0,0,0,0,0,0,0,0,0,0
8416,TOTAL (UTs),2006,,SOCIETAL ISSUES,0,3,12,7,1,23,0,2,5,1,0,8,0,0,0,0,0,0,31
269,TOTAL (UTs),2007,,CAUSES NOT KNOWN,5,207,175,61,13,461,7,122,47,8,5,189,0,0,0,0,0,0,650
815,TOTAL (UTs),2007,,DEATH OF DEAR PERSON,0,1,5,1,3,10,0,2,1,0,0,3,0,0,0,0,0,0,13
1361,TOTAL (UTs),2007,,DOWRY DISPUTE,0,2,0,0,0,2,0,65,5,0,0,70,0,0,0,0,0,0,72
1907,TOTAL (UTs),2007,,DRUG ABUSE,0,10,8,1,1,20,0,1,0,1,1,3,0,0,0,0,0,0,23
2453,TOTAL (UTs),2007,,ECONOMIC ISSUES,0,60,29,11,1,101,0,15,3,0,0,18,0,0,0,0,0,0,119
2999,TOTAL (UTs),2007,,EXAM FAILURE,4,29,1,0,0,34,5,30,0,0,0,35,0,0,0,0,0,0,69
3545,TOTAL (UTs),2007,,FAMILY PROBLEMS,3,117,203,75,13,411,2,139,93,9,4,247,0,0,0,0,0,0,658
4091,TOTAL (UTs),2007,,HEALTH ISSUES,1,26,40,37,27,131,2,38,15,7,9,71,0,0,0,0,0,0,202
4636,TOTAL (UTs),2007,,HERO WORSHIP,0,0,0,0,0,0,0,3,2,2,0,7,0,0,0,0,0,0,7
5181,TOTAL (UTs),2007,,ILLEGITIMATE PREGNANCY,0,0,0,0,0,0,0,0,0,0,0,0,0,0,0,0,0,0,0
5726,TOTAL (UTs),2007,,LOVE AFFAIRS,0,30,3,0,0,33,1,40,3,1,0,45,0,0,0,0,0,0,78
6272,TOTAL (UTs),2007,,MARITAL ISSUES,0,9,6,0,0,15,1,16,5,0,0,22,0,0,0,0,0,0,37
6818,TOTAL (UTs),2007,,MENTAL HEALTH,0,11,20,21,3,55,0,8,16,6,2,32,0,0,0,0,0,0,87
7364,TOTAL (UTs),2007,,OTHERS,4,72,78,38,15,207,9,52,17,7,4,89,0,0,0,0,0,0,296
7948,TOTAL (UTs),2007,,"PHYSICAL ABUSE (RAPE,INCEST ETC.)",0,6,2,1,0,9,0,0,0,0,0,0,0,0,0,0,0,0,9
8455,TOTAL (UTs),2007,,SOCIETAL ISSUES,0,4,1,1,1,7,0,2,1,0,0,3,0,0,0,0,0,0,10
308,TOTAL (UTs),2008,,CAUSES NOT KNOWN,3,149,134,41,12,339,3,106,38,11,3,161,0,0,0,0,0,0,500
854,TOTAL (UTs),2008,,DEATH OF DEAR PERSON,0,1,4,2,2,9,0,7,1,2,1,11,0,0,0,0,0,0,20
1400,TOTAL (UTs),2008,,DOWRY DISPUTE,0,0,0,0,0,0,0,39,10,0,0,49,0,0,0,0,0,0,49
1946,TOTAL (UTs),2008,,DRUG ABUSE,0,14,10,1,0,25,0,2,1,1,0,4,0,0,0,0,0,0,29
2492,TOTAL (UTs),2008,,ECONOMIC ISSUES,0,64,52,20,2,138,1,14,5,2,0,22,0,0,0,0,0,0,160
3038,TOTAL (UTs),2008,,EXAM FAILURE,9,32,1,0,1,43,4,26,4,0,0,34,0,0,0,0,0,0,77
3584,TOTAL (UTs),2008,,FAMILY PROBLEMS,5,101,115,73,11,305,0,142,69,12,2,225,0,0,0,0,0,0,530
4130,TOTAL (UTs),2008,,HEALTH ISSUES,1,21,61,51,25,159,1,42,27,9,10,89,0,0,0,0,0,0,248
4675,TOTAL (UTs),2008,,HERO WORSHIP,0,0,1,0,0,1,0,0,0,0,0,0,0,0,0,0,0,0,1
5220,TOTAL (UTs),2008,,ILLEGITIMATE PREGNANCY,0,0,0,0,0,0,2,1,0,0,0,3,0,0,0,0,0,0,3
5765,TOTAL (UTs),2008,,LOVE AFFAIRS,0,42,2,0,0,44,1,41,1,0,0,43,0,0,0,0,0,0,87
6311,TOTAL (UTs),2008,,MARITAL ISSUES,0,16,2,2,0,20,1,27,7,2,0,37,0,0,0,0,0,0,57
6857,TOTAL (UTs),2008,,MENTAL HEALTH,0,11,23,29,2,65,1,11,7,4,3,26,0,0,0,0,0,0,91
7403,TOTAL (UTs),2008,,OTHERS,1,74,58,18,11,162,4,48,14,5,5,76,0,0,0,0,0,0,238
7987,TOTAL (UTs),2008,,"PHYSICAL ABUSE (RAPE,INCEST ETC.)",0,0,0,0,0,0,0,1,0,0,0,1,0,0,0,0,0,0,1
8494,TOTAL (UTs),2008,,SOCIETAL ISSUES,0,4,11,5,1,21,0,0,3,0,0,3,0,0,0,0,0,0,24
347,TOTAL (UTs),2009,,CAUSES NOT KNOWN,6,153,107,45,19,330,4,111,50,12,3,180,0,0,0,0,0,0,510
893,TOTAL (UTs),2009,,DEATH OF DEAR PERSON,0,3,5,1,4,13,0,5,4,0,0,9,0,0,0,0,0,0,22
1439,TOTAL (UTs),2009,,DOWRY DISPUTE,0,0,1,0,0,1,0,42,7,0,0,49,0,0,0,0,0,0,50
1985,TOTAL (UTs),2009,,DRUG ABUSE,0,16,17,5,0,38,0,0,0,0,0,0,0,0,0,0,0,0,38
2531,TOTAL (UTs),2009,,ECONOMIC ISSUES,0,68,40,18,2,128,1,20,3,2,2,28,0,0,0,0,0,0,156
3077,TOTAL (UTs),2009,,EXAM FAILURE,4,26,0,0,0,30,1,29,1,0,0,31,0,0,0,0,0,0,61
3623,TOTAL (UTs),2009,,FAMILY PROBLEMS,2,141,126,76,14,359,8,148,68,17,4,245,0,0,0,0,0,0,604
4169,TOTAL (UTs),2009,,HEALTH ISSUES,1,33,44,55,26,159,1,34,15,20,14,84,0,0,0,0,0,0,243
4714,TOTAL (UTs),2009,,HERO WORSHIP,0,0,0,0,0,0,0,0,0,0,0,0,0,0,0,0,0,0,0
5259,TOTAL (UTs),2009,,ILLEGITIMATE PREGNANCY,0,0,0,0,0,0,0,0,0,0,0,0,0,0,0,0,0,0,0
5804,TOTAL (UTs),2009,,LOVE AFFAIRS,0,36,1,0,1,38,3,41,0,0,0,44,0,0,0,0,0,0,82
6350,TOTAL (UTs),2009,,MARITAL ISSUES,0,14,15,1,0,30,2,22,10,0,0,34,0,0,0,0,0,0,64
6896,TOTAL (UTs),2009,,MENTAL HEALTH,0,22,16,12,7,57,1,2,11,5,3,22,0,0,0,0,0,0,79
7442,TOTAL (UTs),2009,,OTHERS,5,100,96,40,4,245,11,59,34,11,4,119,0,0,0,0,0,0,364
8026,TOTAL (UTs),2009,,"PHYSICAL ABUSE (RAPE,INCEST ETC.)",0,0,2,1,1,4,0,0,0,0,0,0,0,0,0,0,0,0,4
8533,TOTAL (UTs),2009,,SOCIETAL ISSUES,0,1,0,1,0,2,0,2,0,0,0,2,0,0,0,0,0,0,4
386,TOTAL (UTs),2010,,CAUSES NOT KNOWN,7,195,154,59,34,449,13,145,50,14,4,226,0,0,0,0,0,0,675
932,TOTAL (UTs),2010,,DEATH OF DEAR PERSON,0,5,4,5,2,16,1,10,3,2,0,16,0,0,0,0,0,0,32
1478,TOTAL (UTs),2010,,DOWRY DISPUTE,0,0,0,0,0,0,0,29,5,0,0,34,0,0,0,0,0,0,34
2024,TOTAL (UTs),2010,,DRUG ABUSE,1,10,10,5,2,28,0,0,1,1,0,2,0,0,0,0,0,0,30
2570,TOTAL (UTs),2010,,ECONOMIC ISSUES,0,52,46,16,2,116,0,11,2,2,0,15,0,0,0,0,0,0,131
3116,TOTAL (UTs),2010,,EXAM FAILURE,2,20,2,0,0,24,4,23,1,0,0,28,0,0,0,0,0,0,52
3662,TOTAL (UTs),2010,,FAMILY PROBLEMS,2,105,145,74,11,337,5,142,77,14,6,244,0,0,0,0,0,0,581
4208,TOTAL (UTs),2010,,HEALTH ISSUES,0,29,51,45,23,148,2,43,16,10,14,85,0,0,0,0,0,0,233
4753,TOTAL (UTs),2010,,HERO WORSHIP,0,0,0,0,0,0,0,0,0,0,0,0,0,0,0,0,0,0,0
5298,TOTAL (UTs),2010,,ILLEGITIMATE PREGNANCY,0,0,0,0,0,0,0,0,0,0,0,0,0,0,0,0,0,0,0
5843,TOTAL (UTs),2010,,LOVE AFFAIRS,1,37,4,0,0,42,0,31,2,1,0,34,0,0,0,0,0,0,76
6389,TOTAL (UTs),2010,,MARITAL ISSUES,0,11,13,1,0,25,0,16,13,1,0,30,0,0,0,0,0,0,55
6935,TOTAL (UTs),2010,,MENTAL HEALTH,2,22,29,14,6,73,0,8,11,2,1,22,0,0,0,0,0,0,95
7481,TOTAL (UTs),2010,,OTHERS,10,77,79,33,15,214,2,72,33,6,7,120,0,0,0,0,0,0,334
8065,TOTAL (UTs),2010,,"PHYSICAL ABUSE (RAPE,INCEST ETC.)",0,1,0,0,0,1,1,2,1,0,0,4,0,0,0,0,0,0,5
8572,TOTAL (UTs),2010,,SOCIETAL ISSUES,0,10,6,3,1,20,1,11,5,3,0,20,0,0,0,0,0,0,40
425,TOTAL (UTs),2011,,CAUSES NOT KNOWN,11,241,125,51,13,441,11,117,49,21,3,201,0,0,0,0,0,0,642
971,TOTAL (UTs),2011,,DEATH OF DEAR PERSON,0,2,3,4,1,10,0,1,1,0,0,2,0,0,0,0,0,0,12
1517,TOTAL (UTs),2011,,DOWRY DISPUTE,0,2,1,0,0,3,0,20,6,0,0,26,0,0,0,0,0,0,29
2063,TOTAL (UTs),2011,,DRUG ABUSE,2,17,17,9,1,46,0,4,5,2,0,11,0,0,0,0,0,0,57
2609,TOTAL (UTs),2011,,ECONOMIC ISSUES,0,72,65,13,1,151,0,20,1,2,0,23,0,0,0,0,0,0,174
3155,TOTAL (UTs),2011,,EXAM FAILURE,3,29,0,0,0,32,2,17,0,0,0,19,0,0,0,0,0,0,51
3701,TOTAL (UTs),2011,,FAMILY PROBLEMS,4,181,177,60,18,440,7,148,63,16,4,238,0,0,0,0,0,0,678
4247,TOTAL (UTs),2011,,HEALTH ISSUES,0,35,64,83,30,212,3,28,30,12,14,87,0,0,0,0,0,0,299
4792,TOTAL (UTs),2011,,HERO WORSHIP,0,1,0,0,0,1,0,0,0,0,0,0,0,0,0,0,0,0,1
5337,TOTAL (UTs),2011,,ILLEGITIMATE PREGNANCY,0,0,0,0,0,0,0,3,0,0,0,3,0,0,0,0,0,0,3
5882,TOTAL (UTs),2011,,LOVE AFFAIRS,0,40,3,0,0,43,1,30,2,0,0,33,0,0,0,0,0,0,76
6428,TOTAL (UTs),2011,,MARITAL ISSUES,0,38,5,4,0,47,1,26,5,0,1,33,0,0,0,0,0,0,80
6974,TOTAL (UTs),2011,,MENTAL HEALTH,0,17,29,17,5,68,1,18,8,7,4,38,0,0,0,0,0,0,106
7520,TOTAL (UTs),2011,,OTHERS,2,119,87,51,10,269,4,70,30,8,7,119,0,0,0,0,0,0,388
8104,TOTAL (UTs),2011,,"PHYSICAL ABUSE (RAPE,INCEST ETC.)",0,0,0,0,0,0,0,0,0,0,0,0,0,0,0,0,0,0,0
8611,TOTAL (UTs),2011,,SOCIETAL ISSUES,0,3,3,3,2,11,0,3,0,0,0,3,0,0,0,0,0,0,14
464,TOTAL (UTs),2012,,CAUSES NOT KNOWN,8,252,185,68,15,528,13,135,59,15,2,224,0,0,0,0,0,0,752
1010,TOTAL (UTs),2012,,DEATH OF DEAR PERSON,0,4,3,3,2,12,0,4,5,1,1,11,0,0,0,0,0,0,23
1556,TOTAL (UTs),2012,,DOWRY DISPUTE,0,0,1,0,0,1,0,48,9,3,0,60,0,0,0,0,0,0,61
2102,TOTAL (UTs),2012,,DRUG ABUSE,1,26,20,4,0,51,0,0,0,0,0,0,0,0,0,0,0,0,51
2648,TOTAL (UTs),2012,,ECONOMIC ISSUES,0,95,61,13,0,169,1,20,6,1,1,29,0,0,0,0,0,0,198
3194,TOTAL (UTs),2012,,EXAM FAILURE,9,44,0,0,0,53,10,33,1,0,0,44,0,0,0,0,0,0,97
3740,TOTAL (UTs),2012,,FAMILY PROBLEMS,4,172,187,63,16,442,3,133,86,15,10,247,0,0,0,0,0,0,689
4286,TOTAL (UTs),2012,,HEALTH ISSUES,2,25,62,68,38,195,2,38,28,15,14,97,0,0,0,0,0,0,292
4831,TOTAL (UTs),2012,,HERO WORSHIP,0,0,0,0,0,0,0,0,0,0,0,0,0,0,0,0,0,0,0
5376,TOTAL (UTs),2012,,ILLEGITIMATE PREGNANCY,0,0,0,0,0,0,0,0,0,0,0,0,0,0,0,0,0,0,0
5921,TOTAL (UTs),2012,,LOVE AFFAIRS,0,52,2,0,0,54,4,52,2,0,0,58,0,0,0,0,0,0,112
6467,TOTAL (UTs),2012,,MARITAL ISSUES,0,11,15,6,0,32,0,11,6,1,0,18,0,0,0,0,0,0,50
7013,TOTAL (UTs),2012,,MENTAL HEALTH,2,14,22,15,6,59,1,9,9,4,2,25,0,0,0,0,0,0,84
7559,TOTAL (UTs),2012,,OTHERS,5,86,75,37,19,222,4,70,26,9,9,118,0,0,0,0,0,0,340
8143,TOTAL (UTs),2012,,"PHYSICAL ABUSE (RAPE,INCEST ETC.)",0,0,0,0,0,0,0,0,0,0,0,0,0,0,0,0,0,0,0
8650,TOTAL (UTs),2012,,SOCIETAL ISSUES,0,10,7,2,3,22,0,2,3,2,0,7,0,0,0,0,0,0,29
503,TOTAL (UTs),2013,,CAUSES NOT KNOWN,11,272,205,131,59,678,13,168,62,14,2,259,0,0,0,0,0,0,937
1049,TOTAL (UTs),2013,,DEATH OF DEAR PERSON,0,5,0,2,1,8,0,2,3,2,1,8,0,0,0,0,0,0,16
1595,TOTAL (UTs),2013,,DOWRY DISPUTE,0,1,0,0,0,1,0,43,5,0,0,48,0,0,0,0,0,0,49
2141,TOTAL (UTs),2013,,DRUG ABUSE,0,9,11,2,0,22,0,0,0,0,0,0,0,0,0,0,0,0,22
2687,TOTAL (UTs),2013,,ECONOMIC ISSUES,0,45,61,9,0,115,0,4,1,2,0,7,0,0,0,0,0,0,122
3233,TOTAL (UTs),2013,,EXAM FAILURE,1,30,0,0,0,31,3,32,0,0,0,35,0,0,0,0,0,0,66
3779,TOTAL (UTs),2013,,FAMILY PROBLEMS,3,151,242,130,16,542,4,144,85,16,10,259,0,0,0,0,0,0,801
4325,TOTAL (UTs),2013,,HEALTH ISSUES,0,33,35,58,37,163,1,17,17,11,11,57,0,0,0,0,0,0,220
4870,TOTAL (UTs),2013,,HERO WORSHIP,0,0,0,0,0,0,0,0,0,0,0,0,0,0,0,0,0,0,0
5415,TOTAL (UTs),2013,,ILLEGITIMATE PREGNANCY,0,0,0,0,0,0,0,1,0,0,0,1,0,0,0,0,0,0,1
5960,TOTAL (UTs),2013,,LOVE AFFAIRS,1,59,12,0,0,72,3,46,4,0,0,53,0,0,0,0,0,0,125
6506,TOTAL (UTs),2013,,MARITAL ISSUES,0,12,6,1,0,19,0,14,4,0,0,18,0,0,0,0,0,0,37
7052,TOTAL (UTs),2013,,MENTAL HEALTH,0,22,16,13,8,59,0,9,8,2,8,27,0,0,0,0,0,0,86
7598,TOTAL (UTs),2013,,OTHERS,12,121,106,55,37,331,5,68,34,15,2,124,0,0,0,0,0,0,455
8182,TOTAL (UTs),2013,,"PHYSICAL ABUSE (RAPE,INCEST ETC.)",0,0,0,0,0,0,0,1,0,0,0,1,0,0,0,0,0,0,1
8689,TOTAL (UTs),2013,,SOCIETAL ISSUES,0,7,9,6,1,23,0,7,1,0,0,8,0,0,0,0,0,0,31
542,TOTAL (UTs),2014,,CAUSES NOT KNOWN,5,224,159,75,33,496,4,115,43,3,8,173,0,0,0,0,0,0,669
1088,TOTAL (UTs),2014,,DEATH OF DEAR PERSON,0,1,2,1,1,5,0,1,1,0,0,2,0,0,0,0,0,0,7
1634,TOTAL (UTs),2014,,DOWRY DISPUTE,0,0,0,0,0,0,0,68,6,0,0,74,0,0,0,0,0,0,74
2180,TOTAL (UTs),2014,,DRUG ABUSE,1,21,24,9,5,60,0,0,1,0,0,1,0,0,0,0,0,0,61
2726,TOTAL (UTs),2014,,ECONOMIC ISSUES,0,30,14,12,0,56,0,8,2,1,0,11,0,0,0,0,0,0,67
3272,TOTAL (UTs),2014,,EXAM FAILURE,2,37,2,0,0,41,6,13,0,0,0,19,0,0,0,0,0,0,60
3818,TOTAL (UTs),2014,,FAMILY PROBLEMS,3,138,150,80,26,397,6,98,51,17,7,179,0,0,0,0,0,0,576
4364,TOTAL (UTs),2014,,HEALTH ISSUES,4,103,123,72,70,372,2,48,56,14,38,158,0,0,0,0,0,0,530
4909,TOTAL (UTs),2014,,HERO WORSHIP,0,0,0,0,0,0,0,0,0,0,0,0,0,0,0,0,0,0,0
5454,TOTAL (UTs),2014,,ILLEGITIMATE PREGNANCY,0,0,0,0,0,0,0,0,0,0,0,0,0,0,0,0,0,0,0
5999,TOTAL (UTs),2014,,LOVE AFFAIRS,0,60,7,0,0,67,1,42,0,0,0,43,0,0,0,0,0,0,110
6545,TOTAL (UTs),2014,,MARITAL ISSUES,0,54,24,2,2,82,1,162,26,4,0,193,0,0,0,0,0,0,275
7091,TOTAL (UTs),2014,,MENTAL HEALTH,0,9,17,8,8,42,0,6,4,2,4,16,0,0,0,0,0,0,58
7637,TOTAL (UTs),2014,,OTHERS,11,346,234,176,45,812,8,193,67,23,16,307,0,0,0,0,0,0,1119
7676,TOTAL (UTs),2014,,PHYSICAL ABUSE,0,0,0,0,0,0,0,1,1,0,0,2,0,0,0,0,0,0,2
8728,TOTAL (UTs),2014,,SOCIETAL ISSUES,0,0,2,0,0,2,0,1,1,0,0,2,0,0,0,0,0,0,4
36,TRIPURA,2001,33,CAUSES NOT KNOWN,3,14,11,7,4,39,4,25,3,5,3,40,0,0,0,0,0,0,79
582,TRIPURA,2001,33,DEATH OF DEAR PERSON,0,3,4,5,0,12,0,3,0,2,0,5,0,0,0,0,0,0,17
1128,TRIPURA,2001,33,DOWRY DISPUTE,0,0,0,0,0,0,0,0,0,0,0,0,0,0,0,0,0,0,0
1674,TRIPURA,2001,33,DRUG ABUSE,0,0,0,0,0,0,0,0,0,0,0,0,0,0,0,0,0,0,0
2220,TRIPURA,2001,33,ECONOMIC ISSUES,0,1,5,2,2,10,1,1,0,3,1,6,0,0,0,0,0,0,16
2766,TRIPURA,2001,33,EXAM FAILURE,3,9,7,6,0,25,1,6,2,0,0,9,0,0,0,0,0,0,34
3312,TRIPURA,2001,33,FAMILY PROBLEMS,1,41,97,34,10,183,1,22,142,26,8,199,0,0,0,0,0,0,382
3858,TRIPURA,2001,33,HEALTH ISSUES,1,3,8,13,5,30,0,2,2,6,3,13,0,0,0,0,0,0,43
4404,TRIPURA,2001,33,HERO WORSHIP,0,0,0,0,0,0,0,0,0,0,0,0,0,0,0,0,0,0,0
4949,TRIPURA,2001,33,ILLEGITIMATE PREGNANCY,0,0,0,0,0,0,0,5,0,0,0,5,0,0,0,0,0,0,5
5494,TRIPURA,2001,33,LOVE AFFAIRS,4,26,14,0,0,44,2,7,12,3,0,24,0,0,0,0,0,0,68
6039,TRIPURA,2001,33,MARITAL ISSUES,0,11,12,0,0,23,0,6,1,0,0,7,0,0,0,0,0,0,30
6585,TRIPURA,2001,33,MENTAL HEALTH,0,4,6,6,0,16,0,2,6,4,0,12,0,0,0,0,0,0,28
7131,TRIPURA,2001,33,OTHERS,6,19,30,14,12,81,3,29,19,13,7,71,0,0,0,0,0,0,152
7716,TRIPURA,2001,33,"PHYSICAL ABUSE (RAPE,INCEST ETC.)",0,0,0,0,0,0,0,0,0,0,0,0,0,0,0,0,0,0,0
8222,TRIPURA,2001,33,SOCIETAL ISSUES,0,0,0,0,0,0,0,0,0,0,0,0,0,0,0,0,0,0,0
75,TRIPURA,2002,33,CAUSES NOT KNOWN,2,14,28,21,8,73,4,16,12,7,4,43,0,0,0,0,0,0,116
621,TRIPURA,2002,33,DEATH OF DEAR PERSON,0,3,1,0,0,4,0,1,0,0,0,1,0,0,0,0,0,0,5
1167,TRIPURA,2002,33,DOWRY DISPUTE,0,2,1,1,0,4,0,5,2,1,0,8,0,0,0,0,0,0,12
1713,TRIPURA,2002,33,DRUG ABUSE,0,0,0,0,0,0,0,0,0,0,0,0,0,0,0,0,0,0,0
2259,TRIPURA,2002,33,ECONOMIC ISSUES,0,3,4,5,0,12,0,3,2,0,1,6,0,0,0,0,0,0,18
2805,TRIPURA,2002,33,EXAM FAILURE,2,15,0,0,0,17,0,2,0,0,0,2,0,0,0,0,0,0,19
3351,TRIPURA,2002,33,FAMILY PROBLEMS,2,26,28,12,2,70,4,27,27,9,2,69,0,0,0,0,0,0,139
3897,TRIPURA,2002,33,HEALTH ISSUES,1,5,12,15,5,38,0,8,5,6,3,22,0,0,0,0,0,0,60
4443,TRIPURA,2002,33,HERO WORSHIP,0,0,0,0,0,0,0,1,0,0,0,1,0,0,0,0,0,0,1
4988,TRIPURA,2002,33,ILLEGITIMATE PREGNANCY,0,0,0,0,0,0,0,0,0,0,0,0,0,0,0,0,0,0,0
5533,TRIPURA,2002,33,LOVE AFFAIRS,1,27,16,0,0,44,0,22,13,0,0,35,0,0,0,0,0,0,79
6078,TRIPURA,2002,33,MARITAL ISSUES,0,25,28,17,1,71,0,15,7,3,0,25,0,0,0,0,0,0,96
6624,TRIPURA,2002,33,MENTAL HEALTH,0,7,11,6,3,27,0,3,5,3,2,13,0,0,0,0,0,0,40
7170,TRIPURA,2002,33,OTHERS,5,46,50,25,7,133,6,24,19,9,3,61,0,0,0,0,0,0,194
7755,TRIPURA,2002,33,"PHYSICAL ABUSE (RAPE,INCEST ETC.)",0,0,0,0,0,0,0,0,0,0,0,0,0,0,0,0,0,0,0
8261,TRIPURA,2002,33,SOCIETAL ISSUES,0,0,0,0,0,0,0,0,0,0,0,0,0,0,0,0,0,0,0
114,TRIPURA,2003,33,CAUSES NOT KNOWN,0,1,8,4,0,13,2,0,1,1,1,5,0,0,0,0,0,0,18
660,TRIPURA,2003,33,DEATH OF DEAR PERSON,0,0,4,0,0,4,0,0,0,0,0,0,0,0,0,0,0,0,4
1206,TRIPURA,2003,33,DOWRY DISPUTE,0,3,9,6,0,18,0,9,13,4,0,26,0,0,0,0,0,0,44
1752,TRIPURA,2003,33,DRUG ABUSE,0,0,2,1,0,3,0,0,0,0,0,0,0,0,0,0,0,0,3
2298,TRIPURA,2003,33,ECONOMIC ISSUES,0,16,24,19,0,59,1,40,32,15,3,91,0,0,0,0,0,0,150
2844,TRIPURA,2003,33,EXAM FAILURE,7,9,4,0,0,20,2,0,0,0,0,2,0,0,0,0,0,0,22
3390,TRIPURA,2003,33,FAMILY PROBLEMS,0,89,74,20,4,187,0,48,58,34,0,140,0,0,0,0,0,0,327
3936,TRIPURA,2003,33,HEALTH ISSUES,0,1,5,4,0,10,0,0,0,0,0,0,0,0,0,0,0,0,10
4482,TRIPURA,2003,33,HERO WORSHIP,0,0,0,0,0,0,0,0,0,0,0,0,0,0,0,0,0,0,0
5027,TRIPURA,2003,33,ILLEGITIMATE PREGNANCY,0,0,0,0,0,0,0,0,0,0,0,0,0,0,0,0,0,0,0
5572,TRIPURA,2003,33,LOVE AFFAIRS,0,56,41,8,0,105,2,41,37,5,0,85,0,0,0,0,0,0,190
6117,TRIPURA,2003,33,MARITAL ISSUES,0,13,7,21,0,41,0,0,0,0,0,0,0,0,0,0,0,0,41
6663,TRIPURA,2003,33,MENTAL HEALTH,0,3,0,0,0,3,0,0,0,0,0,0,0,0,0,0,0,0,3
7209,TRIPURA,2003,33,OTHERS,0,7,6,7,0,20,1,2,1,3,0,7,0,0,0,0,0,0,27
7794,TRIPURA,2003,33,"PHYSICAL ABUSE (RAPE,INCEST ETC.)",0,0,0,0,0,0,0,0,0,0,0,0,0,0,0,0,0,0,0
8300,TRIPURA,2003,33,SOCIETAL ISSUES,0,0,4,1,0,5,0,0,0,0,0,0,0,0,0,0,0,0,5
153,TRIPURA,2004,33,CAUSES NOT KNOWN,2,14,3,2,0,21,3,8,5,0,0,16,0,0,0,0,0,0,37
699,TRIPURA,2004,33,DEATH OF DEAR PERSON,0,1,3,1,1,6,0,2,1,0,0,3,0,0,0,0,0,0,9
1245,TRIPURA,2004,33,DOWRY DISPUTE,0,2,7,2,0,11,0,1,3,0,0,4,0,0,0,0,0,0,15
1791,TRIPURA,2004,33,DRUG ABUSE,0,4,1,3,0,8,0,1,1,0,0,2,0,0,0,0,0,0,10
2337,TRIPURA,2004,33,ECONOMIC ISSUES,0,27,11,9,0,47,1,28,13,4,0,46,0,0,0,0,0,0,93
2883,TRIPURA,2004,33,EXAM FAILURE,2,31,3,4,0,40,7,4,1,0,0,12,0,0,0,0,0,0,52
3429,TRIPURA,2004,33,FAMILY PROBLEMS,0,47,48,27,9,131,1,44,40,8,5,98,0,0,0,0,0,0,229
3975,TRIPURA,2004,33,HEALTH ISSUES,0,12,12,7,3,34,0,9,5,1,1,16,0,0,0,0,0,0,50
4521,TRIPURA,2004,33,HERO WORSHIP,0,2,3,2,0,7,0,2,1,0,0,3,0,0,0,0,0,0,10
5066,TRIPURA,2004,33,ILLEGITIMATE PREGNANCY,0,5,4,2,0,11,0,6,1,0,0,7,0,0,0,0,0,0,18
5611,TRIPURA,2004,33,LOVE AFFAIRS,0,24,12,4,0,40,4,47,9,1,0,61,0,0,0,0,0,0,101
6156,TRIPURA,2004,33,MARITAL ISSUES,0,16,13,6,0,35,2,14,12,1,0,29,0,0,0,0,0,0,64
6702,TRIPURA,2004,33,MENTAL HEALTH,1,0,3,2,0,6,0,0,3,2,1,6,0,0,0,0,0,0,12
7248,TRIPURA,2004,33,OTHERS,0,13,9,2,0,24,4,7,8,2,0,21,0,0,0,0,0,0,45
7833,TRIPURA,2004,33,"PHYSICAL ABUSE (RAPE,INCEST ETC.)",0,2,1,2,0,5,0,8,1,0,0,9,0,0,0,0,0,0,14
8339,TRIPURA,2004,33,SOCIETAL ISSUES,0,4,1,2,0,7,0,2,1,1,0,4,0,0,0,0,0,0,11
192,TRIPURA,2005,33,CAUSES NOT KNOWN,2,13,16,13,6,50,5,9,1,3,1,19,0,0,0,0,0,0,69
738,TRIPURA,2005,33,DEATH OF DEAR PERSON,0,0,0,0,0,0,0,0,0,0,0,0,0,0,0,0,0,0,0
1284,TRIPURA,2005,33,DOWRY DISPUTE,0,0,0,0,0,0,0,43,19,10,0,72,0,0,0,0,0,0,72
1830,TRIPURA,2005,33,DRUG ABUSE,0,0,2,2,1,5,0,0,0,0,0,0,0,0,0,0,0,0,5
2376,TRIPURA,2005,33,ECONOMIC ISSUES,0,19,16,12,3,50,0,16,7,2,1,26,0,0,0,0,0,0,76
2922,TRIPURA,2005,33,EXAM FAILURE,1,9,3,1,0,14,5,12,1,0,0,18,0,0,0,0,0,0,32
3468,TRIPURA,2005,33,FAMILY PROBLEMS,2,40,20,11,8,81,1,25,11,10,4,51,0,0,0,0,0,0,132
4014,TRIPURA,2005,33,HEALTH ISSUES,0,9,10,12,0,31,0,5,5,3,0,13,0,0,0,0,0,0,44
4560,TRIPURA,2005,33,HERO WORSHIP,0,0,2,2,0,4,0,9,2,4,0,15,0,0,0,0,0,0,19
5105,TRIPURA,2005,33,ILLEGITIMATE PREGNANCY,0,0,0,0,0,0,0,8,2,0,0,10,0,0,0,0,0,0,10
5650,TRIPURA,2005,33,LOVE AFFAIRS,1,12,8,0,0,21,1,12,4,0,0,17,0,0,0,0,0,0,38
6195,TRIPURA,2005,33,MARITAL ISSUES,0,16,15,8,5,44,0,14,13,1,1,29,0,0,0,0,0,0,73
6741,TRIPURA,2005,33,MENTAL HEALTH,0,8,8,4,1,21,0,10,7,4,0,21,0,0,0,0,0,0,42
7287,TRIPURA,2005,33,OTHERS,4,21,24,16,8,73,4,6,3,1,1,15,0,0,0,0,0,0,88
7872,TRIPURA,2005,33,"PHYSICAL ABUSE (RAPE,INCEST ETC.)",0,0,0,0,0,0,0,0,0,0,0,0,0,0,0,0,0,0,0
8378,TRIPURA,2005,33,SOCIETAL ISSUES,0,2,3,2,0,7,0,5,3,0,0,8,0,0,0,0,0,0,15
231,TRIPURA,2006,33,CAUSES NOT KNOWN,0,69,87,22,12,190,0,60,43,5,0,108,0,0,0,0,0,0,298
777,TRIPURA,2006,33,DEATH OF DEAR PERSON,0,0,0,0,0,0,0,0,3,1,2,6,0,0,0,0,0,0,6
1323,TRIPURA,2006,33,DOWRY DISPUTE,0,0,0,0,0,0,0,31,26,3,0,60,0,0,0,0,0,0,60
1869,TRIPURA,2006,33,DRUG ABUSE,0,0,0,0,0,0,0,1,1,0,0,2,0,0,0,0,0,0,2
2415,TRIPURA,2006,33,ECONOMIC ISSUES,0,6,6,4,0,16,0,1,1,2,0,4,0,0,0,0,0,0,20
2961,TRIPURA,2006,33,EXAM FAILURE,5,6,0,0,0,11,4,7,1,0,0,12,0,0,0,0,0,0,23
3507,TRIPURA,2006,33,FAMILY PROBLEMS,4,16,27,22,8,77,5,20,11,4,0,40,0,0,0,0,0,0,117
4053,TRIPURA,2006,33,HEALTH ISSUES,0,5,6,4,0,15,0,0,3,4,2,9,0,0,0,0,0,0,24
4598,TRIPURA,2006,33,HERO WORSHIP,0,0,0,0,0,0,0,0,0,0,0,0,0,0,0,0,0,0,0
5143,TRIPURA,2006,33,ILLEGITIMATE PREGNANCY,0,0,0,0,0,0,0,4,1,0,0,5,0,0,0,0,0,0,5
5688,TRIPURA,2006,33,LOVE AFFAIRS,0,6,2,0,0,8,1,14,10,0,0,25,0,0,0,0,0,0,33
6234,TRIPURA,2006,33,MARITAL ISSUES,0,1,2,4,0,7,0,4,1,0,0,5,0,0,0,0,0,0,12
6780,TRIPURA,2006,33,MENTAL HEALTH,0,3,5,4,2,14,0,0,0,0,0,0,0,0,0,0,0,0,14
7326,TRIPURA,2006,33,OTHERS,2,33,32,18,5,90,1,26,17,15,2,61,0,0,0,0,0,0,151
7910,TRIPURA,2006,33,"PHYSICAL ABUSE (RAPE,INCEST ETC.)",0,0,0,0,0,0,0,0,0,0,0,0,0,0,0,0,0,0,0
8417,TRIPURA,2006,33,SOCIETAL ISSUES,0,0,0,0,0,0,0,0,0,0,0,0,0,0,0,0,0,0,0
270,TRIPURA,2007,33,CAUSES NOT KNOWN,18,60,72,58,3,211,6,30,34,20,3,93,0,0,0,0,0,0,304
816,TRIPURA,2007,33,DEATH OF DEAR PERSON,0,0,0,0,0,0,0,5,11,0,0,16,0,0,0,0,0,0,16
1362,TRIPURA,2007,33,DOWRY DISPUTE,0,0,0,0,0,0,0,31,23,2,0,56,0,0,0,0,0,0,56
1908,TRIPURA,2007,33,DRUG ABUSE,0,0,0,0,0,0,0,0,0,0,0,0,0,0,0,0,0,0,0
2454,TRIPURA,2007,33,ECONOMIC ISSUES,0,6,5,5,0,16,0,1,1,0,0,2,0,0,0,0,0,0,18
3000,TRIPURA,2007,33,EXAM FAILURE,4,13,0,0,0,17,8,8,0,0,0,16,0,0,0,0,0,0,33
3546,TRIPURA,2007,33,FAMILY PROBLEMS,4,47,40,23,3,117,3,20,25,12,3,63,0,0,0,0,0,0,180
4092,TRIPURA,2007,33,HEALTH ISSUES,0,5,14,7,4,30,0,0,1,7,0,8,0,0,0,0,0,0,38
4637,TRIPURA,2007,33,HERO WORSHIP,0,0,0,0,0,0,0,0,0,0,0,0,0,0,0,0,0,0,0
5182,TRIPURA,2007,33,ILLEGITIMATE PREGNANCY,0,0,0,0,0,0,0,0,0,0,0,0,0,0,0,0,0,0,0
5727,TRIPURA,2007,33,LOVE AFFAIRS,0,14,5,0,0,19,5,12,3,0,0,20,0,0,0,0,0,0,39
6273,TRIPURA,2007,33,MARITAL ISSUES,0,3,3,0,0,6,0,8,2,0,0,10,0,0,0,0,0,0,16
6819,TRIPURA,2007,33,MENTAL HEALTH,0,0,2,1,0,3,0,1,0,0,1,2,0,0,0,0,0,0,5
7365,TRIPURA,2007,33,OTHERS,0,0,0,0,0,0,0,0,0,0,0,0,0,0,0,0,0,0,0
7949,TRIPURA,2007,33,"PHYSICAL ABUSE (RAPE,INCEST ETC.)",0,0,0,0,0,0,0,0,0,0,0,0,0,0,0,0,0,0,0
8456,TRIPURA,2007,33,SOCIETAL ISSUES,0,0,0,0,0,0,0,0,0,0,0,0,0,0,0,0,0,0,0
309,TRIPURA,2008,33,CAUSES NOT KNOWN,4,8,7,6,6,31,5,11,14,3,1,34,0,0,0,0,0,0,65
855,TRIPURA,2008,33,DEATH OF DEAR PERSON,0,0,0,0,0,0,0,0,0,0,0,0,0,0,0,0,0,0,0
1401,TRIPURA,2008,33,DOWRY DISPUTE,0,0,0,0,0,0,0,6,3,0,0,9,0,0,0,0,0,0,9
1947,TRIPURA,2008,33,DRUG ABUSE,0,0,0,0,0,0,0,0,0,0,0,0,0,0,0,0,0,0,0
2493,TRIPURA,2008,33,ECONOMIC ISSUES,0,0,2,0,0,2,0,0,0,0,0,0,0,0,0,0,0,0,2
3039,TRIPURA,2008,33,EXAM FAILURE,2,9,0,0,0,11,2,2,0,0,0,4,0,0,0,0,0,0,15
3585,TRIPURA,2008,33,FAMILY PROBLEMS,0,57,101,50,12,220,0,56,33,24,4,117,0,0,0,0,0,0,337
4131,TRIPURA,2008,33,HEALTH ISSUES,0,3,10,3,2,18,0,0,0,3,1,4,0,0,0,0,0,0,22
4676,TRIPURA,2008,33,HERO WORSHIP,0,0,0,0,0,0,0,0,0,0,0,0,0,0,0,0,0,0,0
5221,TRIPURA,2008,33,ILLEGITIMATE PREGNANCY,0,0,0,0,0,0,0,0,0,0,0,0,0,0,0,0,0,0,0
5766,TRIPURA,2008,33,LOVE AFFAIRS,0,24,13,0,0,37,3,32,12,0,0,47,0,0,0,0,0,0,84
6312,TRIPURA,2008,33,MARITAL ISSUES,0,15,5,0,0,20,0,10,8,0,0,18,0,0,0,0,0,0,38
6858,TRIPURA,2008,33,MENTAL HEALTH,0,1,4,1,0,6,0,0,0,2,0,2,0,0,0,0,0,0,8
7404,TRIPURA,2008,33,OTHERS,3,35,25,29,5,97,4,26,26,19,0,75,0,0,0,0,0,0,172
7988,TRIPURA,2008,33,"PHYSICAL ABUSE (RAPE,INCEST ETC.)",0,0,0,0,0,0,0,0,0,0,0,0,0,0,0,0,0,0,0
8495,TRIPURA,2008,33,SOCIETAL ISSUES,0,0,0,0,0,0,0,0,0,0,0,0,0,0,0,0,0,0,0
348,TRIPURA,2009,33,CAUSES NOT KNOWN,4,46,50,21,0,121,6,29,11,7,0,53,0,0,0,0,0,0,174
894,TRIPURA,2009,33,DEATH OF DEAR PERSON,0,0,0,0,0,0,0,0,0,0,0,0,0,0,0,0,0,0,0
1440,TRIPURA,2009,33,DOWRY DISPUTE,0,0,0,0,0,0,0,16,6,1,0,23,0,0,0,0,0,0,23
1986,TRIPURA,2009,33,DRUG ABUSE,0,0,5,2,1,8,0,0,0,0,0,0,0,0,0,0,0,0,8
2532,TRIPURA,2009,33,ECONOMIC ISSUES,0,19,8,6,1,34,0,4,3,0,0,7,0,0,0,0,0,0,41
3078,TRIPURA,2009,33,EXAM FAILURE,3,4,0,0,0,7,1,5,0,0,0,6,0,0,0,0,0,0,13
3624,TRIPURA,2009,33,FAMILY PROBLEMS,2,56,40,43,4,145,1,43,29,16,2,91,0,0,0,0,0,0,236
4170,TRIPURA,2009,33,HEALTH ISSUES,0,9,10,6,10,35,0,3,2,4,3,12,0,0,0,0,0,0,47
4715,TRIPURA,2009,33,HERO WORSHIP,0,0,0,0,0,0,0,0,0,0,0,0,0,0,0,0,0,0,0
5260,TRIPURA,2009,33,ILLEGITIMATE PREGNANCY,0,0,0,0,0,0,0,1,0,0,0,1,0,0,0,0,0,0,1
5805,TRIPURA,2009,33,LOVE AFFAIRS,0,21,12,0,0,33,0,29,4,0,0,33,0,0,0,0,0,0,66
6351,TRIPURA,2009,33,MARITAL ISSUES,0,5,5,0,0,10,0,5,3,0,0,8,0,0,0,0,0,0,18
6897,TRIPURA,2009,33,MENTAL HEALTH,0,10,4,13,5,32,0,3,0,2,4,9,0,0,0,0,0,0,41
7443,TRIPURA,2009,33,OTHERS,0,17,20,4,1,42,2,20,4,1,1,28,0,0,0,0,0,0,70
8027,TRIPURA,2009,33,"PHYSICAL ABUSE (RAPE,INCEST ETC.)",0,0,0,0,0,0,0,0,0,0,0,0,0,0,0,0,0,0,0
8534,TRIPURA,2009,33,SOCIETAL ISSUES,0,0,0,0,0,0,0,0,0,0,0,0,0,0,0,0,0,0,0
387,TRIPURA,2010,33,CAUSES NOT KNOWN,8,41,35,26,10,120,8,22,11,10,6,57,0,0,0,0,0,0,177
933,TRIPURA,2010,33,DEATH OF DEAR PERSON,0,0,0,0,0,0,0,0,0,0,0,0,0,0,0,0,0,0,0
1479,TRIPURA,2010,33,DOWRY DISPUTE,0,0,0,0,0,0,0,22,14,0,0,36,0,0,0,0,0,0,36
2025,TRIPURA,2010,33,DRUG ABUSE,0,0,3,2,0,5,0,0,0,0,0,0,0,0,0,0,0,0,5
2571,TRIPURA,2010,33,ECONOMIC ISSUES,0,8,18,16,0,42,0,3,6,0,0,9,0,0,0,0,0,0,51
3117,TRIPURA,2010,33,EXAM FAILURE,3,4,0,0,0,7,2,1,0,0,0,3,0,0,0,0,0,0,10
3663,TRIPURA,2010,33,FAMILY PROBLEMS,3,39,38,29,36,145,3,21,36,26,15,101,0,0,0,0,0,0,246
4209,TRIPURA,2010,33,HEALTH ISSUES,0,5,8,7,12,32,0,3,2,4,5,14,0,0,0,0,0,0,46
4754,TRIPURA,2010,33,HERO WORSHIP,0,0,0,0,0,0,0,0,0,0,0,0,0,0,0,0,0,0,0
5299,TRIPURA,2010,33,ILLEGITIMATE PREGNANCY,0,0,0,0,0,0,0,1,1,0,0,2,0,0,0,0,0,0,2
5844,TRIPURA,2010,33,LOVE AFFAIRS,1,19,9,0,0,29,4,19,3,0,0,26,0,0,0,0,0,0,55
6390,TRIPURA,2010,33,MARITAL ISSUES,0,5,7,1,0,13,0,3,5,2,0,10,0,0,0,0,0,0,23
6936,TRIPURA,2010,33,MENTAL HEALTH,0,3,12,8,7,30,0,3,2,3,3,11,0,0,0,0,0,0,41
7482,TRIPURA,2010,33,OTHERS,1,3,12,2,0,18,1,10,0,4,0,15,0,0,0,0,0,0,33
8066,TRIPURA,2010,33,"PHYSICAL ABUSE (RAPE,INCEST ETC.)",0,0,0,0,0,0,0,0,0,0,0,0,0,0,0,0,0,0,0
8573,TRIPURA,2010,33,SOCIETAL ISSUES,0,0,0,0,0,0,0,0,0,0,0,0,0,0,0,0,0,0,0
426,TRIPURA,2011,33,CAUSES NOT KNOWN,2,58,23,19,19,121,1,19,13,14,11,58,0,0,0,0,0,0,179
972,TRIPURA,2011,33,DEATH OF DEAR PERSON,0,0,0,0,0,0,0,0,0,0,0,0,0,0,0,0,0,0,0
1518,TRIPURA,2011,33,DOWRY DISPUTE,0,0,0,0,0,0,0,1,4,0,0,5,0,0,0,0,0,0,5
2064,TRIPURA,2011,33,DRUG ABUSE,0,2,0,0,0,2,0,0,0,0,0,0,0,0,0,0,0,0,2
2610,TRIPURA,2011,33,ECONOMIC ISSUES,0,0,3,0,0,3,0,0,0,0,0,0,0,0,0,0,0,0,3
3156,TRIPURA,2011,33,EXAM FAILURE,1,14,0,0,0,15,2,19,0,0,0,21,0,0,0,0,0,0,36
3702,TRIPURA,2011,33,FAMILY PROBLEMS,2,47,56,33,9,147,2,54,29,17,8,110,0,0,0,0,0,0,257
4248,TRIPURA,2011,33,HEALTH ISSUES,0,7,10,10,9,36,0,11,0,2,3,16,0,0,0,0,0,0,52
4793,TRIPURA,2011,33,HERO WORSHIP,0,0,0,0,0,0,0,0,0,0,0,0,0,0,0,0,0,0,0
5338,TRIPURA,2011,33,ILLEGITIMATE PREGNANCY,0,0,0,0,0,0,0,0,1,0,0,1,0,0,0,0,0,0,1
5883,TRIPURA,2011,33,LOVE AFFAIRS,0,17,7,0,0,24,0,21,2,0,0,23,0,0,0,0,0,0,47
6429,TRIPURA,2011,33,MARITAL ISSUES,0,13,5,0,0,18,0,0,0,0,0,0,0,0,0,0,0,0,18
6975,TRIPURA,2011,33,MENTAL HEALTH,0,0,0,3,1,4,0,6,1,0,3,10,0,0,0,0,0,0,14
7521,TRIPURA,2011,33,OTHERS,0,44,29,3,1,77,0,2,3,5,2,12,0,0,0,0,0,0,89
8105,TRIPURA,2011,33,"PHYSICAL ABUSE (RAPE,INCEST ETC.)",0,0,0,0,0,0,0,0,0,0,0,0,0,0,0,0,0,0,0
8612,TRIPURA,2011,33,SOCIETAL ISSUES,0,0,0,0,0,0,0,0,0,0,0,0,0,0,0,0,0,0,0
465,TRIPURA,2012,33,CAUSES NOT KNOWN,5,37,39,43,17,141,7,30,21,8,8,74,0,0,0,0,0,0,215
1011,TRIPURA,2012,33,DEATH OF DEAR PERSON,0,0,0,0,0,0,0,0,0,0,0,0,0,0,0,0,0,0,0
1557,TRIPURA,2012,33,DOWRY DISPUTE,0,0,0,0,0,0,0,0,0,0,0,0,0,0,0,0,0,0,0
2103,TRIPURA,2012,33,DRUG ABUSE,0,0,0,0,0,0,0,0,0,0,0,0,0,0,0,0,0,0,0
2649,TRIPURA,2012,33,ECONOMIC ISSUES,0,4,2,3,0,9,0,0,0,0,0,0,0,0,0,0,0,0,9
3195,TRIPURA,2012,33,EXAM FAILURE,4,3,0,0,0,7,0,6,0,0,0,6,0,0,0,0,0,0,13
3741,TRIPURA,2012,33,FAMILY PROBLEMS,2,23,25,27,6,83,0,38,20,9,11,78,0,0,0,0,0,0,161
4287,TRIPURA,2012,33,HEALTH ISSUES,0,6,4,13,12,35,0,4,1,4,2,11,0,0,0,0,0,0,46
4832,TRIPURA,2012,33,HERO WORSHIP,0,0,0,0,0,0,0,0,0,0,0,0,0,0,0,0,0,0,0
5377,TRIPURA,2012,33,ILLEGITIMATE PREGNANCY,0,0,0,0,0,0,0,0,0,0,0,0,0,0,0,0,0,0,0
5922,TRIPURA,2012,33,LOVE AFFAIRS,1,6,0,0,0,7,0,5,0,0,0,5,0,0,0,0,0,0,12
6468,TRIPURA,2012,33,MARITAL ISSUES,0,2,1,1,0,4,0,1,0,1,0,2,0,0,0,0,0,0,6
7014,TRIPURA,2012,33,MENTAL HEALTH,0,2,4,2,0,8,0,1,1,1,1,4,0,0,0,0,0,0,12
7560,TRIPURA,2012,33,OTHERS,4,87,136,23,16,266,8,31,42,14,9,104,0,0,0,0,0,0,370
8144,TRIPURA,2012,33,"PHYSICAL ABUSE (RAPE,INCEST ETC.)",0,0,0,0,0,0,0,0,0,0,0,0,0,0,0,0,0,0,0
8651,TRIPURA,2012,33,SOCIETAL ISSUES,0,0,0,0,0,0,0,0,0,0,0,0,0,0,0,0,0,0,0
504,TRIPURA,2013,33,CAUSES NOT KNOWN,4,34,37,34,11,120,6,18,13,3,3,43,0,0,0,0,0,0,163
1050,TRIPURA,2013,33,DEATH OF DEAR PERSON,0,0,0,0,0,0,0,0,0,0,0,0,0,0,0,0,0,0,0
1596,TRIPURA,2013,33,DOWRY DISPUTE,0,0,0,0,0,0,0,5,4,2,0,11,0,0,0,0,0,0,11
2142,TRIPURA,2013,33,DRUG ABUSE,0,0,0,0,0,0,0,0,0,0,0,0,0,0,0,0,0,0,0
2688,TRIPURA,2013,33,ECONOMIC ISSUES,0,0,4,4,0,8,0,0,2,0,0,2,0,0,0,0,0,0,10
3234,TRIPURA,2013,33,EXAM FAILURE,3,1,0,0,0,4,2,4,0,0,0,6,0,0,0,0,0,0,10
3780,TRIPURA,2013,33,FAMILY PROBLEMS,1,49,31,25,2,108,1,41,16,14,9,81,0,0,0,0,0,0,189
4326,TRIPURA,2013,33,HEALTH ISSUES,0,4,1,5,8,18,0,1,1,1,3,6,0,0,0,0,0,0,24
4871,TRIPURA,2013,33,HERO WORSHIP,0,0,0,0,0,0,0,0,0,0,0,0,0,0,0,0,0,0,0
5416,TRIPURA,2013,33,ILLEGITIMATE PREGNANCY,0,0,0,0,0,0,0,0,0,0,0,0,0,0,0,0,0,0,0
5961,TRIPURA,2013,33,LOVE AFFAIRS,1,12,7,0,0,20,0,15,5,0,0,20,0,0,0,0,0,0,40
6507,TRIPURA,2013,33,MARITAL ISSUES,0,0,0,0,0,0,0,0,0,0,0,0,0,0,0,0,0,0,0
7053,TRIPURA,2013,33,MENTAL HEALTH,0,4,4,3,0,11,0,4,0,4,1,9,0,0,0,0,0,0,20
7599,TRIPURA,2013,33,OTHERS,15,109,133,64,25,346,14,59,28,28,17,146,0,0,0,0,0,0,492
8183,TRIPURA,2013,33,"PHYSICAL ABUSE (RAPE,INCEST ETC.)",0,0,0,0,0,0,0,0,0,0,0,0,0,0,0,0,0,0,0
8690,TRIPURA,2013,33,SOCIETAL ISSUES,0,1,0,0,0,1,0,1,0,0,0,1,0,0,0,0,0,0,2
543,TRIPURA,2014,33,CAUSES NOT KNOWN,6,34,10,7,2,59,3,13,5,4,1,26,0,0,0,0,0,0,85
1089,TRIPURA,2014,33,DEATH OF DEAR PERSON,0,0,0,0,0,0,0,0,0,0,0,0,0,0,0,0,0,0,0
1635,TRIPURA,2014,33,DOWRY DISPUTE,0,0,1,0,0,1,0,12,7,3,0,22,0,0,0,0,0,0,23
2181,TRIPURA,2014,33,DRUG ABUSE,0,8,6,3,0,17,0,0,2,0,0,2,0,0,0,0,0,0,19
2727,TRIPURA,2014,33,ECONOMIC ISSUES,0,28,21,15,5,69,0,4,4,2,0,10,0,0,0,0,0,0,79
3273,TRIPURA,2014,33,EXAM FAILURE,2,14,0,0,0,16,1,18,3,1,0,23,0,0,0,0,0,0,39
3819,TRIPURA,2014,33,FAMILY PROBLEMS,0,25,25,11,5,66,0,30,13,7,1,51,0,0,0,0,0,0,117
4365,TRIPURA,2014,33,HEALTH ISSUES,0,22,24,34,25,105,0,15,12,16,19,62,0,0,0,0,0,0,167
4910,TRIPURA,2014,33,HERO WORSHIP,0,0,0,0,0,0,0,0,0,0,0,0,0,0,0,0,0,0,0
5455,TRIPURA,2014,33,ILLEGITIMATE PREGNANCY,0,0,0,0,0,0,0,6,1,0,0,7,0,0,0,0,0,0,7
6000,TRIPURA,2014,33,LOVE AFFAIRS,0,13,1,0,0,14,0,17,2,0,0,19,0,0,0,0,0,0,33
6546,TRIPURA,2014,33,MARITAL ISSUES,0,10,8,8,0,26,0,17,12,5,0,34,0,0,0,0,0,0,60
7092,TRIPURA,2014,33,MENTAL HEALTH,0,4,10,8,5,27,0,5,6,4,3,18,0,0,0,0,0,0,45
7638,TRIPURA,2014,33,OTHERS,6,50,53,41,17,167,3,32,17,4,5,61,0,0,0,0,0,0,228
7677,TRIPURA,2014,33,PHYSICAL ABUSE,0,0,0,0,0,0,0,2,0,0,0,2,0,0,0,0,0,0,2
8729,TRIPURA,2014,33,SOCIETAL ISSUES,0,0,0,0,0,0,0,1,0,0,0,1,0,0,0,0,0,0,1
37,UTTAR PRADESH,2001,34,CAUSES NOT KNOWN,20,89,101,84,54,348,20,113,91,35,12,271,0,0,0,0,0,0,619
583,UTTAR PRADESH,2001,34,DEATH OF DEAR PERSON,0,2,4,0,0,6,0,7,6,3,2,18,0,0,0,0,0,0,24
1129,UTTAR PRADESH,2001,34,DOWRY DISPUTE,0,7,0,1,0,8,1,308,68,3,0,380,0,0,0,0,0,0,388
1675,UTTAR PRADESH,2001,34,DRUG ABUSE,0,26,27,17,3,73,0,2,1,0,0,3,0,0,0,0,0,0,76
2221,UTTAR PRADESH,2001,34,ECONOMIC ISSUES,1,94,82,33,9,219,0,25,27,15,12,79,0,0,0,0,0,0,298
2767,UTTAR PRADESH,2001,34,EXAM FAILURE,16,31,1,0,0,48,10,23,0,0,0,33,0,0,0,0,0,0,81
3313,UTTAR PRADESH,2001,34,FAMILY PROBLEMS,15,203,181,93,35,527,7,118,185,55,11,376,0,0,0,0,0,0,903
3859,UTTAR PRADESH,2001,34,HEALTH ISSUES,2,30,47,57,27,163,1,23,37,27,20,108,0,0,0,0,0,0,271
4405,UTTAR PRADESH,2001,34,HERO WORSHIP,0,1,0,4,0,5,0,1,0,0,0,1,0,0,0,0,0,0,6
4950,UTTAR PRADESH,2001,34,ILLEGITIMATE PREGNANCY,0,7,5,0,0,12,1,28,0,0,0,29,0,0,0,0,0,0,41
5495,UTTAR PRADESH,2001,34,LOVE AFFAIRS,1,54,10,0,0,65,4,67,7,0,0,78,0,0,0,0,0,0,143
6040,UTTAR PRADESH,2001,34,MARITAL ISSUES,1,55,15,3,2,76,2,92,53,8,0,155,0,0,0,0,0,0,231
6586,UTTAR PRADESH,2001,34,MENTAL HEALTH,6,27,27,19,2,81,2,21,20,12,7,62,0,0,0,0,0,0,143
7132,UTTAR PRADESH,2001,34,OTHERS,11,73,35,19,3,141,13,30,30,13,3,89,0,0,0,0,0,0,230
7717,UTTAR PRADESH,2001,34,"PHYSICAL ABUSE (RAPE,INCEST ETC.)",0,6,3,0,0,9,1,9,5,2,0,17,0,0,0,0,0,0,26
8223,UTTAR PRADESH,2001,34,SOCIETAL ISSUES,0,11,7,0,2,20,1,3,7,2,3,16,0,0,0,0,0,0,36
76,UTTAR PRADESH,2002,34,CAUSES NOT KNOWN,20,231,213,123,52,639,32,103,140,96,46,417,0,0,0,0,0,0,1056
622,UTTAR PRADESH,2002,34,DEATH OF DEAR PERSON,0,0,1,2,0,3,0,5,1,2,0,8,0,0,0,0,0,0,11
1168,UTTAR PRADESH,2002,34,DOWRY DISPUTE,0,1,5,1,0,7,112,211,38,0,0,361,0,0,0,0,0,0,368
1714,UTTAR PRADESH,2002,34,DRUG ABUSE,0,14,34,29,5,82,1,2,2,1,0,6,0,0,0,0,0,0,88
2260,UTTAR PRADESH,2002,34,ECONOMIC ISSUES,4,97,90,46,20,257,1,31,25,7,3,67,0,0,0,0,0,0,324
2806,UTTAR PRADESH,2002,34,EXAM FAILURE,10,45,4,1,0,60,4,23,3,1,0,31,0,0,0,0,0,0,91
3352,UTTAR PRADESH,2002,34,FAMILY PROBLEMS,10,218,211,108,46,593,13,238,162,49,20,482,0,0,0,0,0,0,1075
3898,UTTAR PRADESH,2002,34,HEALTH ISSUES,6,31,64,84,33,218,11,28,37,32,15,123,0,0,0,0,0,0,341
4444,UTTAR PRADESH,2002,34,HERO WORSHIP,0,2,0,0,0,2,0,0,2,0,0,2,0,0,0,0,0,0,4
4989,UTTAR PRADESH,2002,34,ILLEGITIMATE PREGNANCY,0,0,0,0,0,0,5,9,0,0,0,14,0,0,0,0,0,0,14
5534,UTTAR PRADESH,2002,34,LOVE AFFAIRS,1,56,14,4,0,75,3,57,13,0,0,73,0,0,0,0,0,0,148
6079,UTTAR PRADESH,2002,34,MARITAL ISSUES,0,48,24,4,0,76,1,79,47,9,0,136,0,0,0,0,0,0,212
6625,UTTAR PRADESH,2002,34,MENTAL HEALTH,1,24,47,35,9,116,4,18,17,20,5,64,0,0,0,0,0,0,180
7171,UTTAR PRADESH,2002,34,OTHERS,3,56,35,17,18,129,18,39,21,18,3,99,0,0,0,0,0,0,228
7756,UTTAR PRADESH,2002,34,"PHYSICAL ABUSE (RAPE,INCEST ETC.)",0,5,4,0,0,9,2,8,5,2,0,17,0,0,0,0,0,0,26
8262,UTTAR PRADESH,2002,34,SOCIETAL ISSUES,0,25,20,8,7,60,1,8,8,3,4,24,0,0,0,0,0,0,84
115,UTTAR PRADESH,2003,34,CAUSES NOT KNOWN,32,177,157,91,54,511,27,124,106,85,41,383,0,0,0,0,0,0,894
661,UTTAR PRADESH,2003,34,DEATH OF DEAR PERSON,0,1,0,1,0,2,0,5,0,0,1,6,0,0,0,0,0,0,8
1207,UTTAR PRADESH,2003,34,DOWRY DISPUTE,1,0,5,0,0,6,4,238,43,0,0,285,0,0,0,0,0,0,291
1753,UTTAR PRADESH,2003,34,DRUG ABUSE,0,17,30,18,5,70,1,5,2,2,5,15,0,0,0,0,0,0,85
2299,UTTAR PRADESH,2003,34,ECONOMIC ISSUES,3,118,103,59,13,296,3,14,14,27,4,62,0,0,0,0,0,0,358
2845,UTTAR PRADESH,2003,34,EXAM FAILURE,10,47,3,0,0,60,14,30,1,0,0,45,0,0,0,0,0,0,105
3391,UTTAR PRADESH,2003,34,FAMILY PROBLEMS,13,195,144,58,25,435,8,201,138,38,8,393,0,0,0,0,0,0,828
3937,UTTAR PRADESH,2003,34,HEALTH ISSUES,5,28,58,67,44,202,1,21,22,29,24,97,0,0,0,0,0,0,299
4483,UTTAR PRADESH,2003,34,HERO WORSHIP,0,1,3,0,0,4,0,1,0,0,0,1,0,0,0,0,0,0,5
5028,UTTAR PRADESH,2003,34,ILLEGITIMATE PREGNANCY,0,0,0,0,0,0,0,9,13,2,0,24,0,0,0,0,0,0,24
5573,UTTAR PRADESH,2003,34,LOVE AFFAIRS,4,73,19,3,1,100,4,47,14,0,0,65,0,0,0,0,0,0,165
6118,UTTAR PRADESH,2003,34,MARITAL ISSUES,3,41,18,7,0,69,2,59,35,8,0,104,0,0,0,0,0,0,173
6664,UTTAR PRADESH,2003,34,MENTAL HEALTH,2,24,27,29,7,89,4,14,13,8,5,44,0,0,0,0,0,0,133
7210,UTTAR PRADESH,2003,34,OTHERS,9,27,49,23,7,115,5,63,24,17,6,115,0,0,0,0,0,0,230
7795,UTTAR PRADESH,2003,34,"PHYSICAL ABUSE (RAPE,INCEST ETC.)",0,7,1,0,0,8,1,4,0,0,1,6,0,0,0,0,0,0,14
8301,UTTAR PRADESH,2003,34,SOCIETAL ISSUES,0,7,5,7,1,20,0,17,5,7,2,31,0,0,0,0,0,0,51
154,UTTAR PRADESH,2004,34,CAUSES NOT KNOWN,39,207,204,101,45,596,34,154,120,45,25,378,0,0,0,0,0,0,974
700,UTTAR PRADESH,2004,34,DEATH OF DEAR PERSON,0,1,0,1,2,4,1,3,1,0,0,5,0,0,0,0,0,0,9
1246,UTTAR PRADESH,2004,34,DOWRY DISPUTE,0,7,0,2,0,9,0,278,46,5,0,329,0,0,0,0,0,0,338
1792,UTTAR PRADESH,2004,34,DRUG ABUSE,2,23,40,26,3,94,0,0,0,0,0,0,0,0,0,0,0,0,94
2338,UTTAR PRADESH,2004,34,ECONOMIC ISSUES,1,67,95,39,8,210,2,14,31,25,1,73,0,0,0,0,0,0,283
2884,UTTAR PRADESH,2004,34,EXAM FAILURE,0,80,19,7,2,108,3,31,1,0,0,35,0,0,0,0,0,0,143
3430,UTTAR PRADESH,2004,34,FAMILY PROBLEMS,26,115,108,46,12,307,9,160,100,46,8,323,0,0,0,0,0,0,630
3976,UTTAR PRADESH,2004,34,HEALTH ISSUES,8,31,76,74,30,219,1,22,23,25,14,85,0,0,0,0,0,0,304
4522,UTTAR PRADESH,2004,34,HERO WORSHIP,0,0,1,0,0,1,0,6,2,0,0,8,0,0,0,0,0,0,9
5067,UTTAR PRADESH,2004,34,ILLEGITIMATE PREGNANCY,0,0,0,0,0,0,0,8,2,1,0,11,0,0,0,0,0,0,11
5612,UTTAR PRADESH,2004,34,LOVE AFFAIRS,0,46,25,4,0,75,0,50,21,4,0,75,0,0,0,0,0,0,150
6157,UTTAR PRADESH,2004,34,MARITAL ISSUES,1,33,11,3,2,50,0,63,41,8,0,112,0,0,0,0,0,0,162
6703,UTTAR PRADESH,2004,34,MENTAL HEALTH,2,20,16,8,9,55,3,20,6,5,1,35,0,0,0,0,0,0,90
7249,UTTAR PRADESH,2004,34,OTHERS,6,95,49,39,14,203,12,100,38,17,14,181,0,0,0,0,0,0,384
7834,UTTAR PRADESH,2004,34,"PHYSICAL ABUSE (RAPE,INCEST ETC.)",0,2,2,2,0,6,0,5,4,1,0,10,0,0,0,0,0,0,16
8340,UTTAR PRADESH,2004,34,SOCIETAL ISSUES,0,10,1,3,3,17,2,8,10,2,1,23,0,0,0,0,0,0,40
193,UTTAR PRADESH,2005,34,CAUSES NOT KNOWN,27,166,189,118,61,561,19,261,116,53,10,459,0,0,0,0,0,0,1020
739,UTTAR PRADESH,2005,34,DEATH OF DEAR PERSON,1,2,4,0,1,8,0,1,2,0,0,3,0,0,0,0,0,0,11
1285,UTTAR PRADESH,2005,34,DOWRY DISPUTE,2,4,5,0,0,11,0,208,58,7,0,273,0,0,0,0,0,0,284
1831,UTTAR PRADESH,2005,34,DRUG ABUSE,0,19,31,31,10,91,0,0,0,0,0,0,0,0,0,0,0,0,91
2377,UTTAR PRADESH,2005,34,ECONOMIC ISSUES,0,43,89,49,18,199,0,24,33,16,1,74,0,0,0,0,0,0,273
2923,UTTAR PRADESH,2005,34,EXAM FAILURE,3,51,9,0,0,63,5,20,5,0,0,30,0,0,0,0,0,0,93
3469,UTTAR PRADESH,2005,34,FAMILY PROBLEMS,10,97,91,33,12,243,13,118,91,48,10,280,0,0,0,0,0,0,523
4015,UTTAR PRADESH,2005,34,HEALTH ISSUES,1,23,44,71,47,186,4,26,49,42,32,153,0,0,0,0,0,0,339
4561,UTTAR PRADESH,2005,34,HERO WORSHIP,2,0,0,0,0,2,0,0,0,0,0,0,0,0,0,0,0,0,2
5106,UTTAR PRADESH,2005,34,ILLEGITIMATE PREGNANCY,0,2,0,0,0,2,0,6,4,0,0,10,0,0,0,0,0,0,12
5651,UTTAR PRADESH,2005,34,LOVE AFFAIRS,2,47,13,4,0,66,2,51,16,1,0,70,0,0,0,0,0,0,136
6196,UTTAR PRADESH,2005,34,MARITAL ISSUES,1,54,38,7,4,104,3,86,50,12,0,151,0,0,0,0,0,0,255
6742,UTTAR PRADESH,2005,34,MENTAL HEALTH,1,17,32,18,3,71,2,3,8,5,5,23,0,0,0,0,0,0,94
7288,UTTAR PRADESH,2005,34,OTHERS,8,36,62,30,7,143,10,37,33,22,15,117,0,0,0,0,0,0,260
7873,UTTAR PRADESH,2005,34,"PHYSICAL ABUSE (RAPE,INCEST ETC.)",0,2,0,0,0,2,1,11,4,1,0,17,0,0,0,0,0,0,19
8379,UTTAR PRADESH,2005,34,SOCIETAL ISSUES,0,4,6,8,2,20,0,12,4,1,0,17,0,0,0,0,0,0,37
232,UTTAR PRADESH,2006,34,CAUSES NOT KNOWN,40,170,168,62,26,466,24,91,52,24,17,208,0,0,0,0,0,0,674
778,UTTAR PRADESH,2006,34,DEATH OF DEAR PERSON,0,0,0,0,0,0,0,0,2,2,0,4,0,0,0,0,0,0,4
1324,UTTAR PRADESH,2006,34,DOWRY DISPUTE,0,0,2,0,0,2,0,249,64,1,0,314,0,0,0,0,0,0,316
1870,UTTAR PRADESH,2006,34,DRUG ABUSE,0,20,42,20,5,87,0,1,1,0,0,2,0,0,0,0,0,0,89
2416,UTTAR PRADESH,2006,34,ECONOMIC ISSUES,0,41,78,37,11,167,4,10,24,14,2,54,0,0,0,0,0,0,221
2962,UTTAR PRADESH,2006,34,EXAM FAILURE,9,69,0,0,0,78,0,43,0,0,0,43,0,0,0,0,0,0,121
3508,UTTAR PRADESH,2006,34,FAMILY PROBLEMS,5,118,102,38,20,283,9,86,63,21,5,184,0,0,0,0,0,0,467
4054,UTTAR PRADESH,2006,34,HEALTH ISSUES,3,25,57,49,35,169,4,23,34,25,29,115,0,0,0,0,0,0,284
4599,UTTAR PRADESH,2006,34,HERO WORSHIP,0,1,0,0,0,1,0,4,3,1,0,8,0,0,0,0,0,0,9
5144,UTTAR PRADESH,2006,34,ILLEGITIMATE PREGNANCY,0,0,0,0,0,0,0,9,1,0,0,10,0,0,0,0,0,0,10
5689,UTTAR PRADESH,2006,34,LOVE AFFAIRS,0,53,11,0,0,64,0,52,11,3,0,66,0,0,0,0,0,0,130
6235,UTTAR PRADESH,2006,34,MARITAL ISSUES,0,41,25,9,2,77,1,88,47,6,1,143,0,0,0,0,0,0,220
6781,UTTAR PRADESH,2006,34,MENTAL HEALTH,1,24,36,22,7,90,0,14,12,0,4,30,0,0,0,0,0,0,120
7327,UTTAR PRADESH,2006,34,OTHERS,7,63,150,33,10,263,8,58,38,23,6,133,0,0,0,0,0,0,396
7911,UTTAR PRADESH,2006,34,"PHYSICAL ABUSE (RAPE,INCEST ETC.)",0,0,0,0,0,0,4,3,5,0,0,12,0,0,0,0,0,0,12
8418,UTTAR PRADESH,2006,34,SOCIETAL ISSUES,0,4,2,6,2,14,0,6,5,0,1,12,0,0,0,0,0,0,26
271,UTTAR PRADESH,2007,34,CAUSES NOT KNOWN,30,184,117,144,60,535,27,186,169,45,33,460,0,0,0,0,0,0,995
817,UTTAR PRADESH,2007,34,DEATH OF DEAR PERSON,0,0,1,2,1,4,0,1,5,4,0,10,0,0,0,0,0,0,14
1363,UTTAR PRADESH,2007,34,DOWRY DISPUTE,0,0,4,0,0,4,12,284,76,2,0,374,0,0,0,0,0,0,378
1909,UTTAR PRADESH,2007,34,DRUG ABUSE,1,16,50,39,11,117,0,0,0,0,0,0,0,0,0,0,0,0,117
2455,UTTAR PRADESH,2007,34,ECONOMIC ISSUES,1,27,64,53,9,154,4,30,22,4,3,63,0,0,0,0,0,0,217
3001,UTTAR PRADESH,2007,34,EXAM FAILURE,3,72,10,1,0,86,3,44,1,0,0,48,0,0,0,0,0,0,134
3547,UTTAR PRADESH,2007,34,FAMILY PROBLEMS,3,151,134,55,11,354,5,139,77,19,11,251,0,0,0,0,0,0,605
4093,UTTAR PRADESH,2007,34,HEALTH ISSUES,2,39,84,86,78,289,0,29,41,36,36,142,0,0,0,0,0,0,431
4638,UTTAR PRADESH,2007,34,HERO WORSHIP,0,1,0,0,1,2,0,0,0,0,0,0,0,0,0,0,0,0,2
5183,UTTAR PRADESH,2007,34,ILLEGITIMATE PREGNANCY,0,0,0,0,0,0,0,10,2,0,0,12,0,0,0,0,0,0,12
5728,UTTAR PRADESH,2007,34,LOVE AFFAIRS,1,56,21,2,0,80,4,79,17,2,0,102,0,0,0,0,0,0,182
6274,UTTAR PRADESH,2007,34,MARITAL ISSUES,0,51,28,6,1,86,2,69,65,9,0,145,0,0,0,0,0,0,231
6820,UTTAR PRADESH,2007,34,MENTAL HEALTH,2,23,27,26,19,97,1,10,11,12,9,43,0,0,0,0,0,0,140
7366,UTTAR PRADESH,2007,34,OTHERS,7,64,75,49,24,219,11,95,66,19,8,199,0,0,0,0,0,0,418
7950,UTTAR PRADESH,2007,34,"PHYSICAL ABUSE (RAPE,INCEST ETC.)",0,1,0,1,0,2,0,4,1,0,0,5,0,0,0,0,0,0,7
8457,UTTAR PRADESH,2007,34,SOCIETAL ISSUES,0,10,13,1,1,25,0,10,4,4,1,19,0,0,0,0,0,0,44
310,UTTAR PRADESH,2008,34,CAUSES NOT KNOWN,34,213,100,113,49,509,30,256,111,43,30,470,0,0,0,0,0,0,979
856,UTTAR PRADESH,2008,34,DEATH OF DEAR PERSON,0,1,2,0,1,4,0,2,1,1,0,4,0,0,0,0,0,0,8
1402,UTTAR PRADESH,2008,34,DOWRY DISPUTE,0,6,8,0,1,15,6,288,102,1,0,397,0,0,0,0,0,0,412
1948,UTTAR PRADESH,2008,34,DRUG ABUSE,0,28,60,27,23,138,0,0,0,0,0,0,0,0,0,0,0,0,138
2494,UTTAR PRADESH,2008,34,ECONOMIC ISSUES,0,43,62,31,10,146,1,11,13,7,2,34,0,0,0,0,0,0,180
3040,UTTAR PRADESH,2008,34,EXAM FAILURE,7,68,8,0,0,83,4,43,0,0,0,47,0,0,0,0,0,0,130
3586,UTTAR PRADESH,2008,34,FAMILY PROBLEMS,5,144,204,79,20,452,18,170,107,43,10,348,0,0,0,0,0,0,800
4132,UTTAR PRADESH,2008,34,HEALTH ISSUES,2,31,87,70,43,233,1,31,54,26,33,145,0,0,0,0,0,0,378
4677,UTTAR PRADESH,2008,34,HERO WORSHIP,0,0,0,0,1,1,0,0,0,0,0,0,0,0,0,0,0,0,1
5222,UTTAR PRADESH,2008,34,ILLEGITIMATE PREGNANCY,0,0,0,0,0,0,0,11,4,0,0,15,0,0,0,0,0,0,15
5767,UTTAR PRADESH,2008,34,LOVE AFFAIRS,2,49,17,3,0,71,1,55,15,2,0,73,0,0,0,0,0,0,144
6313,UTTAR PRADESH,2008,34,MARITAL ISSUES,0,42,29,4,0,75,0,68,54,5,0,127,0,0,0,0,0,0,202
6859,UTTAR PRADESH,2008,34,MENTAL HEALTH,5,24,56,20,10,115,2,24,18,9,9,62,0,0,0,0,0,0,177
7405,UTTAR PRADESH,2008,34,OTHERS,5,95,109,69,15,293,6,110,32,14,3,165,0,0,0,0,0,0,458
7989,UTTAR PRADESH,2008,34,"PHYSICAL ABUSE (RAPE,INCEST ETC.)",0,1,1,0,0,2,0,4,5,0,0,9,0,0,0,0,0,0,11
8496,UTTAR PRADESH,2008,34,SOCIETAL ISSUES,0,23,15,3,1,42,0,10,3,0,0,13,0,0,0,0,0,0,55
349,UTTAR PRADESH,2009,34,CAUSES NOT KNOWN,26,243,241,156,68,734,24,256,124,56,37,497,0,0,0,0,0,0,1231
895,UTTAR PRADESH,2009,34,DEATH OF DEAR PERSON,0,2,0,2,3,7,0,6,3,1,1,11,0,0,0,0,0,0,18
1441,UTTAR PRADESH,2009,34,DOWRY DISPUTE,1,7,3,0,0,11,0,323,102,1,1,427,0,0,0,0,0,0,438
1987,UTTAR PRADESH,2009,34,DRUG ABUSE,0,18,44,23,8,93,0,1,3,2,2,8,0,0,0,0,0,0,101
2533,UTTAR PRADESH,2009,34,ECONOMIC ISSUES,3,54,68,46,7,178,0,10,16,6,2,34,0,0,0,0,0,0,212
3079,UTTAR PRADESH,2009,34,EXAM FAILURE,4,45,2,0,0,51,10,27,4,0,0,41,0,0,0,0,0,0,92
3625,UTTAR PRADESH,2009,34,FAMILY PROBLEMS,2,130,150,61,17,360,9,141,107,45,11,313,0,0,0,0,0,0,673
4171,UTTAR PRADESH,2009,34,HEALTH ISSUES,4,33,90,82,54,263,4,60,45,18,28,155,0,0,0,0,0,0,418
4716,UTTAR PRADESH,2009,34,HERO WORSHIP,0,0,0,0,0,0,0,0,0,0,0,0,0,0,0,0,0,0,0
5261,UTTAR PRADESH,2009,34,ILLEGITIMATE PREGNANCY,0,0,0,0,0,0,0,9,5,1,0,15,0,0,0,0,0,0,15
5806,UTTAR PRADESH,2009,34,LOVE AFFAIRS,0,104,23,1,0,128,5,80,12,1,0,98,0,0,0,0,0,0,226
6352,UTTAR PRADESH,2009,34,MARITAL ISSUES,2,56,28,9,0,95,4,76,46,5,0,131,0,0,0,0,0,0,226
6898,UTTAR PRADESH,2009,34,MENTAL HEALTH,1,21,47,13,8,90,0,13,26,5,6,50,0,0,0,0,0,0,140
7444,UTTAR PRADESH,2009,34,OTHERS,8,81,35,18,3,145,4,54,34,15,6,113,0,0,0,0,0,0,258
8028,UTTAR PRADESH,2009,34,"PHYSICAL ABUSE (RAPE,INCEST ETC.)",0,13,4,1,1,19,1,5,1,4,2,13,0,0,0,0,0,0,32
8535,UTTAR PRADESH,2009,34,SOCIETAL ISSUES,0,29,30,6,0,65,1,8,3,1,0,13,0,0,0,0,0,0,78
388,UTTAR PRADESH,2010,34,CAUSES NOT KNOWN,23,185,128,56,32,424,28,202,107,54,14,405,0,0,0,0,0,0,829
934,UTTAR PRADESH,2010,34,DEATH OF DEAR PERSON,0,0,0,1,0,1,0,1,0,0,0,1,0,0,0,0,0,0,2
1480,UTTAR PRADESH,2010,34,DOWRY DISPUTE,0,4,5,0,0,9,1,391,127,4,0,523,0,0,0,0,0,0,532
2026,UTTAR PRADESH,2010,34,DRUG ABUSE,0,18,37,24,7,86,0,1,0,0,0,1,0,0,0,0,0,0,87
2572,UTTAR PRADESH,2010,34,ECONOMIC ISSUES,1,41,52,16,5,115,1,9,6,8,3,27,0,0,0,0,0,0,142
3118,UTTAR PRADESH,2010,34,EXAM FAILURE,3,57,5,0,0,65,5,34,3,0,0,42,0,0,0,0,0,0,107
3664,UTTAR PRADESH,2010,34,FAMILY PROBLEMS,5,104,149,100,25,383,7,132,121,42,15,317,0,0,0,0,0,0,700
4210,UTTAR PRADESH,2010,34,HEALTH ISSUES,0,17,47,60,41,165,1,19,28,30,21,99,0,0,0,0,0,0,264
4755,UTTAR PRADESH,2010,34,HERO WORSHIP,0,2,2,0,0,4,0,0,0,0,0,0,0,0,0,0,0,0,4
5300,UTTAR PRADESH,2010,34,ILLEGITIMATE PREGNANCY,0,0,0,0,0,0,2,11,7,0,0,20,0,0,0,0,0,0,20
5845,UTTAR PRADESH,2010,34,LOVE AFFAIRS,2,82,22,6,0,112,4,84,14,2,0,104,0,0,0,0,0,0,216
6391,UTTAR PRADESH,2010,34,MARITAL ISSUES,1,64,33,5,1,104,4,80,30,5,0,119,0,0,0,0,0,0,223
6937,UTTAR PRADESH,2010,34,MENTAL HEALTH,5,27,52,39,24,147,1,14,20,13,20,68,0,0,0,0,0,0,215
7483,UTTAR PRADESH,2010,34,OTHERS,6,49,41,36,6,138,3,41,21,12,6,83,0,0,0,0,0,0,221
8067,UTTAR PRADESH,2010,34,"PHYSICAL ABUSE (RAPE,INCEST ETC.)",0,0,1,0,1,2,1,2,2,0,0,5,0,0,0,0,0,0,7
8574,UTTAR PRADESH,2010,34,SOCIETAL ISSUES,0,22,6,4,0,32,0,6,19,2,0,27,0,0,0,0,0,0,59
427,UTTAR PRADESH,2011,34,CAUSES NOT KNOWN,14,180,194,146,66,600,31,133,87,39,19,309,0,0,0,0,0,0,909
973,UTTAR PRADESH,2011,34,DEATH OF DEAR PERSON,0,1,0,3,0,4,0,4,1,0,0,5,0,0,0,0,0,0,9
1519,UTTAR PRADESH,2011,34,DOWRY DISPUTE,0,12,13,5,0,30,1,316,91,1,0,409,0,0,0,0,0,0,439
2065,UTTAR PRADESH,2011,34,DRUG ABUSE,0,33,57,27,2,119,0,0,1,0,0,1,0,0,0,0,0,0,120
2611,UTTAR PRADESH,2011,34,ECONOMIC ISSUES,0,53,97,32,13,195,3,13,19,12,2,49,0,0,0,0,0,0,244
3157,UTTAR PRADESH,2011,34,EXAM FAILURE,1,56,0,1,0,58,2,28,1,0,0,31,0,0,0,0,0,0,89
3703,UTTAR PRADESH,2011,34,FAMILY PROBLEMS,5,257,322,124,48,756,3,321,185,73,33,615,0,0,0,0,0,0,1371
4249,UTTAR PRADESH,2011,34,HEALTH ISSUES,1,32,53,74,32,192,2,24,27,25,19,97,0,0,0,0,0,0,289
4794,UTTAR PRADESH,2011,34,HERO WORSHIP,0,0,0,0,0,0,0,1,0,0,0,1,0,0,0,0,0,0,1
5339,UTTAR PRADESH,2011,34,ILLEGITIMATE PREGNANCY,0,0,0,0,0,0,0,6,1,1,0,8,0,0,0,0,0,0,8
5884,UTTAR PRADESH,2011,34,LOVE AFFAIRS,0,92,54,0,0,146,5,109,43,9,0,166,0,0,0,0,0,0,312
6430,UTTAR PRADESH,2011,34,MARITAL ISSUES,1,69,22,8,0,100,4,99,46,3,2,154,0,0,0,0,0,0,254
6976,UTTAR PRADESH,2011,34,MENTAL HEALTH,4,35,58,42,12,151,1,23,35,15,7,81,0,0,0,0,0,0,232
7522,UTTAR PRADESH,2011,34,OTHERS,19,135,124,49,12,339,6,77,73,23,2,181,0,0,0,0,0,0,520
8106,UTTAR PRADESH,2011,34,"PHYSICAL ABUSE (RAPE,INCEST ETC.)",0,3,1,1,0,5,1,5,1,0,0,7,0,0,0,0,0,0,12
8613,UTTAR PRADESH,2011,34,SOCIETAL ISSUES,0,9,2,6,1,18,0,11,5,0,0,16,0,0,0,0,0,0,34
466,UTTAR PRADESH,2012,34,CAUSES NOT KNOWN,6,120,155,126,34,441,10,103,70,49,12,244,0,0,0,0,0,0,685
1012,UTTAR PRADESH,2012,34,DEATH OF DEAR PERSON,0,5,2,0,0,7,0,10,3,3,0,16,0,0,0,0,0,0,23
1558,UTTAR PRADESH,2012,34,DOWRY DISPUTE,1,14,6,1,0,22,0,285,110,5,0,400,0,0,0,0,0,0,422
2104,UTTAR PRADESH,2012,34,DRUG ABUSE,1,23,61,34,4,123,0,0,1,0,0,1,0,0,0,0,0,0,124
2650,UTTAR PRADESH,2012,34,ECONOMIC ISSUES,0,65,111,35,22,233,2,10,9,17,0,38,0,0,0,0,0,0,271
3196,UTTAR PRADESH,2012,34,EXAM FAILURE,10,111,1,0,0,122,1,120,0,0,0,121,0,0,0,0,0,0,243
3742,UTTAR PRADESH,2012,34,FAMILY PROBLEMS,4,208,253,152,53,670,4,220,207,47,10,488,0,0,0,0,0,0,1158
4288,UTTAR PRADESH,2012,34,HEALTH ISSUES,1,25,59,118,27,230,1,20,23,22,28,94,0,0,0,0,0,0,324
4833,UTTAR PRADESH,2012,34,HERO WORSHIP,0,2,0,0,0,2,0,1,2,3,0,6,0,0,0,0,0,0,8
5378,UTTAR PRADESH,2012,34,ILLEGITIMATE PREGNANCY,0,0,0,0,0,0,0,3,2,0,0,5,0,0,0,0,0,0,5
5923,UTTAR PRADESH,2012,34,LOVE AFFAIRS,0,88,23,0,0,111,9,80,13,1,0,103,0,0,0,0,0,0,214
6469,UTTAR PRADESH,2012,34,MARITAL ISSUES,0,26,15,7,6,54,1,57,53,8,0,119,0,0,0,0,0,0,173
7015,UTTAR PRADESH,2012,34,MENTAL HEALTH,0,35,51,36,14,136,0,23,31,15,11,80,0,0,0,0,0,0,216
7561,UTTAR PRADESH,2012,34,OTHERS,8,70,71,28,19,196,26,38,56,26,12,158,0,0,0,0,0,0,354
8145,UTTAR PRADESH,2012,34,"PHYSICAL ABUSE (RAPE,INCEST ETC.)",0,6,18,15,23,62,0,9,0,9,2,20,0,0,0,0,0,0,82
8652,UTTAR PRADESH,2012,34,SOCIETAL ISSUES,0,47,16,22,1,86,0,10,11,13,0,34,0,0,0,0,0,0,120
505,UTTAR PRADESH,2013,34,CAUSES NOT KNOWN,28,185,253,192,41,699,11,120,109,74,12,326,0,0,0,0,0,0,1025
1051,UTTAR PRADESH,2013,34,DEATH OF DEAR PERSON,0,5,4,2,3,14,0,20,5,2,0,27,0,0,0,0,0,0,41
1597,UTTAR PRADESH,2013,34,DOWRY DISPUTE,0,17,8,13,0,38,9,359,60,6,0,434,0,0,0,0,0,0,472
2143,UTTAR PRADESH,2013,34,DRUG ABUSE,0,19,51,38,7,115,0,0,3,0,0,3,0,0,0,0,0,0,118
2689,UTTAR PRADESH,2013,34,ECONOMIC ISSUES,1,47,79,48,7,182,0,4,14,6,1,25,0,0,0,0,0,0,207
3235,UTTAR PRADESH,2013,34,EXAM FAILURE,8,66,1,0,0,75,5,61,11,0,0,77,0,0,0,0,0,0,152
3781,UTTAR PRADESH,2013,34,FAMILY PROBLEMS,7,137,178,96,13,431,8,121,128,39,6,302,0,0,0,0,0,0,733
4327,UTTAR PRADESH,2013,34,HEALTH ISSUES,5,40,102,102,50,299,6,30,43,54,31,164,0,0,0,0,0,0,463
4872,UTTAR PRADESH,2013,34,HERO WORSHIP,0,2,0,1,0,3,0,0,1,0,0,1,0,0,0,0,0,0,4
5417,UTTAR PRADESH,2013,34,ILLEGITIMATE PREGNANCY,0,0,0,0,0,0,1,22,2,0,0,25,0,0,0,0,0,0,25
5962,UTTAR PRADESH,2013,34,LOVE AFFAIRS,2,119,52,13,0,186,3,103,39,6,0,151,0,0,0,0,0,0,337
6508,UTTAR PRADESH,2013,34,MARITAL ISSUES,0,50,46,9,0,105,2,91,55,18,0,166,0,0,0,0,0,0,271
7054,UTTAR PRADESH,2013,34,MENTAL HEALTH,6,32,40,33,12,123,1,11,26,10,1,49,0,0,0,0,0,0,172
7600,UTTAR PRADESH,2013,34,OTHERS,54,302,274,133,61,824,13,146,111,37,5,312,0,0,0,0,0,0,1136
8184,UTTAR PRADESH,2013,34,"PHYSICAL ABUSE (RAPE,INCEST ETC.)",0,0,0,0,0,0,0,5,4,4,0,13,0,0,0,0,0,0,13
8691,UTTAR PRADESH,2013,34,SOCIETAL ISSUES,1,16,38,9,5,69,3,14,14,16,1,48,0,0,0,0,0,0,117
544,UTTAR PRADESH,2014,34,CAUSES NOT KNOWN,10,120,68,25,5,228,8,77,36,5,4,130,0,0,0,0,0,0,358
1090,UTTAR PRADESH,2014,34,DEATH OF DEAR PERSON,0,0,6,0,0,6,0,1,1,0,5,7,0,0,0,0,0,0,13
1636,UTTAR PRADESH,2014,34,DOWRY DISPUTE,1,10,2,0,0,13,0,290,48,2,0,340,0,0,0,0,0,0,353
2182,UTTAR PRADESH,2014,34,DRUG ABUSE,0,15,13,4,1,33,3,3,3,0,1,10,0,1,0,0,0,1,44
2728,UTTAR PRADESH,2014,34,ECONOMIC ISSUES,0,37,34,7,2,80,0,6,2,1,1,10,0,0,0,0,0,0,90
3274,UTTAR PRADESH,2014,34,EXAM FAILURE,1,33,4,2,0,40,1,13,1,0,0,15,0,0,0,0,0,0,55
3820,UTTAR PRADESH,2014,34,FAMILY PROBLEMS,4,224,197,62,13,500,7,180,82,29,5,303,0,0,0,0,0,0,803
4366,UTTAR PRADESH,2014,34,HEALTH ISSUES,8,114,119,98,30,369,10,76,13,18,8,125,0,0,0,0,0,0,494
4911,UTTAR PRADESH,2014,34,HERO WORSHIP,0,0,0,0,0,0,0,0,0,0,0,0,0,0,0,0,0,0,0
5456,UTTAR PRADESH,2014,34,ILLEGITIMATE PREGNANCY,0,0,0,0,0,0,1,0,0,0,0,1,0,0,0,0,0,0,1
6001,UTTAR PRADESH,2014,34,LOVE AFFAIRS,2,36,11,1,0,50,0,37,5,1,0,43,0,0,0,0,0,0,93
6547,UTTAR PRADESH,2014,34,MARITAL ISSUES,2,184,76,31,10,303,2,480,111,14,2,609,0,0,0,0,0,0,912
7093,UTTAR PRADESH,2014,34,MENTAL HEALTH,2,12,19,6,2,41,0,8,3,0,0,11,0,0,0,0,0,0,52
7639,UTTAR PRADESH,2014,34,OTHERS,20,419,293,120,36,888,13,297,120,29,6,465,0,4,0,1,0,5,1358
7678,UTTAR PRADESH,2014,34,PHYSICAL ABUSE,0,0,0,0,0,0,0,7,2,0,0,9,0,0,0,0,0,0,9
8730,UTTAR PRADESH,2014,34,SOCIETAL ISSUES,0,5,2,0,0,7,1,1,0,0,0,2,0,0,0,0,0,0,9
38,UTTARAKHAND,2001,35,CAUSES NOT KNOWN,0,13,24,16,3,56,2,13,11,3,0,29,0,0,0,0,0,0,85
584,UTTARAKHAND,2001,35,DEATH OF DEAR PERSON,0,0,0,0,0,0,0,0,0,0,0,0,0,0,0,0,0,0,0
1130,UTTARAKHAND,2001,35,DOWRY DISPUTE,0,0,0,0,0,0,0,9,4,0,0,13,0,0,0,0,0,0,13
1676,UTTARAKHAND,2001,35,DRUG ABUSE,0,1,4,3,0,8,0,0,0,0,0,0,0,0,0,0,0,0,8
2222,UTTARAKHAND,2001,35,ECONOMIC ISSUES,1,6,23,2,1,33,0,2,2,2,0,6,0,0,0,0,0,0,39
2768,UTTARAKHAND,2001,35,EXAM FAILURE,0,2,6,0,0,8,0,1,0,0,0,1,0,0,0,0,0,0,9
3314,UTTARAKHAND,2001,35,FAMILY PROBLEMS,0,1,5,1,0,7,0,3,4,3,0,10,0,0,0,0,0,0,17
3860,UTTARAKHAND,2001,35,HEALTH ISSUES,0,4,1,3,0,8,2,2,3,0,1,8,0,0,0,0,0,0,16
4406,UTTARAKHAND,2001,35,HERO WORSHIP,0,7,10,6,1,24,0,17,5,2,0,24,0,0,0,0,0,0,48
4951,UTTARAKHAND,2001,35,ILLEGITIMATE PREGNANCY,0,0,0,0,0,0,0,8,7,0,0,15,0,0,0,0,0,0,15
5496,UTTARAKHAND,2001,35,LOVE AFFAIRS,0,5,1,0,0,6,0,5,0,0,0,5,0,0,0,0,0,0,11
6041,UTTARAKHAND,2001,35,MARITAL ISSUES,0,0,0,0,0,0,0,2,0,0,0,2,0,0,0,0,0,0,2
6587,UTTARAKHAND,2001,35,MENTAL HEALTH,0,0,3,1,0,4,0,2,1,0,1,4,0,0,0,0,0,0,8
7133,UTTARAKHAND,2001,35,OTHERS,2,2,14,10,0,28,0,8,4,0,0,12,0,0,0,0,0,0,40
7718,UTTARAKHAND,2001,35,"PHYSICAL ABUSE (RAPE,INCEST ETC.)",0,0,0,0,0,0,0,0,0,0,0,0,0,0,0,0,0,0,0
8224,UTTARAKHAND,2001,35,SOCIETAL ISSUES,0,0,0,0,0,0,0,0,0,0,0,0,0,0,0,0,0,0,0
77,UTTARAKHAND,2002,35,CAUSES NOT KNOWN,3,33,18,12,3,69,2,29,17,9,0,57,0,0,0,0,0,0,126
623,UTTARAKHAND,2002,35,DEATH OF DEAR PERSON,0,0,0,0,0,0,0,0,0,0,0,0,0,0,0,0,0,0,0
1169,UTTARAKHAND,2002,35,DOWRY DISPUTE,0,0,0,0,0,0,0,3,0,0,0,3,0,0,0,0,0,0,3
1715,UTTARAKHAND,2002,35,DRUG ABUSE,0,1,0,0,0,1,0,0,0,0,0,0,0,0,0,0,0,0,1
2261,UTTARAKHAND,2002,35,ECONOMIC ISSUES,0,21,9,4,3,37,3,5,6,1,1,16,0,0,0,0,0,0,53
2807,UTTARAKHAND,2002,35,EXAM FAILURE,0,3,0,0,0,3,0,2,0,0,0,2,0,0,0,0,0,0,5
3353,UTTARAKHAND,2002,35,FAMILY PROBLEMS,4,14,13,6,3,40,0,32,21,4,1,58,0,0,0,0,0,0,98
3899,UTTARAKHAND,2002,35,HEALTH ISSUES,1,0,5,6,5,17,0,1,2,0,1,4,0,0,0,0,0,0,21
4445,UTTARAKHAND,2002,35,HERO WORSHIP,0,1,2,0,0,3,0,2,0,0,0,2,0,0,0,0,0,0,5
4990,UTTARAKHAND,2002,35,ILLEGITIMATE PREGNANCY,0,0,0,0,0,0,0,0,0,0,0,0,0,0,0,0,0,0,0
5535,UTTARAKHAND,2002,35,LOVE AFFAIRS,0,4,0,0,0,4,2,4,0,0,0,6,0,0,0,0,0,0,10
6080,UTTARAKHAND,2002,35,MARITAL ISSUES,0,2,0,0,0,2,0,2,2,0,0,4,0,0,0,0,0,0,6
6626,UTTARAKHAND,2002,35,MENTAL HEALTH,0,0,3,2,0,5,1,0,1,1,0,3,0,0,0,0,0,0,8
7172,UTTARAKHAND,2002,35,OTHERS,0,9,10,2,2,23,0,0,1,0,0,1,0,0,0,0,0,0,24
7757,UTTARAKHAND,2002,35,"PHYSICAL ABUSE (RAPE,INCEST ETC.)",0,0,0,0,0,0,0,0,0,0,0,0,0,0,0,0,0,0,0
8263,UTTARAKHAND,2002,35,SOCIETAL ISSUES,0,1,0,0,0,1,0,0,0,0,0,0,0,0,0,0,0,0,1
116,UTTARAKHAND,2003,35,CAUSES NOT KNOWN,0,49,38,30,0,117,1,16,8,5,1,31,0,0,0,0,0,0,148
662,UTTARAKHAND,2003,35,DEATH OF DEAR PERSON,0,0,0,0,0,0,0,0,0,0,0,0,0,0,0,0,0,0,0
1208,UTTARAKHAND,2003,35,DOWRY DISPUTE,0,0,0,0,0,0,0,11,3,0,0,14,0,0,0,0,0,0,14
1754,UTTARAKHAND,2003,35,DRUG ABUSE,0,0,1,0,1,2,0,0,0,0,0,0,0,0,0,0,0,0,2
2300,UTTARAKHAND,2003,35,ECONOMIC ISSUES,0,13,8,6,0,27,0,2,4,2,0,8,0,0,0,0,0,0,35
2846,UTTARAKHAND,2003,35,EXAM FAILURE,0,5,0,0,0,5,0,3,2,0,0,5,0,0,0,0,0,0,10
3392,UTTARAKHAND,2003,35,FAMILY PROBLEMS,0,26,30,12,2,70,2,26,14,3,1,46,0,0,0,0,0,0,116
3938,UTTARAKHAND,2003,35,HEALTH ISSUES,0,2,3,0,2,7,0,3,0,0,1,4,0,0,0,0,0,0,11
4484,UTTARAKHAND,2003,35,HERO WORSHIP,0,1,0,0,0,1,0,1,0,0,0,1,0,0,0,0,0,0,2
5029,UTTARAKHAND,2003,35,ILLEGITIMATE PREGNANCY,0,0,0,0,0,0,0,1,0,0,0,1,0,0,0,0,0,0,1
5574,UTTARAKHAND,2003,35,LOVE AFFAIRS,0,7,2,0,0,9,0,10,0,0,0,10,0,0,0,0,0,0,19
6119,UTTARAKHAND,2003,35,MARITAL ISSUES,0,1,0,1,0,2,0,3,0,0,0,3,0,0,0,0,0,0,5
6665,UTTARAKHAND,2003,35,MENTAL HEALTH,0,3,8,4,0,15,0,0,1,2,0,3,0,0,0,0,0,0,18
7211,UTTARAKHAND,2003,35,OTHERS,0,3,1,2,0,6,0,1,0,2,0,3,0,0,0,0,0,0,9
7796,UTTARAKHAND,2003,35,"PHYSICAL ABUSE (RAPE,INCEST ETC.)",0,0,0,0,0,0,0,0,0,0,0,0,0,0,0,0,0,0,0
8302,UTTARAKHAND,2003,35,SOCIETAL ISSUES,0,1,0,0,0,1,0,0,0,0,0,0,0,0,0,0,0,0,1
155,UTTARAKHAND,2004,35,CAUSES NOT KNOWN,4,32,24,6,2,68,1,14,5,3,0,23,0,0,0,0,0,0,91
701,UTTARAKHAND,2004,35,DEATH OF DEAR PERSON,0,0,0,0,0,0,0,0,0,0,0,0,0,0,0,0,0,0,0
1247,UTTARAKHAND,2004,35,DOWRY DISPUTE,0,0,0,0,0,0,0,11,1,0,0,12,0,0,0,0,0,0,12
1793,UTTARAKHAND,2004,35,DRUG ABUSE,0,0,1,0,1,2,0,0,0,0,0,0,0,0,0,0,0,0,2
2339,UTTARAKHAND,2004,35,ECONOMIC ISSUES,0,6,6,3,0,15,0,0,9,0,0,9,0,0,0,0,0,0,24
2885,UTTARAKHAND,2004,35,EXAM FAILURE,0,3,0,0,0,3,0,6,0,0,0,6,0,0,0,0,0,0,9
3431,UTTARAKHAND,2004,35,FAMILY PROBLEMS,2,11,14,6,1,34,1,13,5,5,0,24,0,0,0,0,0,0,58
3977,UTTARAKHAND,2004,35,HEALTH ISSUES,0,0,2,2,1,5,0,0,1,1,0,2,0,0,0,0,0,0,7
4523,UTTARAKHAND,2004,35,HERO WORSHIP,0,0,0,0,0,0,0,1,0,0,0,1,0,0,0,0,0,0,1
5068,UTTARAKHAND,2004,35,ILLEGITIMATE PREGNANCY,0,0,0,0,0,0,0,1,0,0,0,1,0,0,0,0,0,0,1
5613,UTTARAKHAND,2004,35,LOVE AFFAIRS,0,4,0,0,0,4,0,2,0,0,0,2,0,0,0,0,0,0,6
6158,UTTARAKHAND,2004,35,MARITAL ISSUES,0,1,1,0,0,2,0,2,0,1,0,3,0,0,0,0,0,0,5
6704,UTTARAKHAND,2004,35,MENTAL HEALTH,2,2,5,4,2,15,0,4,1,0,0,5,0,0,0,0,0,0,20
7250,UTTARAKHAND,2004,35,OTHERS,0,0,0,0,0,0,0,1,0,0,0,1,0,0,0,0,0,0,1
7835,UTTARAKHAND,2004,35,"PHYSICAL ABUSE (RAPE,INCEST ETC.)",0,0,0,0,0,0,0,0,0,0,0,0,0,0,0,0,0,0,0
8341,UTTARAKHAND,2004,35,SOCIETAL ISSUES,0,0,0,0,0,0,0,0,0,0,0,0,0,0,0,0,0,0,0
194,UTTARAKHAND,2005,35,CAUSES NOT KNOWN,0,12,11,2,0,25,1,6,5,1,0,13,0,0,0,0,0,0,38
740,UTTARAKHAND,2005,35,DEATH OF DEAR PERSON,0,0,0,0,0,0,0,0,0,0,0,0,0,0,0,0,0,0,0
1286,UTTARAKHAND,2005,35,DOWRY DISPUTE,0,0,0,0,0,0,0,10,0,0,0,10,0,0,0,0,0,0,10
1832,UTTARAKHAND,2005,35,DRUG ABUSE,0,2,8,3,0,13,0,0,0,0,0,0,0,0,0,0,0,0,13
2378,UTTARAKHAND,2005,35,ECONOMIC ISSUES,0,10,11,2,0,23,0,1,1,0,0,2,0,0,0,0,0,0,25
2924,UTTARAKHAND,2005,35,EXAM FAILURE,0,6,0,0,0,6,1,2,0,0,0,3,0,0,0,0,0,0,9
3470,UTTARAKHAND,2005,35,FAMILY PROBLEMS,0,15,14,8,4,41,1,10,11,3,0,25,0,0,0,0,0,0,66
4016,UTTARAKHAND,2005,35,HEALTH ISSUES,0,3,2,4,4,13,0,1,1,2,0,4,0,0,0,0,0,0,17
4562,UTTARAKHAND,2005,35,HERO WORSHIP,0,0,0,0,0,0,0,0,0,0,0,0,0,0,0,0,0,0,0
5107,UTTARAKHAND,2005,35,ILLEGITIMATE PREGNANCY,0,0,0,0,0,0,0,0,0,0,0,0,0,0,0,0,0,0,0
5652,UTTARAKHAND,2005,35,LOVE AFFAIRS,0,6,0,0,0,6,0,0,0,0,0,0,0,0,0,0,0,0,6
6197,UTTARAKHAND,2005,35,MARITAL ISSUES,0,1,1,0,0,2,0,2,1,0,0,3,0,0,0,0,0,0,5
6743,UTTARAKHAND,2005,35,MENTAL HEALTH,0,2,5,4,1,12,0,1,2,3,0,6,0,0,0,0,0,0,18
7289,UTTARAKHAND,2005,35,OTHERS,0,8,9,2,0,19,1,7,2,0,0,10,0,0,0,0,0,0,29
7874,UTTARAKHAND,2005,35,"PHYSICAL ABUSE (RAPE,INCEST ETC.)",0,0,0,0,0,0,0,0,0,0,0,0,0,0,0,0,0,0,0
8380,UTTARAKHAND,2005,35,SOCIETAL ISSUES,0,11,5,4,0,20,0,14,3,0,0,17,0,0,0,0,0,0,37
233,UTTARAKHAND,2006,35,CAUSES NOT KNOWN,0,5,11,4,2,22,3,13,2,3,0,21,0,0,0,0,0,0,43
779,UTTARAKHAND,2006,35,DEATH OF DEAR PERSON,0,0,0,0,0,0,0,0,0,1,0,1,0,0,0,0,0,0,1
1325,UTTARAKHAND,2006,35,DOWRY DISPUTE,0,0,0,0,0,0,0,4,5,0,0,9,0,0,0,0,0,0,9
1871,UTTARAKHAND,2006,35,DRUG ABUSE,0,5,4,3,0,12,0,0,0,0,0,0,0,0,0,0,0,0,12
2417,UTTARAKHAND,2006,35,ECONOMIC ISSUES,0,5,11,7,1,24,0,4,8,2,0,14,0,0,0,0,0,0,38
2963,UTTARAKHAND,2006,35,EXAM FAILURE,0,4,0,0,0,4,0,3,0,0,0,3,0,0,0,0,0,0,7
3509,UTTARAKHAND,2006,35,FAMILY PROBLEMS,0,13,19,7,3,42,1,27,20,2,0,50,0,0,0,0,0,0,92
4055,UTTARAKHAND,2006,35,HEALTH ISSUES,0,1,7,8,4,20,0,2,4,3,1,10,0,0,0,0,0,0,30
4600,UTTARAKHAND,2006,35,HERO WORSHIP,0,0,0,0,0,0,0,0,0,0,0,0,0,0,0,0,0,0,0
5145,UTTARAKHAND,2006,35,ILLEGITIMATE PREGNANCY,0,0,0,0,0,0,0,2,0,0,0,2,0,0,0,0,0,0,2
5690,UTTARAKHAND,2006,35,LOVE AFFAIRS,0,2,1,0,0,3,0,2,1,0,0,3,0,0,0,0,0,0,6
6236,UTTARAKHAND,2006,35,MARITAL ISSUES,0,9,6,1,0,16,0,10,6,0,0,16,0,0,0,0,0,0,32
6782,UTTARAKHAND,2006,35,MENTAL HEALTH,0,4,3,6,3,16,0,3,4,2,1,10,0,0,0,0,0,0,26
7328,UTTARAKHAND,2006,35,OTHERS,0,2,6,3,0,11,1,4,3,0,1,9,0,0,0,0,0,0,20
7912,UTTARAKHAND,2006,35,"PHYSICAL ABUSE (RAPE,INCEST ETC.)",0,0,0,0,0,0,0,0,1,0,0,1,0,0,0,0,0,0,1
8419,UTTARAKHAND,2006,35,SOCIETAL ISSUES,0,1,2,0,0,3,0,3,1,0,0,4,0,0,0,0,0,0,7
272,UTTARAKHAND,2007,35,CAUSES NOT KNOWN,1,14,16,6,0,37,6,9,7,2,2,26,0,0,0,0,0,0,63
818,UTTARAKHAND,2007,35,DEATH OF DEAR PERSON,0,0,1,0,0,1,0,1,0,0,0,1,0,0,0,0,0,0,2
1364,UTTARAKHAND,2007,35,DOWRY DISPUTE,0,0,0,0,0,0,0,9,1,0,0,10,0,0,0,0,0,0,10
1910,UTTARAKHAND,2007,35,DRUG ABUSE,0,0,8,1,0,9,0,0,0,0,0,0,0,0,0,0,0,0,9
2456,UTTARAKHAND,2007,35,ECONOMIC ISSUES,0,5,9,3,0,17,0,1,4,1,0,6,0,0,0,0,0,0,23
3002,UTTARAKHAND,2007,35,EXAM FAILURE,0,2,0,0,0,2,0,2,0,0,0,2,0,0,0,0,0,0,4
3548,UTTARAKHAND,2007,35,FAMILY PROBLEMS,0,12,9,4,0,25,0,21,12,1,1,35,0,0,0,0,0,0,60
4094,UTTARAKHAND,2007,35,HEALTH ISSUES,1,3,2,0,0,6,2,3,0,0,0,5,0,0,0,0,0,0,11
4639,UTTARAKHAND,2007,35,HERO WORSHIP,0,0,0,0,0,0,0,0,0,0,0,0,0,0,0,0,0,0,0
5184,UTTARAKHAND,2007,35,ILLEGITIMATE PREGNANCY,0,0,0,0,0,0,0,1,0,0,0,1,0,0,0,0,0,0,1
5729,UTTARAKHAND,2007,35,LOVE AFFAIRS,0,4,2,0,0,6,0,4,0,0,0,4,0,0,0,0,0,0,10
6275,UTTARAKHAND,2007,35,MARITAL ISSUES,0,5,4,0,0,9,0,8,6,0,0,14,0,0,0,0,0,0,23
6821,UTTARAKHAND,2007,35,MENTAL HEALTH,0,5,8,0,0,13,0,2,3,2,1,8,0,0,0,0,0,0,21
7367,UTTARAKHAND,2007,35,OTHERS,0,1,1,0,1,3,0,1,2,2,0,5,0,0,0,0,0,0,8
7951,UTTARAKHAND,2007,35,"PHYSICAL ABUSE (RAPE,INCEST ETC.)",0,0,0,0,0,0,0,0,0,0,0,0,0,0,0,0,0,0,0
8458,UTTARAKHAND,2007,35,SOCIETAL ISSUES,0,2,0,0,0,2,0,1,0,0,0,1,0,0,0,0,0,0,3
311,UTTARAKHAND,2008,35,CAUSES NOT KNOWN,2,16,9,6,0,33,1,6,6,2,0,15,0,0,0,0,0,0,48
857,UTTARAKHAND,2008,35,DEATH OF DEAR PERSON,0,0,0,1,0,1,0,0,0,0,0,0,0,0,0,0,0,0,1
1403,UTTARAKHAND,2008,35,DOWRY DISPUTE,0,0,0,0,0,0,0,14,1,0,0,15,0,0,0,0,0,0,15
1949,UTTARAKHAND,2008,35,DRUG ABUSE,0,1,2,1,0,4,0,0,0,0,0,0,0,0,0,0,0,0,4
2495,UTTARAKHAND,2008,35,ECONOMIC ISSUES,0,1,4,4,0,9,0,0,0,1,0,1,0,0,0,0,0,0,10
3041,UTTARAKHAND,2008,35,EXAM FAILURE,0,2,0,0,0,2,1,0,0,0,0,1,0,0,0,0,0,0,3
3587,UTTARAKHAND,2008,35,FAMILY PROBLEMS,1,7,8,4,1,21,0,17,4,1,0,22,0,0,0,0,0,0,43
4133,UTTARAKHAND,2008,35,HEALTH ISSUES,0,0,0,1,0,1,0,2,1,0,0,3,0,0,0,0,0,0,4
4678,UTTARAKHAND,2008,35,HERO WORSHIP,0,0,0,0,0,0,0,0,0,0,0,0,0,0,0,0,0,0,0
5223,UTTARAKHAND,2008,35,ILLEGITIMATE PREGNANCY,0,0,0,0,0,0,0,0,0,0,0,0,0,0,0,0,0,0,0
5768,UTTARAKHAND,2008,35,LOVE AFFAIRS,1,2,1,0,0,4,0,5,0,1,0,6,0,0,0,0,0,0,10
6314,UTTARAKHAND,2008,35,MARITAL ISSUES,0,0,1,1,0,2,0,2,1,1,0,4,0,0,0,0,0,0,6
6860,UTTARAKHAND,2008,35,MENTAL HEALTH,0,4,4,2,0,10,0,0,0,0,0,0,0,0,0,0,0,0,10
7406,UTTARAKHAND,2008,35,OTHERS,4,4,6,0,2,16,1,15,2,2,0,20,0,0,0,0,0,0,36
7990,UTTARAKHAND,2008,35,"PHYSICAL ABUSE (RAPE,INCEST ETC.)",0,0,0,0,0,0,0,0,0,0,0,0,0,0,0,0,0,0,0
8497,UTTARAKHAND,2008,35,SOCIETAL ISSUES,0,0,0,0,1,1,0,0,0,0,0,0,0,0,0,0,0,0,1
350,UTTARAKHAND,2009,35,CAUSES NOT KNOWN,0,9,8,5,0,22,0,8,5,5,1,19,0,0,0,0,0,0,41
896,UTTARAKHAND,2009,35,DEATH OF DEAR PERSON,0,0,0,0,0,0,0,1,2,0,0,3,0,0,0,0,0,0,3
1442,UTTARAKHAND,2009,35,DOWRY DISPUTE,0,0,0,0,0,0,0,17,5,0,0,22,0,0,0,0,0,0,22
1988,UTTARAKHAND,2009,35,DRUG ABUSE,0,1,5,7,0,13,0,1,0,0,0,1,0,0,0,0,0,0,14
2534,UTTARAKHAND,2009,35,ECONOMIC ISSUES,1,6,11,7,0,25,0,0,0,0,0,0,0,0,0,0,0,0,25
3080,UTTARAKHAND,2009,35,EXAM FAILURE,1,4,0,0,0,5,0,3,0,0,0,3,0,0,0,0,0,0,8
3626,UTTARAKHAND,2009,35,FAMILY PROBLEMS,0,12,9,6,0,27,2,12,11,1,0,26,0,0,0,0,0,0,53
4172,UTTARAKHAND,2009,35,HEALTH ISSUES,0,3,7,10,5,25,1,5,3,1,0,10,0,0,0,0,0,0,35
4717,UTTARAKHAND,2009,35,HERO WORSHIP,0,0,0,0,0,0,0,0,0,0,0,0,0,0,0,0,0,0,0
5262,UTTARAKHAND,2009,35,ILLEGITIMATE PREGNANCY,0,0,0,0,0,0,0,1,0,0,0,1,0,0,0,0,0,0,1
5807,UTTARAKHAND,2009,35,LOVE AFFAIRS,0,13,0,1,0,14,0,15,2,0,0,17,0,0,0,0,0,0,31
6353,UTTARAKHAND,2009,35,MARITAL ISSUES,0,6,1,2,0,9,0,5,4,1,0,10,0,0,0,0,0,0,19
6899,UTTARAKHAND,2009,35,MENTAL HEALTH,0,8,4,5,4,21,0,3,4,3,0,10,0,0,0,0,0,0,31
7445,UTTARAKHAND,2009,35,OTHERS,0,11,9,14,1,35,0,8,6,4,0,18,0,0,0,0,0,0,53
8029,UTTARAKHAND,2009,35,"PHYSICAL ABUSE (RAPE,INCEST ETC.)",0,0,0,0,0,0,0,0,0,0,0,0,0,0,0,0,0,0,0
8536,UTTARAKHAND,2009,35,SOCIETAL ISSUES,0,4,1,0,1,6,0,0,0,0,0,0,0,0,0,0,0,0,6
389,UTTARAKHAND,2010,35,CAUSES NOT KNOWN,4,12,15,5,3,39,7,11,7,2,0,27,0,0,0,0,0,0,66
935,UTTARAKHAND,2010,35,DEATH OF DEAR PERSON,0,0,0,0,0,0,0,0,0,0,0,0,0,0,0,0,0,0,0
1481,UTTARAKHAND,2010,35,DOWRY DISPUTE,0,0,0,0,0,0,0,6,4,0,0,10,0,0,0,0,0,0,10
2027,UTTARAKHAND,2010,35,DRUG ABUSE,0,2,3,1,0,6,0,0,0,0,0,0,0,0,0,0,0,0,6
2573,UTTARAKHAND,2010,35,ECONOMIC ISSUES,0,10,9,4,3,26,0,4,2,3,0,9,0,0,0,0,0,0,35
3119,UTTARAKHAND,2010,35,EXAM FAILURE,0,2,1,0,0,3,0,8,0,0,0,8,0,0,0,0,0,0,11
3665,UTTARAKHAND,2010,35,FAMILY PROBLEMS,0,21,14,12,2,49,0,20,8,2,2,32,0,0,0,0,0,0,81
4211,UTTARAKHAND,2010,35,HEALTH ISSUES,0,2,3,2,1,8,0,4,2,0,0,6,0,0,0,0,0,0,14
4756,UTTARAKHAND,2010,35,HERO WORSHIP,0,0,0,0,0,0,0,0,0,0,0,0,0,0,0,0,0,0,0
5301,UTTARAKHAND,2010,35,ILLEGITIMATE PREGNANCY,0,0,0,0,0,0,0,0,0,0,0,0,0,0,0,0,0,0,0
5846,UTTARAKHAND,2010,35,LOVE AFFAIRS,0,5,0,0,0,5,0,10,0,0,0,10,0,0,0,0,0,0,15
6392,UTTARAKHAND,2010,35,MARITAL ISSUES,0,1,0,0,0,1,0,3,0,0,0,3,0,0,0,0,0,0,4
6938,UTTARAKHAND,2010,35,MENTAL HEALTH,0,2,3,3,1,9,0,2,1,0,0,3,0,0,0,0,0,0,12
7484,UTTARAKHAND,2010,35,OTHERS,0,5,7,2,2,16,0,1,6,2,0,9,0,0,0,0,0,0,25
8068,UTTARAKHAND,2010,35,"PHYSICAL ABUSE (RAPE,INCEST ETC.)",0,0,0,0,0,0,0,0,0,0,0,0,0,0,0,0,0,0,0
8575,UTTARAKHAND,2010,35,SOCIETAL ISSUES,0,0,2,0,0,2,0,0,0,0,0,0,0,0,0,0,0,0,2
428,UTTARAKHAND,2011,35,CAUSES NOT KNOWN,0,8,11,5,2,26,0,6,3,1,0,10,0,0,0,0,0,0,36
974,UTTARAKHAND,2011,35,DEATH OF DEAR PERSON,0,3,2,1,0,6,0,0,1,0,0,1,0,0,0,0,0,0,7
1520,UTTARAKHAND,2011,35,DOWRY DISPUTE,0,0,0,0,0,0,0,10,2,0,0,12,0,0,0,0,0,0,12
2066,UTTARAKHAND,2011,35,DRUG ABUSE,0,0,3,2,0,5,0,0,0,0,0,0,0,0,0,0,0,0,5
2612,UTTARAKHAND,2011,35,ECONOMIC ISSUES,1,5,10,5,0,21,0,0,0,0,0,0,0,0,0,0,0,0,21
3158,UTTARAKHAND,2011,35,EXAM FAILURE,1,3,0,0,0,4,1,7,0,0,0,8,0,0,0,0,0,0,12
3704,UTTARAKHAND,2011,35,FAMILY PROBLEMS,0,14,21,10,2,47,0,16,15,4,0,35,0,0,0,0,0,0,82
4250,UTTARAKHAND,2011,35,HEALTH ISSUES,0,6,4,3,2,15,0,3,4,1,0,8,0,0,0,0,0,0,23
4795,UTTARAKHAND,2011,35,HERO WORSHIP,0,0,0,0,0,0,0,0,0,0,0,0,0,0,0,0,0,0,0
5340,UTTARAKHAND,2011,35,ILLEGITIMATE PREGNANCY,0,0,0,0,0,0,0,0,0,0,0,0,0,0,0,0,0,0,0
5885,UTTARAKHAND,2011,35,LOVE AFFAIRS,0,4,1,0,0,5,0,7,0,0,0,7,0,0,0,0,0,0,12
6431,UTTARAKHAND,2011,35,MARITAL ISSUES,1,3,3,0,1,8,0,6,5,1,0,12,0,0,0,0,0,0,20
6977,UTTARAKHAND,2011,35,MENTAL HEALTH,0,1,1,1,1,4,0,3,0,0,0,3,0,0,0,0,0,0,7
7523,UTTARAKHAND,2011,35,OTHERS,2,21,16,5,3,47,0,10,14,3,1,28,0,0,0,0,0,0,75
8107,UTTARAKHAND,2011,35,"PHYSICAL ABUSE (RAPE,INCEST ETC.)",0,1,0,0,0,1,0,1,0,0,0,1,0,0,0,0,0,0,2
8614,UTTARAKHAND,2011,35,SOCIETAL ISSUES,0,0,1,2,0,3,0,0,0,0,0,0,0,0,0,0,0,0,3
467,UTTARAKHAND,2012,35,CAUSES NOT KNOWN,2,19,37,21,6,85,4,30,11,8,4,57,0,0,0,0,0,0,142
1013,UTTARAKHAND,2012,35,DEATH OF DEAR PERSON,0,0,0,0,0,0,0,0,0,0,0,0,0,0,0,0,0,0,0
1559,UTTARAKHAND,2012,35,DOWRY DISPUTE,0,0,0,0,0,0,0,0,0,0,0,0,0,0,0,0,0,0,0
2105,UTTARAKHAND,2012,35,DRUG ABUSE,1,2,5,0,0,8,0,0,0,0,0,0,0,0,0,0,0,0,8
2651,UTTARAKHAND,2012,35,ECONOMIC ISSUES,0,3,7,4,0,14,0,3,1,0,0,4,0,0,0,0,0,0,18
3197,UTTARAKHAND,2012,35,EXAM FAILURE,0,4,0,0,0,4,0,2,0,0,0,2,0,0,0,0,0,0,6
3743,UTTARAKHAND,2012,35,FAMILY PROBLEMS,0,23,17,7,3,50,3,24,15,3,1,46,0,0,0,0,0,0,96
4289,UTTARAKHAND,2012,35,HEALTH ISSUES,3,2,4,2,4,15,0,6,2,1,2,11,0,0,0,0,0,0,26
4834,UTTARAKHAND,2012,35,HERO WORSHIP,0,0,0,0,0,0,0,0,0,0,0,0,0,0,0,0,0,0,0
5379,UTTARAKHAND,2012,35,ILLEGITIMATE PREGNANCY,0,0,0,0,0,0,0,0,0,0,0,0,0,0,0,0,0,0,0
5924,UTTARAKHAND,2012,35,LOVE AFFAIRS,0,9,2,0,0,11,0,4,0,0,0,4,0,0,0,0,0,0,15
6470,UTTARAKHAND,2012,35,MARITAL ISSUES,0,2,1,0,0,3,1,5,2,0,0,8,0,0,0,0,0,0,11
7016,UTTARAKHAND,2012,35,MENTAL HEALTH,0,1,3,5,0,9,0,0,0,0,0,0,0,0,0,0,0,0,9
7562,UTTARAKHAND,2012,35,OTHERS,1,8,30,7,3,49,1,26,16,0,0,43,0,0,0,0,0,0,92
8146,UTTARAKHAND,2012,35,"PHYSICAL ABUSE (RAPE,INCEST ETC.)",0,0,0,0,0,0,0,0,0,0,0,0,0,0,0,0,0,0,0
8653,UTTARAKHAND,2012,35,SOCIETAL ISSUES,0,0,0,1,0,1,0,0,0,0,0,0,0,0,0,0,0,0,1
506,UTTARAKHAND,2013,35,CAUSES NOT KNOWN,0,16,19,8,4,47,3,9,18,1,1,32,0,0,0,0,0,0,79
1052,UTTARAKHAND,2013,35,DEATH OF DEAR PERSON,0,0,0,0,0,0,0,0,0,0,0,0,0,0,0,0,0,0,0
1598,UTTARAKHAND,2013,35,DOWRY DISPUTE,0,1,0,0,0,1,0,5,4,0,0,9,0,0,0,0,0,0,10
2144,UTTARAKHAND,2013,35,DRUG ABUSE,0,9,3,2,0,14,0,0,0,0,0,0,0,0,0,0,0,0,14
2690,UTTARAKHAND,2013,35,ECONOMIC ISSUES,0,13,8,9,0,30,0,0,0,0,0,0,0,0,0,0,0,0,30
3236,UTTARAKHAND,2013,35,EXAM FAILURE,2,9,12,2,0,25,0,7,5,1,0,13,0,0,0,0,0,0,38
3782,UTTARAKHAND,2013,35,FAMILY PROBLEMS,2,20,24,11,3,60,3,18,4,10,1,36,0,0,0,0,0,0,96
4328,UTTARAKHAND,2013,35,HEALTH ISSUES,0,9,11,2,3,25,0,0,0,0,0,0,0,0,0,0,0,0,25
4873,UTTARAKHAND,2013,35,HERO WORSHIP,0,0,0,0,0,0,0,0,0,0,0,0,0,0,0,0,0,0,0
5418,UTTARAKHAND,2013,35,ILLEGITIMATE PREGNANCY,0,0,0,0,0,0,0,0,0,0,0,0,0,0,0,0,0,0,0
5963,UTTARAKHAND,2013,35,LOVE AFFAIRS,0,7,1,0,0,8,0,6,0,0,0,6,0,0,0,0,0,0,14
6509,UTTARAKHAND,2013,35,MARITAL ISSUES,0,0,0,0,0,0,0,6,5,0,0,11,0,0,0,0,0,0,11
7055,UTTARAKHAND,2013,35,MENTAL HEALTH,0,0,4,1,0,5,0,3,0,0,0,3,0,0,0,0,0,0,8
7601,UTTARAKHAND,2013,35,OTHERS,0,10,10,8,1,29,1,5,2,1,1,10,0,0,0,0,0,0,39
8185,UTTARAKHAND,2013,35,"PHYSICAL ABUSE (RAPE,INCEST ETC.)",0,0,0,0,0,0,0,0,1,0,0,1,0,0,0,0,0,0,1
8692,UTTARAKHAND,2013,35,SOCIETAL ISSUES,0,0,0,0,0,0,0,0,0,0,0,0,0,0,0,0,0,0,0
545,UTTARAKHAND,2014,35,CAUSES NOT KNOWN,0,8,0,0,0,8,0,0,0,0,0,0,0,0,0,0,0,0,8
1091,UTTARAKHAND,2014,35,DEATH OF DEAR PERSON,0,0,0,0,0,0,0,0,0,0,0,0,0,0,0,0,0,0,0
1637,UTTARAKHAND,2014,35,DOWRY DISPUTE,0,0,0,0,0,0,0,0,0,0,0,0,0,0,0,0,0,0,0
2183,UTTARAKHAND,2014,35,DRUG ABUSE,0,0,0,0,0,0,0,0,0,0,0,0,0,0,0,0,0,0,0
2729,UTTARAKHAND,2014,35,ECONOMIC ISSUES,0,15,1,0,0,16,0,0,0,0,0,0,0,0,0,0,0,0,16
3275,UTTARAKHAND,2014,35,EXAM FAILURE,0,3,1,0,0,4,0,4,0,0,0,4,0,0,0,0,0,0,8
3821,UTTARAKHAND,2014,35,FAMILY PROBLEMS,0,14,5,2,0,21,0,1,4,0,0,5,0,0,0,0,0,0,26
4367,UTTARAKHAND,2014,35,HEALTH ISSUES,0,1,0,0,0,1,0,2,1,0,0,3,0,0,0,0,0,0,4
4912,UTTARAKHAND,2014,35,HERO WORSHIP,0,0,0,0,0,0,0,0,0,0,0,0,0,0,0,0,0,0,0
5457,UTTARAKHAND,2014,35,ILLEGITIMATE PREGNANCY,0,0,0,0,0,0,0,0,0,0,0,0,0,0,0,0,0,0,0
6002,UTTARAKHAND,2014,35,LOVE AFFAIRS,0,0,0,0,0,0,0,1,0,0,0,1,0,0,0,0,0,0,1
6548,UTTARAKHAND,2014,35,MARITAL ISSUES,0,14,2,0,0,16,0,5,2,0,0,7,0,0,0,0,0,0,23
7094,UTTARAKHAND,2014,35,MENTAL HEALTH,0,1,0,0,0,1,0,2,1,0,0,3,0,0,0,0,0,0,4
7640,UTTARAKHAND,2014,35,OTHERS,1,62,22,9,6,100,1,27,10,3,0,41,0,0,0,0,0,0,141
7679,UTTARAKHAND,2014,35,PHYSICAL ABUSE,0,0,0,0,0,0,0,0,0,0,0,0,0,0,0,0,0,0,0
8731,UTTARAKHAND,2014,35,SOCIETAL ISSUES,0,0,0,0,0,0,0,0,0,0,0,0,0,0,0,0,0,0,0
39,WEST BENGAL,2001,36,CAUSES NOT KNOWN,111,494,792,480,153,2030,120,600,567,296,114,1697,0,0,0,0,0,0,3727
585,WEST BENGAL,2001,36,DEATH OF DEAR PERSON,1,23,17,23,23,87,4,17,12,16,7,56,0,0,0,0,0,0,143
1131,WEST BENGAL,2001,36,DOWRY DISPUTE,0,0,0,0,0,0,0,142,121,2,0,265,0,0,0,0,0,0,265
1677,WEST BENGAL,2001,36,DRUG ABUSE,10,34,68,41,1,154,0,6,6,3,0,15,0,0,0,0,0,0,169
2223,WEST BENGAL,2001,36,ECONOMIC ISSUES,3,137,248,204,73,665,0,54,87,29,24,194,0,0,0,0,0,0,859
2769,WEST BENGAL,2001,36,EXAM FAILURE,77,201,6,0,0,284,34,175,0,0,0,209,0,0,0,0,0,0,493
3315,WEST BENGAL,2001,36,FAMILY PROBLEMS,5,281,452,334,118,1190,3,324,369,228,93,1017,0,0,0,0,0,0,2207
3861,WEST BENGAL,2001,36,HEALTH ISSUES,3,169,184,329,139,824,2,88,168,223,61,542,0,0,0,0,0,0,1366
4407,WEST BENGAL,2001,36,HERO WORSHIP,0,7,1,5,0,13,0,0,0,0,0,0,0,0,0,0,0,0,13
4952,WEST BENGAL,2001,36,ILLEGITIMATE PREGNANCY,0,0,0,0,0,0,1,45,29,3,0,78,0,0,0,0,0,0,78
5497,WEST BENGAL,2001,36,LOVE AFFAIRS,5,179,50,0,0,234,41,163,46,0,0,250,0,0,0,0,0,0,484
6042,WEST BENGAL,2001,36,MARITAL ISSUES,0,113,127,52,11,303,2,215,195,54,0,466,0,0,0,0,0,0,769
6588,WEST BENGAL,2001,36,MENTAL HEALTH,8,58,82,111,33,292,2,31,40,56,34,163,0,0,0,0,0,0,455
7134,WEST BENGAL,2001,36,OTHERS,60,323,368,438,150,1339,73,380,364,253,130,1200,0,0,0,0,0,0,2539
7719,WEST BENGAL,2001,36,"PHYSICAL ABUSE (RAPE,INCEST ETC.)",0,0,0,0,0,0,1,13,5,0,0,19,0,0,0,0,0,0,19
8225,WEST BENGAL,2001,36,SOCIETAL ISSUES,0,8,31,29,12,80,0,1,6,7,10,24,0,0,0,0,0,0,104
78,WEST BENGAL,2002,36,CAUSES NOT KNOWN,120,654,662,454,156,2046,102,450,571,302,88,1513,0,0,0,0,0,0,3559
624,WEST BENGAL,2002,36,DEATH OF DEAR PERSON,1,18,15,13,6,53,2,25,18,13,0,58,0,0,0,0,0,0,111
1170,WEST BENGAL,2002,36,DOWRY DISPUTE,0,0,0,0,0,0,0,153,112,21,0,286,0,0,0,0,0,0,286
1716,WEST BENGAL,2002,36,DRUG ABUSE,0,37,52,23,0,112,0,0,0,0,0,0,0,0,0,0,0,0,112
2262,WEST BENGAL,2002,36,ECONOMIC ISSUES,0,69,192,170,44,475,0,15,34,26,14,89,0,0,0,0,0,0,564
2808,WEST BENGAL,2002,36,EXAM FAILURE,61,220,7,0,0,288,68,183,8,0,0,259,0,0,0,0,0,0,547
3354,WEST BENGAL,2002,36,FAMILY PROBLEMS,16,366,569,283,91,1325,29,390,407,226,71,1123,0,0,0,0,0,0,2448
3900,WEST BENGAL,2002,36,HEALTH ISSUES,4,114,177,224,138,657,1,40,113,179,60,393,0,0,0,0,0,0,1050
4446,WEST BENGAL,2002,36,HERO WORSHIP,0,0,0,0,0,0,0,0,0,0,0,0,0,0,0,0,0,0,0
4991,WEST BENGAL,2002,36,ILLEGITIMATE PREGNANCY,0,0,0,0,0,0,3,40,34,2,0,79,0,0,0,0,0,0,79
5536,WEST BENGAL,2002,36,LOVE AFFAIRS,0,219,87,2,0,308,18,202,72,0,0,292,0,0,0,0,0,0,600
6081,WEST BENGAL,2002,36,MARITAL ISSUES,0,104,109,75,5,293,0,210,179,80,0,469,0,0,0,0,0,0,762
6627,WEST BENGAL,2002,36,MENTAL HEALTH,6,86,129,127,31,379,7,67,80,55,27,236,0,0,0,0,0,0,615
7173,WEST BENGAL,2002,36,OTHERS,75,321,328,327,85,1136,64,369,345,169,94,1041,0,0,0,0,0,0,2177
7758,WEST BENGAL,2002,36,"PHYSICAL ABUSE (RAPE,INCEST ETC.)",0,0,0,0,0,0,0,6,3,0,0,9,0,0,0,0,0,0,9
8264,WEST BENGAL,2002,36,SOCIETAL ISSUES,0,7,27,13,5,52,0,8,12,11,5,36,0,0,0,0,0,0,88
117,WEST BENGAL,2003,36,CAUSES NOT KNOWN,22,406,348,232,100,1108,39,248,239,170,46,742,0,0,0,0,0,0,1850
663,WEST BENGAL,2003,36,DEATH OF DEAR PERSON,0,48,37,32,6,123,0,28,15,6,0,49,0,0,0,0,0,0,172
1209,WEST BENGAL,2003,36,DOWRY DISPUTE,0,0,0,0,0,0,0,196,145,0,0,341,0,0,0,0,0,0,341
1755,WEST BENGAL,2003,36,DRUG ABUSE,0,9,5,5,0,19,0,0,0,0,0,0,0,0,0,0,0,0,19
2301,WEST BENGAL,2003,36,ECONOMIC ISSUES,0,78,273,181,36,568,0,27,63,56,12,158,0,0,0,0,0,0,726
2847,WEST BENGAL,2003,36,EXAM FAILURE,25,244,27,0,0,296,42,352,12,0,0,406,0,0,0,0,0,0,702
3393,WEST BENGAL,2003,36,FAMILY PROBLEMS,1,649,835,624,204,2313,0,426,517,397,185,1525,0,0,0,0,0,0,3838
3939,WEST BENGAL,2003,36,HEALTH ISSUES,0,71,191,200,106,568,0,61,164,164,72,461,0,0,0,0,0,0,1029
4485,WEST BENGAL,2003,36,HERO WORSHIP,0,5,4,1,0,10,0,0,0,0,0,0,0,0,0,0,0,0,10
5030,WEST BENGAL,2003,36,ILLEGITIMATE PREGNANCY,0,0,0,0,0,0,0,34,20,5,0,59,0,0,0,0,0,0,59
5575,WEST BENGAL,2003,36,LOVE AFFAIRS,0,362,221,1,0,584,5,345,127,0,0,477,0,0,0,0,0,0,1061
6120,WEST BENGAL,2003,36,MARITAL ISSUES,0,93,150,34,0,277,0,235,214,66,0,515,0,0,0,0,0,0,792
6666,WEST BENGAL,2003,36,MENTAL HEALTH,0,100,166,150,57,473,0,55,132,127,49,363,0,0,0,0,0,0,836
7212,WEST BENGAL,2003,36,OTHERS,13,319,350,306,70,1058,12,251,241,171,26,701,0,0,0,0,0,0,1759
7797,WEST BENGAL,2003,36,"PHYSICAL ABUSE (RAPE,INCEST ETC.)",0,0,5,3,0,8,0,11,4,4,0,19,0,0,0,0,0,0,27
8303,WEST BENGAL,2003,36,SOCIETAL ISSUES,0,12,6,1,0,19,0,13,2,25,0,40,0,0,0,0,0,0,59
156,WEST BENGAL,2004,36,CAUSES NOT KNOWN,70,527,762,605,122,2086,49,523,414,204,52,1242,0,0,0,0,0,0,3328
702,WEST BENGAL,2004,36,DEATH OF DEAR PERSON,1,24,21,10,10,66,2,12,10,6,1,31,0,0,0,0,0,0,97
1248,WEST BENGAL,2004,36,DOWRY DISPUTE,0,0,0,0,0,0,0,307,102,2,0,411,0,0,0,0,0,0,411
1794,WEST BENGAL,2004,36,DRUG ABUSE,0,27,21,7,0,55,0,2,0,0,0,2,0,0,0,0,0,0,57
2340,WEST BENGAL,2004,36,ECONOMIC ISSUES,0,129,189,123,48,489,0,51,49,32,8,140,0,0,0,0,0,0,629
2886,WEST BENGAL,2004,36,EXAM FAILURE,76,243,15,0,0,334,119,172,0,0,0,291,0,0,0,0,0,0,625
3432,WEST BENGAL,2004,36,FAMILY PROBLEMS,14,448,635,381,94,1572,9,387,517,274,69,1256,0,0,0,0,0,0,2828
3978,WEST BENGAL,2004,36,HEALTH ISSUES,2,84,170,257,133,646,0,48,143,150,63,404,0,0,0,0,0,0,1050
4524,WEST BENGAL,2004,36,HERO WORSHIP,0,0,0,0,0,0,0,0,0,0,0,0,0,0,0,0,0,0,0
5069,WEST BENGAL,2004,36,ILLEGITIMATE PREGNANCY,0,0,0,0,0,0,3,25,19,0,0,47,0,0,0,0,0,0,47
5614,WEST BENGAL,2004,36,LOVE AFFAIRS,4,320,95,2,0,421,7,268,186,2,0,463,0,0,0,0,0,0,884
6159,WEST BENGAL,2004,36,MARITAL ISSUES,0,70,70,21,0,161,0,191,125,15,0,331,0,0,0,0,0,0,492
6705,WEST BENGAL,2004,36,MENTAL HEALTH,17,48,105,149,90,409,4,41,63,52,12,172,0,0,0,0,0,0,581
7251,WEST BENGAL,2004,36,OTHERS,100,432,444,351,66,1393,96,335,296,171,47,945,0,0,0,0,0,0,2338
7836,WEST BENGAL,2004,36,"PHYSICAL ABUSE (RAPE,INCEST ETC.)",0,0,0,0,0,0,0,3,5,0,0,8,0,0,0,0,0,0,8
8342,WEST BENGAL,2004,36,SOCIETAL ISSUES,0,3,23,3,0,29,0,5,7,8,0,20,0,0,0,0,0,0,49
195,WEST BENGAL,2005,36,CAUSES NOT KNOWN,52,663,535,462,57,1769,32,373,270,281,28,984,0,0,0,0,0,0,2753
741,WEST BENGAL,2005,36,DEATH OF DEAR PERSON,0,8,49,9,3,69,0,17,42,16,0,75,0,0,0,0,0,0,144
1287,WEST BENGAL,2005,36,DOWRY DISPUTE,0,0,0,0,0,0,0,302,167,0,0,469,0,0,0,0,0,0,469
1833,WEST BENGAL,2005,36,DRUG ABUSE,0,35,39,12,0,86,0,1,3,0,0,4,0,0,0,0,0,0,90
2379,WEST BENGAL,2005,36,ECONOMIC ISSUES,0,85,329,305,52,771,0,38,79,49,6,172,0,0,0,0,0,0,943
2925,WEST BENGAL,2005,36,EXAM FAILURE,77,263,2,0,0,342,122,115,3,0,0,240,0,0,0,0,0,0,582
3471,WEST BENGAL,2005,36,FAMILY PROBLEMS,3,435,535,384,73,1430,1,606,433,267,96,1403,0,0,0,0,0,0,2833
4017,WEST BENGAL,2005,36,HEALTH ISSUES,4,38,144,219,147,552,0,19,92,126,75,312,0,0,0,0,0,0,864
4563,WEST BENGAL,2005,36,HERO WORSHIP,0,2,0,0,0,2,0,0,0,0,0,0,0,0,0,0,0,0,2
5108,WEST BENGAL,2005,36,ILLEGITIMATE PREGNANCY,0,0,0,0,0,0,0,23,12,0,0,35,0,0,0,0,0,0,35
5653,WEST BENGAL,2005,36,LOVE AFFAIRS,17,286,165,4,0,472,29,413,119,6,0,567,0,0,0,0,0,0,1039
6198,WEST BENGAL,2005,36,MARITAL ISSUES,0,58,54,25,0,137,0,175,170,45,0,390,0,0,0,0,0,0,527
6744,WEST BENGAL,2005,36,MENTAL HEALTH,0,81,139,153,99,472,1,72,72,84,34,263,0,0,0,0,0,0,735
7290,WEST BENGAL,2005,36,OTHERS,61,779,759,337,56,1992,20,497,386,261,53,1217,0,0,0,0,0,0,3209
7875,WEST BENGAL,2005,36,"PHYSICAL ABUSE (RAPE,INCEST ETC.)",0,0,0,0,0,0,0,5,0,0,0,5,0,0,0,0,0,0,5
8381,WEST BENGAL,2005,36,SOCIETAL ISSUES,0,229,151,98,42,520,0,124,71,43,27,265,0,0,0,0,0,0,785
234,WEST BENGAL,2006,36,CAUSES NOT KNOWN,26,448,451,244,49,1218,15,219,177,102,27,540,0,0,0,0,0,0,1758
780,WEST BENGAL,2006,36,DEATH OF DEAR PERSON,0,14,64,43,11,132,0,27,26,62,5,120,0,0,0,0,0,0,252
1326,WEST BENGAL,2006,36,DOWRY DISPUTE,0,0,0,0,0,0,0,299,146,0,0,445,0,0,0,0,0,0,445
1872,WEST BENGAL,2006,36,DRUG ABUSE,0,41,96,10,3,150,0,0,7,0,0,7,0,0,0,0,0,0,157
2418,WEST BENGAL,2006,36,ECONOMIC ISSUES,0,199,440,404,26,1069,0,38,136,175,5,354,0,0,0,0,0,0,1423
2964,WEST BENGAL,2006,36,EXAM FAILURE,110,310,0,0,0,420,151,115,0,0,0,266,0,0,0,0,0,0,686
3510,WEST BENGAL,2006,36,FAMILY PROBLEMS,4,1032,1465,751,175,3427,3,1329,788,511,89,2720,0,0,0,0,0,0,6147
4056,WEST BENGAL,2006,36,HEALTH ISSUES,2,117,217,213,152,701,0,43,92,163,71,369,0,0,0,0,0,0,1070
4601,WEST BENGAL,2006,36,HERO WORSHIP,3,4,6,0,0,13,0,0,0,0,0,0,0,0,0,0,0,0,13
5146,WEST BENGAL,2006,36,ILLEGITIMATE PREGNANCY,0,0,0,0,0,0,0,51,44,5,0,100,0,0,0,0,0,0,100
5691,WEST BENGAL,2006,36,LOVE AFFAIRS,4,515,270,1,0,790,15,555,172,1,0,743,0,0,0,0,0,0,1533
6237,WEST BENGAL,2006,36,MARITAL ISSUES,0,65,76,17,0,158,0,220,171,45,0,436,0,0,0,0,0,0,594
6783,WEST BENGAL,2006,36,MENTAL HEALTH,0,237,275,135,134,781,0,79,93,127,70,369,0,0,0,0,0,0,1150
7329,WEST BENGAL,2006,36,OTHERS,1,23,6,8,6,44,0,3,4,3,3,13,0,0,0,0,0,0,57
7913,WEST BENGAL,2006,36,"PHYSICAL ABUSE (RAPE,INCEST ETC.)",0,0,0,0,0,0,0,15,36,0,0,51,0,0,0,0,0,0,51
8420,WEST BENGAL,2006,36,SOCIETAL ISSUES,0,32,109,67,9,217,0,5,21,40,6,72,0,0,0,0,0,0,289
273,WEST BENGAL,2007,36,CAUSES NOT KNOWN,73,787,833,403,112,2208,61,485,382,216,36,1180,0,0,0,0,0,0,3388
819,WEST BENGAL,2007,36,DEATH OF DEAR PERSON,4,11,1,0,3,19,8,6,10,6,1,31,0,0,0,0,0,0,50
1365,WEST BENGAL,2007,36,DOWRY DISPUTE,0,0,0,0,0,0,0,579,396,24,0,999,0,0,0,0,0,0,999
1911,WEST BENGAL,2007,36,DRUG ABUSE,0,22,36,20,3,81,0,0,0,0,0,0,0,0,0,0,0,0,81
2457,WEST BENGAL,2007,36,ECONOMIC ISSUES,0,280,495,168,28,971,0,36,55,48,10,149,0,0,0,0,0,0,1120
3003,WEST BENGAL,2007,36,EXAM FAILURE,48,152,5,0,0,205,38,105,1,0,0,144,0,0,0,0,0,0,349
3549,WEST BENGAL,2007,36,FAMILY PROBLEMS,20,541,830,458,92,1941,19,447,513,265,47,1291,0,0,0,0,0,0,3232
4095,WEST BENGAL,2007,36,HEALTH ISSUES,2,76,126,249,145,598,3,60,119,124,54,360,0,0,0,0,0,0,958
4640,WEST BENGAL,2007,36,HERO WORSHIP,0,0,0,0,0,0,0,0,0,0,0,0,0,0,0,0,0,0,0
5185,WEST BENGAL,2007,36,ILLEGITIMATE PREGNANCY,0,0,0,0,0,0,2,29,11,1,0,43,0,0,0,0,0,0,43
5730,WEST BENGAL,2007,36,LOVE AFFAIRS,9,200,71,3,3,286,21,278,88,2,0,389,0,0,0,0,0,0,675
6276,WEST BENGAL,2007,36,MARITAL ISSUES,1,114,140,35,2,292,1,253,205,53,7,519,0,0,0,0,0,0,811
6822,WEST BENGAL,2007,36,MENTAL HEALTH,2,148,271,345,36,802,8,174,220,153,21,576,0,0,0,0,0,0,1378
7368,WEST BENGAL,2007,36,OTHERS,58,307,370,249,67,1051,41,267,151,111,56,626,0,0,0,0,0,0,1677
7952,WEST BENGAL,2007,36,"PHYSICAL ABUSE (RAPE,INCEST ETC.)",0,0,0,0,0,0,0,6,0,5,0,11,0,0,0,0,0,0,11
8459,WEST BENGAL,2007,36,SOCIETAL ISSUES,0,8,28,10,5,51,0,5,27,5,0,37,0,0,0,0,0,0,88
312,WEST BENGAL,2008,36,CAUSES NOT KNOWN,82,789,823,352,117,2163,58,496,389,221,41,1205,0,0,0,0,0,0,3368
858,WEST BENGAL,2008,36,DEATH OF DEAR PERSON,4,12,2,0,2,20,5,174,8,4,0,191,0,0,0,0,0,0,211
1404,WEST BENGAL,2008,36,DOWRY DISPUTE,0,1,0,0,0,1,0,485,255,21,0,761,0,0,0,0,0,0,762
1950,WEST BENGAL,2008,36,DRUG ABUSE,0,36,44,19,2,101,0,0,0,0,0,0,0,0,0,0,0,0,101
2496,WEST BENGAL,2008,36,ECONOMIC ISSUES,0,196,345,124,7,672,1,30,47,23,4,105,0,0,0,0,0,0,777
3042,WEST BENGAL,2008,36,EXAM FAILURE,44,123,8,0,0,175,41,100,3,3,0,147,0,0,0,0,0,0,322
3588,WEST BENGAL,2008,36,FAMILY PROBLEMS,49,541,841,372,49,1852,30,479,493,195,36,1233,0,0,0,0,0,0,3085
4134,WEST BENGAL,2008,36,HEALTH ISSUES,5,65,129,195,108,502,3,36,100,129,45,313,0,0,0,0,0,0,815
4679,WEST BENGAL,2008,36,HERO WORSHIP,0,0,0,0,0,0,0,0,0,0,0,0,0,0,0,0,0,0,0
5224,WEST BENGAL,2008,36,ILLEGITIMATE PREGNANCY,0,0,0,0,0,0,1,32,11,1,0,45,0,0,0,0,0,0,45
5769,WEST BENGAL,2008,36,LOVE AFFAIRS,9,272,89,2,0,372,35,297,87,1,0,420,0,0,0,0,0,0,792
6315,WEST BENGAL,2008,36,MARITAL ISSUES,0,87,78,33,0,198,4,160,127,14,8,313,0,0,0,0,0,0,511
6861,WEST BENGAL,2008,36,MENTAL HEALTH,9,132,287,275,36,739,13,173,285,173,19,663,0,0,0,0,0,0,1402
7407,WEST BENGAL,2008,36,OTHERS,73,546,652,209,42,1522,49,516,335,111,23,1034,0,0,0,0,0,0,2556
7991,WEST BENGAL,2008,36,"PHYSICAL ABUSE (RAPE,INCEST ETC.)",0,0,0,0,0,0,1,19,3,5,0,28,0,0,0,0,0,0,28
8498,WEST BENGAL,2008,36,SOCIETAL ISSUES,0,6,29,12,5,52,0,7,17,1,0,25,0,0,0,0,0,0,77
351,WEST BENGAL,2009,36,CAUSES NOT KNOWN,116,700,1240,498,130,2684,66,524,532,209,36,1367,0,0,0,0,0,0,4051
897,WEST BENGAL,2009,36,DEATH OF DEAR PERSON,5,12,3,2,9,31,7,12,14,5,2,40,0,0,0,0,0,0,71
1443,WEST BENGAL,2009,36,DOWRY DISPUTE,0,0,0,0,0,0,9,459,237,21,0,726,0,0,0,0,0,0,726
1989,WEST BENGAL,2009,36,DRUG ABUSE,0,32,21,16,0,69,0,0,0,0,0,0,0,0,0,0,0,0,69
2535,WEST BENGAL,2009,36,ECONOMIC ISSUES,2,258,464,273,29,1026,0,48,30,14,9,101,0,0,0,0,0,0,1127
3081,WEST BENGAL,2009,36,EXAM FAILURE,34,96,15,0,0,145,37,87,6,0,0,130,0,0,0,0,0,0,275
3627,WEST BENGAL,2009,36,FAMILY PROBLEMS,21,535,817,434,48,1855,16,621,543,245,58,1483,0,0,0,0,0,0,3338
4173,WEST BENGAL,2009,36,HEALTH ISSUES,3,47,105,175,91,421,0,55,85,79,33,252,0,0,0,0,0,0,673
4718,WEST BENGAL,2009,36,HERO WORSHIP,0,0,2,0,0,2,0,0,0,0,0,0,0,0,0,0,0,0,2
5263,WEST BENGAL,2009,36,ILLEGITIMATE PREGNANCY,0,0,0,0,0,0,3,24,1,0,0,28,0,0,0,0,0,0,28
5808,WEST BENGAL,2009,36,LOVE AFFAIRS,13,281,86,9,0,389,37,294,92,0,0,423,0,0,0,0,0,0,812
6354,WEST BENGAL,2009,36,MARITAL ISSUES,0,42,55,30,2,129,1,121,104,31,2,259,0,0,0,0,0,0,388
6900,WEST BENGAL,2009,36,MENTAL HEALTH,7,113,256,319,46,741,11,170,250,167,18,616,0,0,0,0,0,0,1357
7446,WEST BENGAL,2009,36,OTHERS,33,264,311,212,102,922,30,283,203,103,38,657,0,0,0,0,0,0,1579
8030,WEST BENGAL,2009,36,"PHYSICAL ABUSE (RAPE,INCEST ETC.)",0,0,0,0,0,0,1,2,0,0,0,3,0,0,0,0,0,0,3
8537,WEST BENGAL,2009,36,SOCIETAL ISSUES,1,27,34,12,6,80,0,25,34,10,0,69,0,0,0,0,0,0,149
390,WEST BENGAL,2010,36,CAUSES NOT KNOWN,105,786,1094,658,219,2862,51,460,586,385,83,1565,0,0,0,0,0,0,4427
936,WEST BENGAL,2010,36,DEATH OF DEAR PERSON,5,25,10,9,9,58,11,15,5,10,3,44,0,0,0,0,0,0,102
1482,WEST BENGAL,2010,36,DOWRY DISPUTE,0,0,0,0,0,0,0,467,299,1,0,767,0,0,0,0,0,0,767
2028,WEST BENGAL,2010,36,DRUG ABUSE,1,15,27,25,11,79,0,2,0,0,0,2,0,0,0,0,0,0,81
2574,WEST BENGAL,2010,36,ECONOMIC ISSUES,0,248,372,164,23,807,0,46,72,27,11,156,0,0,0,0,0,0,963
3120,WEST BENGAL,2010,36,EXAM FAILURE,30,167,5,0,0,202,40,167,3,0,0,210,0,0,0,0,0,0,412
3666,WEST BENGAL,2010,36,FAMILY PROBLEMS,28,332,773,443,74,1650,20,418,487,265,42,1232,0,0,0,0,0,0,2882
4212,WEST BENGAL,2010,36,HEALTH ISSUES,5,35,101,151,57,349,5,36,85,97,29,252,0,0,0,0,0,0,601
4757,WEST BENGAL,2010,36,HERO WORSHIP,0,0,1,0,0,1,0,5,0,0,0,5,0,0,0,0,0,0,6
5302,WEST BENGAL,2010,36,ILLEGITIMATE PREGNANCY,0,0,0,0,0,0,2,16,5,0,0,23,0,0,0,0,0,0,23
5847,WEST BENGAL,2010,36,LOVE AFFAIRS,14,273,118,12,0,417,22,269,74,3,0,368,0,0,0,0,0,0,785
6393,WEST BENGAL,2010,36,MARITAL ISSUES,0,69,48,18,0,135,0,170,119,25,1,315,0,0,0,0,0,0,450
6939,WEST BENGAL,2010,36,MENTAL HEALTH,17,145,367,424,42,995,4,232,283,205,38,762,0,0,0,0,0,0,1757
7485,WEST BENGAL,2010,36,OTHERS,61,573,546,389,120,1689,57,309,337,208,83,994,0,0,0,0,0,0,2683
8069,WEST BENGAL,2010,36,"PHYSICAL ABUSE (RAPE,INCEST ETC.)",0,0,0,0,0,0,0,4,2,0,0,6,0,0,0,0,0,0,6
8576,WEST BENGAL,2010,36,SOCIETAL ISSUES,2,8,33,11,3,57,0,10,20,5,0,35,0,0,0,0,0,0,92
429,WEST BENGAL,2011,36,CAUSES NOT KNOWN,158,833,1108,642,363,3104,98,511,617,390,182,1798,0,0,0,0,0,0,4902
975,WEST BENGAL,2011,36,DEATH OF DEAR PERSON,6,13,5,10,1,35,7,6,6,4,1,24,0,0,0,0,0,0,59
1521,WEST BENGAL,2011,36,DOWRY DISPUTE,0,0,0,0,0,0,0,551,320,59,0,930,0,0,0,0,0,0,930
2067,WEST BENGAL,2011,36,DRUG ABUSE,0,18,36,27,13,94,0,0,0,0,0,0,0,0,0,0,0,0,94
2613,WEST BENGAL,2011,36,ECONOMIC ISSUES,0,176,522,222,16,936,10,78,102,73,27,290,0,0,0,0,0,0,1226
3159,WEST BENGAL,2011,36,EXAM FAILURE,15,206,16,0,0,237,20,113,8,0,0,141,0,0,0,0,0,0,378
3705,WEST BENGAL,2011,36,FAMILY PROBLEMS,12,393,860,512,92,1869,15,387,480,245,51,1178,0,0,0,0,0,0,3047
4251,WEST BENGAL,2011,36,HEALTH ISSUES,0,39,82,126,69,316,3,17,78,71,42,211,0,0,0,0,0,0,527
4796,WEST BENGAL,2011,36,HERO WORSHIP,0,0,0,0,0,0,0,0,0,0,0,0,0,0,0,0,0,0,0
5341,WEST BENGAL,2011,36,ILLEGITIMATE PREGNANCY,0,0,0,0,0,0,1,22,7,1,0,31,0,0,0,0,0,0,31
5886,WEST BENGAL,2011,36,LOVE AFFAIRS,10,290,138,23,0,461,19,345,102,14,0,480,0,0,0,0,0,0,941
6432,WEST BENGAL,2011,36,MARITAL ISSUES,0,116,111,45,3,275,0,179,126,29,1,335,0,0,0,0,0,0,610
6978,WEST BENGAL,2011,36,MENTAL HEALTH,0,104,259,335,35,733,5,145,259,139,17,565,0,0,0,0,0,0,1298
7524,WEST BENGAL,2011,36,OTHERS,83,324,634,338,136,1515,80,335,204,131,89,839,0,0,0,0,0,0,2354
8108,WEST BENGAL,2011,36,"PHYSICAL ABUSE (RAPE,INCEST ETC.)",0,0,0,0,0,0,0,5,2,0,0,7,0,0,0,0,0,0,7
8615,WEST BENGAL,2011,36,SOCIETAL ISSUES,0,9,21,16,3,49,0,19,15,5,0,39,0,0,0,0,0,0,88
468,WEST BENGAL,2012,36,CAUSES NOT KNOWN,0,0,0,0,0,0,0,0,0,0,0,0,0,0,0,0,0,0,0
1014,WEST BENGAL,2012,36,DEATH OF DEAR PERSON,0,0,0,0,0,0,0,0,0,0,0,0,0,0,0,0,0,0,0
1560,WEST BENGAL,2012,36,DOWRY DISPUTE,0,0,0,0,0,0,0,0,0,0,0,0,0,0,0,0,0,0,0
2106,WEST BENGAL,2012,36,DRUG ABUSE,0,0,0,0,0,0,0,0,0,0,0,0,0,0,0,0,0,0,0
2652,WEST BENGAL,2012,36,ECONOMIC ISSUES,0,0,0,0,0,0,0,0,0,0,0,0,0,0,0,0,0,0,0
3198,WEST BENGAL,2012,36,EXAM FAILURE,0,0,0,0,0,0,0,0,0,0,0,0,0,0,0,0,0,0,0
3744,WEST BENGAL,2012,36,FAMILY PROBLEMS,0,0,0,0,0,0,0,0,0,0,0,0,0,0,0,0,0,0,0
4290,WEST BENGAL,2012,36,HEALTH ISSUES,0,0,0,0,0,0,0,0,0,0,0,0,0,0,0,0,0,0,0
4835,WEST BENGAL,2012,36,HERO WORSHIP,0,0,0,0,0,0,0,0,0,0,0,0,0,0,0,0,0,0,0
5380,WEST BENGAL,2012,36,ILLEGITIMATE PREGNANCY,0,0,0,0,0,0,0,0,0,0,0,0,0,0,0,0,0,0,0
5925,WEST BENGAL,2012,36,LOVE AFFAIRS,0,0,0,0,0,0,0,0,0,0,0,0,0,0,0,0,0,0,0
6471,WEST BENGAL,2012,36,MARITAL ISSUES,0,0,0,0,0,0,0,0,0,0,0,0,0,0,0,0,0,0,0
7017,WEST BENGAL,2012,36,MENTAL HEALTH,0,0,0,0,0,0,0,0,0,0,0,0,0,0,0,0,0,0,0
7563,WEST BENGAL,2012,36,OTHERS,0,0,0,0,0,0,0,0,0,0,0,0,0,0,0,0,0,0,0
8147,WEST BENGAL,2012,36,"PHYSICAL ABUSE (RAPE,INCEST ETC.)",0,0,0,0,0,0,0,0,0,0,0,0,0,0,0,0,0,0,0
8654,WEST BENGAL,2012,36,SOCIETAL ISSUES,0,0,0,0,0,0,0,0,0,0,0,0,0,0,0,0,0,0,0
507,WEST BENGAL,2013,36,CAUSES NOT KNOWN,72,553,683,498,80,1886,25,332,368,228,46,999,0,0,0,0,0,0,2885
1053,WEST BENGAL,2013,36,DEATH OF DEAR PERSON,0,3,2,5,2,12,0,3,1,1,1,6,0,0,0,0,0,0,18
1599,WEST BENGAL,2013,36,DOWRY DISPUTE,0,0,0,3,0,3,0,318,192,32,2,544,0,0,0,0,0,0,547
2145,WEST BENGAL,2013,36,DRUG ABUSE,0,12,13,17,12,54,0,0,0,0,0,0,0,0,0,0,0,0,54
2691,WEST BENGAL,2013,36,ECONOMIC ISSUES,0,121,200,105,13,439,0,60,55,19,0,134,0,0,0,0,0,0,573
3237,WEST BENGAL,2013,36,EXAM FAILURE,13,108,3,0,0,124,9,89,4,0,0,102,0,0,0,0,0,0,226
3783,WEST BENGAL,2013,36,FAMILY PROBLEMS,14,294,685,423,108,1524,15,325,416,192,52,1000,0,0,0,0,0,0,2524
4329,WEST BENGAL,2013,36,HEALTH ISSUES,1,26,95,82,69,273,3,46,72,57,41,219,0,0,0,0,0,0,492
4874,WEST BENGAL,2013,36,HERO WORSHIP,0,0,0,0,0,0,0,0,0,0,0,0,0,0,0,0,0,0,0
5419,WEST BENGAL,2013,36,ILLEGITIMATE PREGNANCY,0,0,0,0,0,0,0,10,2,1,0,13,0,0,0,0,0,0,13
5964,WEST BENGAL,2013,36,LOVE AFFAIRS,22,197,132,18,0,369,15,180,62,9,0,266,0,0,0,0,0,0,635
6510,WEST BENGAL,2013,36,MARITAL ISSUES,0,90,68,24,8,190,0,68,59,24,7,158,0,0,0,0,0,0,348
7056,WEST BENGAL,2013,36,MENTAL HEALTH,1,111,135,172,41,460,9,106,125,119,19,378,0,0,0,0,0,0,838
7602,WEST BENGAL,2013,36,OTHERS,61,771,923,600,150,2505,38,464,564,208,74,1348,0,0,0,0,0,0,3853
8186,WEST BENGAL,2013,36,"PHYSICAL ABUSE (RAPE,INCEST ETC.)",0,0,0,0,0,0,0,3,2,0,0,5,0,0,0,0,0,0,5
8693,WEST BENGAL,2013,36,SOCIETAL ISSUES,0,4,8,5,4,21,0,10,7,4,2,23,0,0,0,0,0,0,44
546,WEST BENGAL,2014,36,CAUSES NOT KNOWN,54,913,774,428,168,2337,33,642,289,130,59,1153,0,0,0,0,0,0,3490
1092,WEST BENGAL,2014,36,DEATH OF DEAR PERSON,0,3,5,9,2,19,0,3,3,3,2,11,0,0,0,0,0,0,30
1638,WEST BENGAL,2014,36,DOWRY DISPUTE,0,0,0,0,0,0,0,302,145,8,0,455,0,0,0,0,0,0,455
2184,WEST BENGAL,2014,36,DRUG ABUSE,0,17,10,10,5,42,0,0,0,2,0,2,0,0,0,0,0,0,44
2730,WEST BENGAL,2014,36,ECONOMIC ISSUES,0,127,175,91,9,402,0,35,18,0,2,55,0,0,0,0,0,0,457
3276,WEST BENGAL,2014,36,EXAM FAILURE,29,86,2,0,0,117,6,36,10,0,0,52,0,0,0,0,0,0,169
3822,WEST BENGAL,2014,36,FAMILY PROBLEMS,33,545,524,299,80,1481,12,503,338,130,35,1018,0,0,0,0,0,0,2499
4368,WEST BENGAL,2014,36,HEALTH ISSUES,46,366,271,230,153,1066,2,196,169,114,62,543,0,0,0,0,0,0,1609
4913,WEST BENGAL,2014,36,HERO WORSHIP,0,0,0,0,0,0,0,0,0,0,0,0,0,0,0,0,0,0,0
5458,WEST BENGAL,2014,36,ILLEGITIMATE PREGNANCY,0,0,0,0,0,0,0,17,2,0,0,19,0,0,0,0,0,0,19
6003,WEST BENGAL,2014,36,LOVE AFFAIRS,0,156,28,15,0,199,8,209,28,1,0,246,0,0,0,0,0,0,445
6549,WEST BENGAL,2014,36,MARITAL ISSUES,1,206,166,34,10,417,1,745,376,27,4,1153,0,0,0,0,0,0,1570
7095,WEST BENGAL,2014,36,MENTAL HEALTH,42,210,121,86,31,490,2,128,75,30,16,251,0,0,0,0,0,0,741
7641,WEST BENGAL,2014,36,OTHERS,43,1231,1349,524,192,3339,40,822,664,142,65,1733,0,0,0,0,0,0,5072
7680,WEST BENGAL,2014,36,PHYSICAL ABUSE,0,0,0,0,0,0,1,1,0,0,0,2,0,0,0,0,0,0,2
8732,WEST BENGAL,2014,36,SOCIETAL ISSUES,0,11,27,9,3,50,0,17,10,5,2,34,0,0,0,0,0,0,84