STATE.UT,id,Year,CAUSE,Male,Female,Total
A & N ISLANDS,1,2001,No Education,7,4,11
A & N ISLANDS,1,2001,Primary,20,7,27
A & N ISLANDS,1,2001,Middle,39,33,72
A & N ISLANDS,1,2001,Matriculate/Secondary,10,6,16
A & N ISLANDS,1,2001,Hr. Secondary/Intermediate/Pre-University,2,0,2
A & N ISLANDS,1,2001,Diploma,0,0,0
A & N ISLANDS,1,2001,Graduate,1,0,1
A & N ISLANDS,1,2001,Post Graduate and Above,0,0,0
A & N ISLANDS,1,2002,No Education,0,0,0
A & N ISLANDS,1,2002,Primary,15,0,15
A & N ISLANDS,1,2002,Middle,55,45,100
A & N ISLANDS,1,2002,Matriculate/Secondary,17,5,22
A & N ISLANDS,1,2002,Hr. Secondary/Intermediate/Pre-University,1,3,4
A & N ISLANDS,1,2002,Diploma,0,0,0
A & N ISLANDS,1,2002,Graduate,2,0,2
A & N ISLANDS,1,2002,Post Graduate and Above,1,0,1
A & N ISLANDS,1,2003,No Education,2,1,3
A & N ISLANDS,1,2003,Primary,5,1,6
A & N ISLANDS,1,2003,Middle,42,17,59
A & N ISLANDS,1,2003,Matriculate/Secondary,15,21,36
A & N ISLANDS,1,2003,Hr. Secondary/Intermediate/Pre-University,4,1,5
A & N ISLANDS,1,2003,Diploma,0,0,0
A & N ISLANDS,1,2003,Graduate,2,2,4
A & N ISLANDS,1,2003,Post Graduate and Above,0,0,0
A & N ISLANDS,1,2004,No Education,5,1,6
A & N ISLANDS,1,2004,Primary,17,7,24
A & N ISLANDS,1,2004,Middle,30,18,48
A & N ISLANDS,1,2004,Matriculate/Secondary,19,10,29
A & N ISLANDS,1,2004,Hr. Secondary/Intermediate/Pre-University,9,5,14
A & N ISLANDS,1,2004,Diploma,0,0,0
A & N ISLANDS,1,2004,Graduate,1,0,1
A & N ISLANDS,1,2004,Post Graduate and Above,0,0,0
A & N ISLANDS,1,2005,No Education,15,4,19
A & N ISLANDS,1,2005,Primary,22,14,36
A & N ISLANDS,1,2005,Middle,37,14,51
A & N ISLANDS,1,2005,Matriculate/Secondary,8,18,26
A & N ISLANDS,1,2005,Hr. Secondary/Intermediate/Pre-University,3,2,5
A & N ISLANDS,1,2005,Diploma,0,0,0
A & N ISLANDS,1,2005,Graduate,1,1,2
A & N ISLANDS,1,2005,Post Graduate and Above,0,0,0
A & N ISLANDS,1,2006,No Education,8,2,10
A & N ISLANDS,1,2006,Primary,38,14,52
A & N ISLANDS,1,2006,Middle,43,14,57
A & N ISLANDS,1,2006,Matriculate/Secondary,5,7,12
A & N ISLANDS,1,2006,Hr. Secondary/Intermediate/Pre-University,2,0,2
A & N ISLANDS,1,2006,Diploma,0,0,0
A & N ISLANDS,1,2006,Graduate,0,0,0
A & N ISLANDS,1,2006,Post Graduate and Above,0,0,0
A & N ISLANDS,1,2007,No Education,19,8,27
A & N ISLANDS,1,2007,Primary,10,4,14
A & N ISLANDS,1,2007,Middle,30,10,40
A & N ISLANDS,1,2007,Matriculate/Secondary,33,27,60
A & N ISLANDS,1,2007,Hr. Secondary/Intermediate/Pre-University,7,6,13
A & N ISLANDS,1,2007,Diploma,0,0,0
A & N ISLANDS,1,2007,Graduate,1,1,2
A & N ISLANDS,1,2007,Post Graduate and Above,0,0,0
A & N ISLANDS,1,2008,No Education,11,4,15
A & N ISLANDS,1,2008,Primary,6,6,12
A & N ISLANDS,1,2008,Middle,28,12,40
A & N ISLANDS,1,2008,Matriculate/Secondary,36,13,49
A & N ISLANDS,1,2008,Hr. Secondary/Intermediate/Pre-University,17,9,26
A & N ISLANDS,1,2008,Diploma,0,0,0
A & N ISLANDS,1,2008,Graduate,0,0,0
A & N ISLANDS,1,2008,Post Graduate and Above,0,1,1
A & N ISLANDS,1,2009,No Education,2,1,3
A & N ISLANDS,1,2009,Primary,8,1,9
A & N ISLANDS,1,2009,Middle,43,27,70
A & N ISLANDS,1,2009,Matriculate/Secondary,29,13,42
A & N ISLANDS,1,2009,Hr. Secondary/Intermediate/Pre-University,4,2,6
A & N ISLANDS,1,2009,Diploma,0,0,0
A & N ISLANDS,1,2009,Graduate,0,1,1
A & N ISLANDS,1,2009,Post Graduate and Above,0,0,0
A & N ISLANDS,1,2010,No Education,17,6,23
A & N ISLANDS,1,2010,Primary,24,4,28
A & N ISLANDS,1,2010,Middle,29,8,37
A & N ISLANDS,1,2010,Matriculate/Secondary,31,16,47
A & N ISLANDS,1,2010,Hr. Secondary/Intermediate/Pre-University,11,10,21
A & N ISLANDS,1,2010,Diploma,0,0,0
A & N ISLANDS,1,2010,Graduate,0,0,0
A & N ISLANDS,1,2010,Post Graduate and Above,0,0,0
A & N ISLANDS,1,2011,No Education,3,1,4
A & N ISLANDS,1,2011,Primary,27,10,37
A & N ISLANDS,1,2011,Middle,25,9,34
A & N ISLANDS,1,2011,Matriculate/Secondary,19,12,31
A & N ISLANDS,1,2011,Hr. Secondary/Intermediate/Pre-University,16,9,25
A & N ISLANDS,1,2011,Diploma,2,1,3
A & N ISLANDS,1,2011,Graduate,1,0,1
A & N ISLANDS,1,2011,Post Graduate and Above,1,0,1
A & N ISLANDS,1,2012,No Education,0,0,0
A & N ISLANDS,1,2012,Primary,16,4,20
A & N ISLANDS,1,2012,Middle,42,22,64
A & N ISLANDS,1,2012,Matriculate/Secondary,21,13,34
A & N ISLANDS,1,2012,Hr. Secondary/Intermediate/Pre-University,1,2,3
A & N ISLANDS,1,2012,Diploma,0,0,0
A & N ISLANDS,1,2012,Graduate,0,0,0
A & N ISLANDS,1,2012,Post Graduate and Above,0,0,0
A & N ISLANDS,1,2013,No Education,0,0,0
A & N ISLANDS,1,2013,Primary,23,6,29
A & N ISLANDS,1,2013,Middle,46,12,58
A & N ISLANDS,1,2013,Matriculate/Secondary,26,12,38
A & N ISLANDS,1,2013,Hr. Secondary/Intermediate/Pre-University,15,7,22
A & N ISLANDS,1,2013,Diploma,0,0,0
A & N ISLANDS,1,2013,Graduate,1,3,4
A & N ISLANDS,1,2013,Post Graduate and Above,0,0,0
A & N ISLANDS,1,2014,No Education,0,0,0
A & N ISLANDS,1,2014,Primary,24,16,40
A & N ISLANDS,1,2014,Middle,91,15,106
A & N ISLANDS,1,2014,Matriculate/Secondary,0,5,5
A & N ISLANDS,1,2014,Hr. Secondary/Intermediate/Pre-University,0,0,0
A & N ISLANDS,1,2014,Diploma,0,0,0
A & N ISLANDS,1,2014,Graduate,0,4,4
A & N ISLANDS,1,2014,Post Graduate and Above,0,0,0
ANDHRA PRADESH,2,2001,No Education,2117,1657,3774
ANDHRA PRADESH,2,2001,Primary,1536,1076,2612
ANDHRA PRADESH,2,2001,Middle,1281,722,2003
ANDHRA PRADESH,2,2001,Matriculate/Secondary,818,449,1267
ANDHRA PRADESH,2,2001,Hr. Secondary/Intermediate/Pre-University,427,168,595
ANDHRA PRADESH,2,2001,Diploma,75,23,98
ANDHRA PRADESH,2,2001,Graduate,104,42,146
ANDHRA PRADESH,2,2001,Post Graduate and Above,21,6,27
ANDHRA PRADESH,2,2002,No Education,2505,1700,4205
ANDHRA PRADESH,2,2002,Primary,1723,929,2652
ANDHRA PRADESH,2,2002,Middle,1731,832,2563
ANDHRA PRADESH,2,2002,Matriculate/Secondary,965,443,1408
ANDHRA PRADESH,2,2002,Hr. Secondary/Intermediate/Pre-University,496,170,666
ANDHRA PRADESH,2,2002,Diploma,28,19,47
ANDHRA PRADESH,2,2002,Graduate,100,25,125
ANDHRA PRADESH,2,2002,Post Graduate and Above,23,4,27
ANDHRA PRADESH,2,2003,No Education,2738,1505,4243
ANDHRA PRADESH,2,2003,Primary,1845,930,2775
ANDHRA PRADESH,2,2003,Middle,1528,838,2366
ANDHRA PRADESH,2,2003,Matriculate/Secondary,809,353,1162
ANDHRA PRADESH,2,2003,Hr. Secondary/Intermediate/Pre-University,406,197,603
ANDHRA PRADESH,2,2003,Diploma,62,11,73
ANDHRA PRADESH,2,2003,Graduate,101,53,154
ANDHRA PRADESH,2,2003,Post Graduate and Above,24,9,33
ANDHRA PRADESH,2,2004,No Education,2937,1843,4780
ANDHRA PRADESH,2,2004,Primary,2057,995,3052
ANDHRA PRADESH,2,2004,Middle,2203,906,3109
ANDHRA PRADESH,2,2004,Matriculate/Secondary,1157,417,1574
ANDHRA PRADESH,2,2004,Hr. Secondary/Intermediate/Pre-University,511,222,733
ANDHRA PRADESH,2,2004,Diploma,68,15,83
ANDHRA PRADESH,2,2004,Graduate,135,40,175
ANDHRA PRADESH,2,2004,Post Graduate and Above,14,6,20
ANDHRA PRADESH,2,2005,No Education,2761,1685,4446
ANDHRA PRADESH,2,2005,Primary,2340,1074,3414
ANDHRA PRADESH,2,2005,Middle,2247,1026,3273
ANDHRA PRADESH,2,2005,Matriculate/Secondary,796,438,1234
ANDHRA PRADESH,2,2005,Hr. Secondary/Intermediate/Pre-University,557,298,855
ANDHRA PRADESH,2,2005,Diploma,36,16,52
ANDHRA PRADESH,2,2005,Graduate,111,34,145
ANDHRA PRADESH,2,2005,Post Graduate and Above,17,6,23
ANDHRA PRADESH,2,2006,No Education,2913,1788,4701
ANDHRA PRADESH,2,2006,Primary,1899,922,2821
ANDHRA PRADESH,2,2006,Middle,2180,949,3129
ANDHRA PRADESH,2,2006,Matriculate/Secondary,1096,455,1551
ANDHRA PRADESH,2,2006,Hr. Secondary/Intermediate/Pre-University,563,232,795
ANDHRA PRADESH,2,2006,Diploma,77,21,98
ANDHRA PRADESH,2,2006,Graduate,120,36,156
ANDHRA PRADESH,2,2006,Post Graduate and Above,15,10,25
ANDHRA PRADESH,2,2007,No Education,3183,1922,5105
ANDHRA PRADESH,2,2007,Primary,2339,1112,3451
ANDHRA PRADESH,2,2007,Middle,2336,1127,3463
ANDHRA PRADESH,2,2007,Matriculate/Secondary,1195,466,1661
ANDHRA PRADESH,2,2007,Hr. Secondary/Intermediate/Pre-University,661,237,898
ANDHRA PRADESH,2,2007,Diploma,81,14,95
ANDHRA PRADESH,2,2007,Graduate,114,43,157
ANDHRA PRADESH,2,2007,Post Graduate and Above,40,12,52
ANDHRA PRADESH,2,2008,No Education,2999,1687,4686
ANDHRA PRADESH,2,2008,Primary,2094,1104,3198
ANDHRA PRADESH,2,2008,Middle,1869,875,2744
ANDHRA PRADESH,2,2008,Matriculate/Secondary,1396,596,1992
ANDHRA PRADESH,2,2008,Hr. Secondary/Intermediate/Pre-University,965,276,1241
ANDHRA PRADESH,2,2008,Diploma,94,18,112
ANDHRA PRADESH,2,2008,Graduate,235,62,297
ANDHRA PRADESH,2,2008,Post Graduate and Above,69,15,84
ANDHRA PRADESH,2,2009,No Education,2844,1659,4503
ANDHRA PRADESH,2,2009,Primary,2234,967,3201
ANDHRA PRADESH,2,2009,Middle,1919,900,2819
ANDHRA PRADESH,2,2009,Matriculate/Secondary,1653,669,2322
ANDHRA PRADESH,2,2009,Hr. Secondary/Intermediate/Pre-University,755,277,1032
ANDHRA PRADESH,2,2009,Diploma,124,35,159
ANDHRA PRADESH,2,2009,Graduate,257,84,341
ANDHRA PRADESH,2,2009,Post Graduate and Above,101,22,123
ANDHRA PRADESH,2,2010,No Education,3115,1700,4815
ANDHRA PRADESH,2,2010,Primary,2465,1273,3738
ANDHRA PRADESH,2,2010,Middle,2097,884,2981
ANDHRA PRADESH,2,2010,Matriculate/Secondary,1775,598,2373
ANDHRA PRADESH,2,2010,Hr. Secondary/Intermediate/Pre-University,875,309,1184
ANDHRA PRADESH,2,2010,Diploma,104,40,144
ANDHRA PRADESH,2,2010,Graduate,379,121,500
ANDHRA PRADESH,2,2010,Post Graduate and Above,137,29,166
ANDHRA PRADESH,2,2011,No Education,3015,1724,4739
ANDHRA PRADESH,2,2011,Primary,1979,1007,2986
ANDHRA PRADESH,2,2011,Middle,2327,1028,3355
ANDHRA PRADESH,2,2011,Matriculate/Secondary,1484,642,2126
ANDHRA PRADESH,2,2011,Hr. Secondary/Intermediate/Pre-University,873,450,1323
ANDHRA PRADESH,2,2011,Diploma,136,30,166
ANDHRA PRADESH,2,2011,Graduate,263,60,323
ANDHRA PRADESH,2,2011,Post Graduate and Above,43,16,59
ANDHRA PRADESH,2,2012,No Education,3311,1630,4941
ANDHRA PRADESH,2,2012,Primary,1949,1080,3029
ANDHRA PRADESH,2,2012,Middle,1880,859,2739
ANDHRA PRADESH,2,2012,Matriculate/Secondary,1296,636,1932
ANDHRA PRADESH,2,2012,Hr. Secondary/Intermediate/Pre-University,541,333,874
ANDHRA PRADESH,2,2012,Diploma,110,28,138
ANDHRA PRADESH,2,2012,Graduate,402,126,528
ANDHRA PRADESH,2,2012,Post Graduate and Above,38,19,57
ANDHRA PRADESH,2,2013,No Education,3127,1704,4831
ANDHRA PRADESH,2,2013,Primary,1895,892,2787
ANDHRA PRADESH,2,2013,Middle,1760,759,2519
ANDHRA PRADESH,2,2013,Matriculate/Secondary,1605,704,2309
ANDHRA PRADESH,2,2013,Hr. Secondary/Intermediate/Pre-University,795,399,1194
ANDHRA PRADESH,2,2013,Diploma,104,53,157
ANDHRA PRADESH,2,2013,Graduate,555,165,720
ANDHRA PRADESH,2,2013,Post Graduate and Above,61,29,90
ANDHRA PRADESH,2,2014,No Education,927,470,1397
ANDHRA PRADESH,2,2014,Primary,743,385,1128
ANDHRA PRADESH,2,2014,Middle,630,343,973
ANDHRA PRADESH,2,2014,Matriculate/Secondary,657,306,963
ANDHRA PRADESH,2,2014,Hr. Secondary/Intermediate/Pre-University,395,150,545
ANDHRA PRADESH,2,2014,Diploma,77,16,93
ANDHRA PRADESH,2,2014,Graduate,174,39,213
ANDHRA PRADESH,2,2014,Post Graduate and Above,16,4,20
ARUNACHAL PRADESH,3,2001,No Education,14,10,24
ARUNACHAL PRADESH,3,2001,Primary,19,12,31
ARUNACHAL PRADESH,3,2001,Middle,19,11,30
ARUNACHAL PRADESH,3,2001,Matriculate/Secondary,21,2,23
ARUNACHAL PRADESH,3,2001,Hr. Secondary/Intermediate/Pre-University,1,0,1
ARUNACHAL PRADESH,3,2001,Diploma,0,0,0
ARUNACHAL PRADESH,3,2001,Graduate,1,0,1
ARUNACHAL PRADESH,3,2001,Post Graduate and Above,1,0,1
ARUNACHAL PRADESH,3,2002,No Education,18,18,36
ARUNACHAL PRADESH,3,2002,Primary,22,12,34
ARUNACHAL PRADESH,3,2002,Middle,17,12,29
ARUNACHAL PRADESH,3,2002,Matriculate/Secondary,14,1,15
ARUNACHAL PRADESH,3,2002,Hr. Secondary/Intermediate/Pre-University,0,0,0
ARUNACHAL PRADESH,3,2002,Diploma,0,0,0
ARUNACHAL PRADESH,3,2002,Graduate,0,0,0
ARUNACHAL PRADESH,3,2002,Post Graduate and Above,0,0,0
ARUNACHAL PRADESH,3,2003,No Education,16,8,24
ARUNACHAL PRADESH,3,2003,Primary,6,6,12
ARUNACHAL PRADESH,3,2003,Middle,15,5,20
ARUNACHAL PRADESH,3,2003,Matriculate/Secondary,14,8,22
ARUNACHAL PRADESH,3,2003,Hr. Secondary/Intermediate/Pre-University,1,0,1
ARUNACHAL PRADESH,3,2003,Diploma,1,0,1
ARUNACHAL PRADESH,3,2003,Graduate,1,0,1
ARUNACHAL PRADESH,3,2003,Post Graduate and Above,0,0,0
ARUNACHAL PRADESH,3,2004,No Education,15,12,27
ARUNACHAL PRADESH,3,2004,Primary,14,9,23
ARUNACHAL PRADESH,3,2004,Middle,17,4,21
ARUNACHAL PRADESH,3,2004,Matriculate/Secondary,3,5,8
ARUNACHAL PRADESH,3,2004,Hr. Secondary/Intermediate/Pre-University,0,0,0
ARUNACHAL PRADESH,3,2004,Diploma,0,0,0
ARUNACHAL PRADESH,3,2004,Graduate,0,0,0
ARUNACHAL PRADESH,3,2004,Post Graduate and Above,0,0,0
ARUNACHAL PRADESH,3,2005,No Education,14,6,20
ARUNACHAL PRADESH,3,2005,Primary,14,9,23
ARUNACHAL PRADESH,3,2005,Middle,10,4,14
ARUNACHAL PRADESH,3,2005,Matriculate/Secondary,8,2,10
ARUNACHAL PRADESH,3,2005,Hr. Secondary/Intermediate/Pre-University,2,0,2
ARUNACHAL PRADESH,3,2005,Diploma,0,0,0
ARUNACHAL PRADESH,3,2005,Graduate,1,0,1
ARUNACHAL PRADESH,3,2005,Post Graduate and Above,0,0,0
ARUNACHAL PRADESH,3,2006,No Education,19,11,30
ARUNACHAL PRADESH,3,2006,Primary,8,5,13
ARUNACHAL PRADESH,3,2006,Middle,25,7,32
ARUNACHAL PRADESH,3,2006,Matriculate/Secondary,37,7,44
ARUNACHAL PRADESH,3,2006,Hr. Secondary/Intermediate/Pre-University,6,3,9
ARUNACHAL PRADESH,3,2006,Diploma,0,0,0
ARUNACHAL PRADESH,3,2006,Graduate,0,0,0
ARUNACHAL PRADESH,3,2006,Post Graduate and Above,1,0,1
ARUNACHAL PRADESH,3,2007,No Education,31,6,37
ARUNACHAL PRADESH,3,2007,Primary,14,13,27
ARUNACHAL PRADESH,3,2007,Middle,27,8,35
ARUNACHAL PRADESH,3,2007,Matriculate/Secondary,7,2,9
ARUNACHAL PRADESH,3,2007,Hr. Secondary/Intermediate/Pre-University,17,2,19
ARUNACHAL PRADESH,3,2007,Diploma,0,0,0
ARUNACHAL PRADESH,3,2007,Graduate,2,0,2
ARUNACHAL PRADESH,3,2007,Post Graduate and Above,0,0,0
ARUNACHAL PRADESH,3,2008,No Education,12,10,22
ARUNACHAL PRADESH,3,2008,Primary,28,11,39
ARUNACHAL PRADESH,3,2008,Middle,24,10,34
ARUNACHAL PRADESH,3,2008,Matriculate/Secondary,13,1,14
ARUNACHAL PRADESH,3,2008,Hr. Secondary/Intermediate/Pre-University,0,1,1
ARUNACHAL PRADESH,3,2008,Diploma,0,0,0
ARUNACHAL PRADESH,3,2008,Graduate,0,0,0
ARUNACHAL PRADESH,3,2008,Post Graduate and Above,0,0,0
ARUNACHAL PRADESH,3,2009,No Education,12,10,22
ARUNACHAL PRADESH,3,2009,Primary,28,11,39
ARUNACHAL PRADESH,3,2009,Middle,24,10,34
ARUNACHAL PRADESH,3,2009,Matriculate/Secondary,13,1,14
ARUNACHAL PRADESH,3,2009,Hr. Secondary/Intermediate/Pre-University,0,1,1
ARUNACHAL PRADESH,3,2009,Diploma,0,0,0
ARUNACHAL PRADESH,3,2009,Graduate,0,0,0
ARUNACHAL PRADESH,3,2009,Post Graduate and Above,0,0,0
ARUNACHAL PRADESH,3,2010,No Education,17,5,22
ARUNACHAL PRADESH,3,2010,Primary,20,13,33
ARUNACHAL PRADESH,3,2010,Middle,15,4,19
ARUNACHAL PRADESH,3,2010,Matriculate/Secondary,25,12,37
ARUNACHAL PRADESH,3,2010,Hr. Secondary/Intermediate/Pre-University,12,6,18
ARUNACHAL PRADESH,3,2010,Diploma,1,0,1
ARUNACHAL PRADESH,3,2010,Graduate,1,0,1
ARUNACHAL PRADESH,3,2010,Post Graduate and Above,0,0,0
ARUNACHAL PRADESH,3,2011,No Education,21,12,33
ARUNACHAL PRADESH,3,2011,Primary,24,11,35
ARUNACHAL PRADESH,3,2011,Middle,29,7,36
ARUNACHAL PRADESH,3,2011,Matriculate/Secondary,20,4,24
ARUNACHAL PRADESH,3,2011,Hr. Secondary/Intermediate/Pre-University,5,0,5
ARUNACHAL PRADESH,3,2011,Diploma,0,0,0
ARUNACHAL PRADESH,3,2011,Graduate,0,1,1
ARUNACHAL PRADESH,3,2011,Post Graduate and Above,0,0,0
ARUNACHAL PRADESH,3,2012,No Education,25,5,30
ARUNACHAL PRADESH,3,2012,Primary,27,8,35
ARUNACHAL PRADESH,3,2012,Middle,19,8,27
ARUNACHAL PRADESH,3,2012,Matriculate/Secondary,20,6,26
ARUNACHAL PRADESH,3,2012,Hr. Secondary/Intermediate/Pre-University,4,0,4
ARUNACHAL PRADESH,3,2012,Diploma,0,0,0
ARUNACHAL PRADESH,3,2012,Graduate,1,1,2
ARUNACHAL PRADESH,3,2012,Post Graduate and Above,4,2,6
ARUNACHAL PRADESH,3,2013,No Education,46,19,65
ARUNACHAL PRADESH,3,2013,Primary,42,14,56
ARUNACHAL PRADESH,3,2013,Middle,37,14,51
ARUNACHAL PRADESH,3,2013,Matriculate/Secondary,33,5,38
ARUNACHAL PRADESH,3,2013,Hr. Secondary/Intermediate/Pre-University,11,5,16
ARUNACHAL PRADESH,3,2013,Diploma,0,0,0
ARUNACHAL PRADESH,3,2013,Graduate,2,1,3
ARUNACHAL PRADESH,3,2013,Post Graduate and Above,0,0,0
ARUNACHAL PRADESH,3,2014,No Education,25,13,38
ARUNACHAL PRADESH,3,2014,Primary,12,0,12
ARUNACHAL PRADESH,3,2014,Middle,14,10,24
ARUNACHAL PRADESH,3,2014,Matriculate/Secondary,11,10,21
ARUNACHAL PRADESH,3,2014,Hr. Secondary/Intermediate/Pre-University,11,7,18
ARUNACHAL PRADESH,3,2014,Diploma,2,0,2
ARUNACHAL PRADESH,3,2014,Graduate,5,0,5
ARUNACHAL PRADESH,3,2014,Post Graduate and Above,1,0,1
ASSAM,4,2001,No Education,350,182,532
ASSAM,4,2001,Primary,542,269,811
ASSAM,4,2001,Middle,497,244,741
ASSAM,4,2001,Matriculate/Secondary,311,66,377
ASSAM,4,2001,Hr. Secondary/Intermediate/Pre-University,110,46,156
ASSAM,4,2001,Diploma,3,0,3
ASSAM,4,2001,Graduate,23,4,27
ASSAM,4,2001,Post Graduate and Above,0,0,0
ASSAM,4,2002,No Education,379,215,594
ASSAM,4,2002,Primary,414,214,628
ASSAM,4,2002,Middle,553,264,817
ASSAM,4,2002,Matriculate/Secondary,275,87,362
ASSAM,4,2002,Hr. Secondary/Intermediate/Pre-University,62,23,85
ASSAM,4,2002,Diploma,4,0,4
ASSAM,4,2002,Graduate,9,3,12
ASSAM,4,2002,Post Graduate and Above,6,2,8
ASSAM,4,2003,No Education,238,191,429
ASSAM,4,2003,Primary,510,259,769
ASSAM,4,2003,Middle,420,245,665
ASSAM,4,2003,Matriculate/Secondary,290,97,387
ASSAM,4,2003,Hr. Secondary/Intermediate/Pre-University,174,86,260
ASSAM,4,2003,Diploma,14,6,20
ASSAM,4,2003,Graduate,20,17,37
ASSAM,4,2003,Post Graduate and Above,10,19,29
ASSAM,4,2004,No Education,318,172,490
ASSAM,4,2004,Primary,406,187,593
ASSAM,4,2004,Middle,485,305,790
ASSAM,4,2004,Matriculate/Secondary,497,124,621
ASSAM,4,2004,Hr. Secondary/Intermediate/Pre-University,196,78,274
ASSAM,4,2004,Diploma,11,3,14
ASSAM,4,2004,Graduate,20,9,29
ASSAM,4,2004,Post Graduate and Above,12,16,28
ASSAM,4,2005,No Education,358,239,597
ASSAM,4,2005,Primary,453,211,664
ASSAM,4,2005,Middle,605,242,847
ASSAM,4,2005,Matriculate/Secondary,350,145,495
ASSAM,4,2005,Hr. Secondary/Intermediate/Pre-University,130,41,171
ASSAM,4,2005,Diploma,37,10,47
ASSAM,4,2005,Graduate,16,7,23
ASSAM,4,2005,Post Graduate and Above,2,0,2
ASSAM,4,2006,No Education,407,195,602
ASSAM,4,2006,Primary,445,169,614
ASSAM,4,2006,Middle,825,381,1206
ASSAM,4,2006,Matriculate/Secondary,345,134,479
ASSAM,4,2006,Hr. Secondary/Intermediate/Pre-University,72,32,104
ASSAM,4,2006,Diploma,11,1,12
ASSAM,4,2006,Graduate,11,3,14
ASSAM,4,2006,Post Graduate and Above,0,0,0
ASSAM,4,2007,No Education,305,199,504
ASSAM,4,2007,Primary,398,176,574
ASSAM,4,2007,Middle,841,386,1227
ASSAM,4,2007,Matriculate/Secondary,378,137,515
ASSAM,4,2007,Hr. Secondary/Intermediate/Pre-University,144,41,185
ASSAM,4,2007,Diploma,19,3,22
ASSAM,4,2007,Graduate,27,3,30
ASSAM,4,2007,Post Graduate and Above,4,1,5
ASSAM,4,2008,No Education,485,301,786
ASSAM,4,2008,Primary,395,233,628
ASSAM,4,2008,Middle,605,284,889
ASSAM,4,2008,Matriculate/Secondary,318,137,455
ASSAM,4,2008,Hr. Secondary/Intermediate/Pre-University,114,51,165
ASSAM,4,2008,Diploma,19,8,27
ASSAM,4,2008,Graduate,34,5,39
ASSAM,4,2008,Post Graduate and Above,0,0,0
ASSAM,4,2009,No Education,302,233,535
ASSAM,4,2009,Primary,355,220,575
ASSAM,4,2009,Middle,562,351,913
ASSAM,4,2009,Matriculate/Secondary,426,212,638
ASSAM,4,2009,Hr. Secondary/Intermediate/Pre-University,185,58,243
ASSAM,4,2009,Diploma,40,5,45
ASSAM,4,2009,Graduate,10,2,12
ASSAM,4,2009,Post Graduate and Above,2,3,5
ASSAM,4,2010,No Education,368,221,589
ASSAM,4,2010,Primary,346,172,518
ASSAM,4,2010,Middle,716,282,998
ASSAM,4,2010,Matriculate/Secondary,362,173,535
ASSAM,4,2010,Hr. Secondary/Intermediate/Pre-University,200,114,314
ASSAM,4,2010,Diploma,13,1,14
ASSAM,4,2010,Graduate,19,4,23
ASSAM,4,2010,Post Graduate and Above,2,0,2
ASSAM,4,2011,No Education,286,199,485
ASSAM,4,2011,Primary,360,230,590
ASSAM,4,2011,Middle,568,289,857
ASSAM,4,2011,Matriculate/Secondary,371,119,490
ASSAM,4,2011,Hr. Secondary/Intermediate/Pre-University,199,51,250
ASSAM,4,2011,Diploma,8,0,8
ASSAM,4,2011,Graduate,32,12,44
ASSAM,4,2011,Post Graduate and Above,2,0,2
ASSAM,4,2012,No Education,265,123,388
ASSAM,4,2012,Primary,398,171,569
ASSAM,4,2012,Middle,719,263,982
ASSAM,4,2012,Matriculate/Secondary,551,193,744
ASSAM,4,2012,Hr. Secondary/Intermediate/Pre-University,368,107,475
ASSAM,4,2012,Diploma,39,5,44
ASSAM,4,2012,Graduate,50,10,60
ASSAM,4,2012,Post Graduate and Above,2,0,2
ASSAM,4,2013,No Education,355,182,537
ASSAM,4,2013,Primary,490,196,686
ASSAM,4,2013,Middle,818,319,1137
ASSAM,4,2013,Matriculate/Secondary,540,165,705
ASSAM,4,2013,Hr. Secondary/Intermediate/Pre-University,318,120,438
ASSAM,4,2013,Diploma,5,2,7
ASSAM,4,2013,Graduate,31,11,42
ASSAM,4,2013,Post Graduate and Above,1,0,1
ASSAM,4,2014,No Education,312,187,499
ASSAM,4,2014,Primary,440,212,652
ASSAM,4,2014,Middle,651,263,914
ASSAM,4,2014,Matriculate/Secondary,411,116,527
ASSAM,4,2014,Hr. Secondary/Intermediate/Pre-University,205,56,261
ASSAM,4,2014,Diploma,1,0,1
ASSAM,4,2014,Graduate,2,1,3
ASSAM,4,2014,Post Graduate and Above,0,0,0
BIHAR,5,2001,No Education,85,140,225
BIHAR,5,2001,Primary,46,50,96
BIHAR,5,2001,Middle,64,53,117
BIHAR,5,2001,Matriculate/Secondary,73,35,108
BIHAR,5,2001,Hr. Secondary/Intermediate/Pre-University,24,12,36
BIHAR,5,2001,Diploma,2,3,5
BIHAR,5,2001,Graduate,11,3,14
BIHAR,5,2001,Post Graduate and Above,2,0,2
BIHAR,5,2002,No Education,139,151,290
BIHAR,5,2002,Primary,109,62,171
BIHAR,5,2002,Middle,74,47,121
BIHAR,5,2002,Matriculate/Secondary,76,22,98
BIHAR,5,2002,Hr. Secondary/Intermediate/Pre-University,18,8,26
BIHAR,5,2002,Diploma,5,0,5
BIHAR,5,2002,Graduate,3,2,5
BIHAR,5,2002,Post Graduate and Above,2,2,4
BIHAR,5,2003,No Education,102,100,202
BIHAR,5,2003,Primary,66,40,106
BIHAR,5,2003,Middle,64,42,106
BIHAR,5,2003,Matriculate/Secondary,77,31,108
BIHAR,5,2003,Hr. Secondary/Intermediate/Pre-University,24,22,46
BIHAR,5,2003,Diploma,1,0,1
BIHAR,5,2003,Graduate,16,8,24
BIHAR,5,2003,Post Graduate and Above,1,5,6
BIHAR,5,2004,No Education,63,66,129
BIHAR,5,2004,Primary,38,22,60
BIHAR,5,2004,Middle,47,31,78
BIHAR,5,2004,Matriculate/Secondary,48,14,62
BIHAR,5,2004,Hr. Secondary/Intermediate/Pre-University,14,6,20
BIHAR,5,2004,Diploma,0,0,0
BIHAR,5,2004,Graduate,1,0,1
BIHAR,5,2004,Post Graduate and Above,1,0,1
BIHAR,5,2005,No Education,91,68,159
BIHAR,5,2005,Primary,52,49,101
BIHAR,5,2005,Middle,88,46,134
BIHAR,5,2005,Matriculate/Secondary,61,42,103
BIHAR,5,2005,Hr. Secondary/Intermediate/Pre-University,25,8,33
BIHAR,5,2005,Diploma,3,0,3
BIHAR,5,2005,Graduate,7,3,10
BIHAR,5,2005,Post Graduate and Above,0,0,0
BIHAR,5,2006,No Education,75,143,218
BIHAR,5,2006,Primary,59,62,121
BIHAR,5,2006,Middle,58,34,92
BIHAR,5,2006,Matriculate/Secondary,68,52,120
BIHAR,5,2006,Hr. Secondary/Intermediate/Pre-University,23,17,40
BIHAR,5,2006,Diploma,6,2,8
BIHAR,5,2006,Graduate,10,9,19
BIHAR,5,2006,Post Graduate and Above,0,0,0
BIHAR,5,2007,No Education,131,135,266
BIHAR,5,2007,Primary,96,102,198
BIHAR,5,2007,Middle,91,77,168
BIHAR,5,2007,Matriculate/Secondary,111,82,193
BIHAR,5,2007,Hr. Secondary/Intermediate/Pre-University,56,16,72
BIHAR,5,2007,Diploma,13,6,19
BIHAR,5,2007,Graduate,32,12,44
BIHAR,5,2007,Post Graduate and Above,4,1,5
BIHAR,5,2008,No Education,188,147,335
BIHAR,5,2008,Primary,151,117,268
BIHAR,5,2008,Middle,95,78,173
BIHAR,5,2008,Matriculate/Secondary,122,46,168
BIHAR,5,2008,Hr. Secondary/Intermediate/Pre-University,32,11,43
BIHAR,5,2008,Diploma,2,0,2
BIHAR,5,2008,Graduate,18,7,25
BIHAR,5,2008,Post Graduate and Above,1,0,1
BIHAR,5,2009,No Education,155,166,321
BIHAR,5,2009,Primary,107,139,246
BIHAR,5,2009,Middle,116,136,252
BIHAR,5,2009,Matriculate/Secondary,81,57,138
BIHAR,5,2009,Hr. Secondary/Intermediate/Pre-University,43,33,76
BIHAR,5,2009,Diploma,1,0,1
BIHAR,5,2009,Graduate,10,4,14
BIHAR,5,2009,Post Graduate and Above,1,2,3
BIHAR,5,2010,No Education,291,172,463
BIHAR,5,2010,Primary,95,123,218
BIHAR,5,2010,Middle,144,98,242
BIHAR,5,2010,Matriculate/Secondary,101,57,158
BIHAR,5,2010,Hr. Secondary/Intermediate/Pre-University,44,34,78
BIHAR,5,2010,Diploma,10,8,18
BIHAR,5,2010,Graduate,26,20,46
BIHAR,5,2010,Post Graduate and Above,1,2,3
BIHAR,5,2011,No Education,113,113,226
BIHAR,5,2011,Primary,99,99,198
BIHAR,5,2011,Middle,99,62,161
BIHAR,5,2011,Matriculate/Secondary,63,45,108
BIHAR,5,2011,Hr. Secondary/Intermediate/Pre-University,39,17,56
BIHAR,5,2011,Diploma,4,2,6
BIHAR,5,2011,Graduate,20,4,24
BIHAR,5,2011,Post Graduate and Above,9,7,16
BIHAR,5,2012,No Education,95,83,178
BIHAR,5,2012,Primary,73,71,144
BIHAR,5,2012,Middle,83,61,144
BIHAR,5,2012,Matriculate/Secondary,124,57,181
BIHAR,5,2012,Hr. Secondary/Intermediate/Pre-University,47,17,64
BIHAR,5,2012,Diploma,3,2,5
BIHAR,5,2012,Graduate,20,4,24
BIHAR,5,2012,Post Graduate and Above,10,9,19
BIHAR,5,2013,No Education,127,136,263
BIHAR,5,2013,Primary,150,116,266
BIHAR,5,2013,Middle,168,66,234
BIHAR,5,2013,Matriculate/Secondary,113,55,168
BIHAR,5,2013,Hr. Secondary/Intermediate/Pre-University,38,30,68
BIHAR,5,2013,Diploma,11,12,23
BIHAR,5,2013,Graduate,19,10,29
BIHAR,5,2013,Post Graduate and Above,4,2,6
BIHAR,5,2014,No Education,52,41,93
BIHAR,5,2014,Primary,45,49,94
BIHAR,5,2014,Middle,83,61,144
BIHAR,5,2014,Matriculate/Secondary,110,74,184
BIHAR,5,2014,Hr. Secondary/Intermediate/Pre-University,56,37,93
BIHAR,5,2014,Diploma,30,3,33
BIHAR,5,2014,Graduate,18,4,22
BIHAR,5,2014,Post Graduate and Above,0,0,0
CHANDIGARH,6,2001,No Education,7,11,18
CHANDIGARH,6,2001,Primary,4,6,10
CHANDIGARH,6,2001,Middle,10,8,18
CHANDIGARH,6,2001,Matriculate/Secondary,9,5,14
CHANDIGARH,6,2001,Hr. Secondary/Intermediate/Pre-University,7,1,8
CHANDIGARH,6,2001,Diploma,0,0,0
CHANDIGARH,6,2001,Graduate,2,0,2
CHANDIGARH,6,2001,Post Graduate and Above,0,0,0
CHANDIGARH,6,2002,No Education,7,3,10
CHANDIGARH,6,2002,Primary,8,7,15
CHANDIGARH,6,2002,Middle,12,7,19
CHANDIGARH,6,2002,Matriculate/Secondary,14,9,23
CHANDIGARH,6,2002,Hr. Secondary/Intermediate/Pre-University,9,7,16
CHANDIGARH,6,2002,Diploma,0,0,0
CHANDIGARH,6,2002,Graduate,3,1,4
CHANDIGARH,6,2002,Post Graduate and Above,0,0,0
CHANDIGARH,6,2003,No Education,10,4,14
CHANDIGARH,6,2003,Primary,9,6,15
CHANDIGARH,6,2003,Middle,9,8,17
CHANDIGARH,6,2003,Matriculate/Secondary,37,11,48
CHANDIGARH,6,2003,Hr. Secondary/Intermediate/Pre-University,1,4,5
CHANDIGARH,6,2003,Diploma,0,0,0
CHANDIGARH,6,2003,Graduate,2,2,4
CHANDIGARH,6,2003,Post Graduate and Above,0,0,0
CHANDIGARH,6,2004,No Education,6,7,13
CHANDIGARH,6,2004,Primary,8,1,9
CHANDIGARH,6,2004,Middle,7,1,8
CHANDIGARH,6,2004,Matriculate/Secondary,22,7,29
CHANDIGARH,6,2004,Hr. Secondary/Intermediate/Pre-University,4,3,7
CHANDIGARH,6,2004,Diploma,0,0,0
CHANDIGARH,6,2004,Graduate,4,4,8
CHANDIGARH,6,2004,Post Graduate and Above,1,0,1
CHANDIGARH,6,2005,No Education,11,9,20
CHANDIGARH,6,2005,Primary,6,1,7
CHANDIGARH,6,2005,Middle,12,6,18
CHANDIGARH,6,2005,Matriculate/Secondary,31,6,37
CHANDIGARH,6,2005,Hr. Secondary/Intermediate/Pre-University,0,1,1
CHANDIGARH,6,2005,Diploma,0,0,0
CHANDIGARH,6,2005,Graduate,3,2,5
CHANDIGARH,6,2005,Post Graduate and Above,0,1,1
CHANDIGARH,6,2006,No Education,0,3,3
CHANDIGARH,6,2006,Primary,4,4,8
CHANDIGARH,6,2006,Middle,7,3,10
CHANDIGARH,6,2006,Matriculate/Secondary,19,6,25
CHANDIGARH,6,2006,Hr. Secondary/Intermediate/Pre-University,18,3,21
CHANDIGARH,6,2006,Diploma,1,0,1
CHANDIGARH,6,2006,Graduate,7,5,12
CHANDIGARH,6,2006,Post Graduate and Above,0,0,0
CHANDIGARH,6,2007,No Education,1,2,3
CHANDIGARH,6,2007,Primary,6,1,7
CHANDIGARH,6,2007,Middle,12,3,15
CHANDIGARH,6,2007,Matriculate/Secondary,19,12,31
CHANDIGARH,6,2007,Hr. Secondary/Intermediate/Pre-University,14,1,15
CHANDIGARH,6,2007,Diploma,1,0,1
CHANDIGARH,6,2007,Graduate,7,3,10
CHANDIGARH,6,2007,Post Graduate and Above,0,0,0
CHANDIGARH,6,2008,No Education,6,1,7
CHANDIGARH,6,2008,Primary,6,2,8
CHANDIGARH,6,2008,Middle,14,7,21
CHANDIGARH,6,2008,Matriculate/Secondary,16,7,23
CHANDIGARH,6,2008,Hr. Secondary/Intermediate/Pre-University,11,4,15
CHANDIGARH,6,2008,Diploma,0,0,0
CHANDIGARH,6,2008,Graduate,4,4,8
CHANDIGARH,6,2008,Post Graduate and Above,1,0,1
CHANDIGARH,6,2009,No Education,2,0,2
CHANDIGARH,6,2009,Primary,1,1,2
CHANDIGARH,6,2009,Middle,2,2,4
CHANDIGARH,6,2009,Matriculate/Secondary,24,22,46
CHANDIGARH,6,2009,Hr. Secondary/Intermediate/Pre-University,5,2,7
CHANDIGARH,6,2009,Diploma,0,0,0
CHANDIGARH,6,2009,Graduate,8,3,11
CHANDIGARH,6,2009,Post Graduate and Above,2,1,3
CHANDIGARH,6,2010,No Education,3,0,3
CHANDIGARH,6,2010,Primary,5,2,7
CHANDIGARH,6,2010,Middle,6,13,19
CHANDIGARH,6,2010,Matriculate/Secondary,5,17,22
CHANDIGARH,6,2010,Hr. Secondary/Intermediate/Pre-University,4,5,9
CHANDIGARH,6,2010,Diploma,1,0,1
CHANDIGARH,6,2010,Graduate,6,3,9
CHANDIGARH,6,2010,Post Graduate and Above,1,0,1
CHANDIGARH,6,2011,No Education,2,0,2
CHANDIGARH,6,2011,Primary,3,4,7
CHANDIGARH,6,2011,Middle,8,10,18
CHANDIGARH,6,2011,Matriculate/Secondary,28,25,53
CHANDIGARH,6,2011,Hr. Secondary/Intermediate/Pre-University,6,6,12
CHANDIGARH,6,2011,Diploma,0,0,0
CHANDIGARH,6,2011,Graduate,10,3,13
CHANDIGARH,6,2011,Post Graduate and Above,0,0,0
CHANDIGARH,6,2012,No Education,4,4,8
CHANDIGARH,6,2012,Primary,3,3,6
CHANDIGARH,6,2012,Middle,8,7,15
CHANDIGARH,6,2012,Matriculate/Secondary,38,16,54
CHANDIGARH,6,2012,Hr. Secondary/Intermediate/Pre-University,12,2,14
CHANDIGARH,6,2012,Diploma,0,0,0
CHANDIGARH,6,2012,Graduate,10,7,17
CHANDIGARH,6,2012,Post Graduate and Above,0,0,0
CHANDIGARH,6,2013,No Education,3,1,4
CHANDIGARH,6,2013,Primary,4,2,6
CHANDIGARH,6,2013,Middle,7,5,12
CHANDIGARH,6,2013,Matriculate/Secondary,20,14,34
CHANDIGARH,6,2013,Hr. Secondary/Intermediate/Pre-University,8,12,20
CHANDIGARH,6,2013,Diploma,0,0,0
CHANDIGARH,6,2013,Graduate,16,4,20
CHANDIGARH,6,2013,Post Graduate and Above,1,0,1
CHANDIGARH,6,2014,No Education,0,0,0
CHANDIGARH,6,2014,Primary,9,1,10
CHANDIGARH,6,2014,Middle,6,2,8
CHANDIGARH,6,2014,Matriculate/Secondary,0,7,7
CHANDIGARH,6,2014,Hr. Secondary/Intermediate/Pre-University,31,7,38
CHANDIGARH,6,2014,Diploma,0,0,0
CHANDIGARH,6,2014,Graduate,20,3,23
CHANDIGARH,6,2014,Post Graduate and Above,0,0,0
CHHATTISGARH,7,2001,No Education,598,423,1021
CHHATTISGARH,7,2001,Primary,686,350,1036
CHHATTISGARH,7,2001,Middle,637,307,944
CHHATTISGARH,7,2001,Matriculate/Secondary,380,231,611
CHHATTISGARH,7,2001,Hr. Secondary/Intermediate/Pre-University,244,64,308
CHHATTISGARH,7,2001,Diploma,51,2,53
CHHATTISGARH,7,2001,Graduate,37,6,43
CHHATTISGARH,7,2001,Post Graduate and Above,7,2,9
CHHATTISGARH,7,2002,No Education,635,445,1080
CHHATTISGARH,7,2002,Primary,645,322,967
CHHATTISGARH,7,2002,Middle,577,284,861
CHHATTISGARH,7,2002,Matriculate/Secondary,558,201,759
CHHATTISGARH,7,2002,Hr. Secondary/Intermediate/Pre-University,191,58,249
CHHATTISGARH,7,2002,Diploma,5,1,6
CHHATTISGARH,7,2002,Graduate,11,4,15
CHHATTISGARH,7,2002,Post Graduate and Above,7,6,13
CHHATTISGARH,7,2003,No Education,772,438,1210
CHHATTISGARH,7,2003,Primary,693,390,1083
CHHATTISGARH,7,2003,Middle,564,254,818
CHHATTISGARH,7,2003,Matriculate/Secondary,402,168,570
CHHATTISGARH,7,2003,Hr. Secondary/Intermediate/Pre-University,133,64,197
CHHATTISGARH,7,2003,Diploma,2,3,5
CHHATTISGARH,7,2003,Graduate,23,10,33
CHHATTISGARH,7,2003,Post Graduate and Above,3,0,3
CHHATTISGARH,7,2004,No Education,878,481,1359
CHHATTISGARH,7,2004,Primary,753,388,1141
CHHATTISGARH,7,2004,Middle,775,365,1140
CHHATTISGARH,7,2004,Matriculate/Secondary,410,206,616
CHHATTISGARH,7,2004,Hr. Secondary/Intermediate/Pre-University,136,58,194
CHHATTISGARH,7,2004,Diploma,4,2,6
CHHATTISGARH,7,2004,Graduate,25,7,32
CHHATTISGARH,7,2004,Post Graduate and Above,5,2,7
CHHATTISGARH,7,2005,No Education,959,489,1448
CHHATTISGARH,7,2005,Primary,848,517,1365
CHHATTISGARH,7,2005,Middle,752,326,1078
CHHATTISGARH,7,2005,Matriculate/Secondary,423,145,568
CHHATTISGARH,7,2005,Hr. Secondary/Intermediate/Pre-University,242,74,316
CHHATTISGARH,7,2005,Diploma,20,5,25
CHHATTISGARH,7,2005,Graduate,49,13,62
CHHATTISGARH,7,2005,Post Graduate and Above,12,7,19
CHHATTISGARH,7,2006,No Education,986,548,1534
CHHATTISGARH,7,2006,Primary,776,418,1194
CHHATTISGARH,7,2006,Middle,670,359,1029
CHHATTISGARH,7,2006,Matriculate/Secondary,422,164,586
CHHATTISGARH,7,2006,Hr. Secondary/Intermediate/Pre-University,165,68,233
CHHATTISGARH,7,2006,Diploma,4,0,4
CHHATTISGARH,7,2006,Graduate,35,9,44
CHHATTISGARH,7,2006,Post Graduate and Above,2,0,2
CHHATTISGARH,7,2007,No Education,638,430,1068
CHHATTISGARH,7,2007,Primary,963,506,1469
CHHATTISGARH,7,2007,Middle,870,405,1275
CHHATTISGARH,7,2007,Matriculate/Secondary,499,153,652
CHHATTISGARH,7,2007,Hr. Secondary/Intermediate/Pre-University,239,76,315
CHHATTISGARH,7,2007,Diploma,9,3,12
CHHATTISGARH,7,2007,Graduate,36,9,45
CHHATTISGARH,7,2007,Post Graduate and Above,2,1,3
CHHATTISGARH,7,2008,No Education,360,320,680
CHHATTISGARH,7,2008,Primary,985,552,1537
CHHATTISGARH,7,2008,Middle,962,470,1432
CHHATTISGARH,7,2008,Matriculate/Secondary,593,239,832
CHHATTISGARH,7,2008,Hr. Secondary/Intermediate/Pre-University,304,99,403
CHHATTISGARH,7,2008,Diploma,14,2,16
CHHATTISGARH,7,2008,Graduate,26,12,38
CHHATTISGARH,7,2008,Post Graduate and Above,4,3,7
CHHATTISGARH,7,2009,No Education,1037,549,1586
CHHATTISGARH,7,2009,Primary,978,510,1488
CHHATTISGARH,7,2009,Middle,992,544,1536
CHHATTISGARH,7,2009,Matriculate/Secondary,617,248,865
CHHATTISGARH,7,2009,Hr. Secondary/Intermediate/Pre-University,290,69,359
CHHATTISGARH,7,2009,Diploma,9,3,12
CHHATTISGARH,7,2009,Graduate,26,6,32
CHHATTISGARH,7,2009,Post Graduate and Above,5,0,5
CHHATTISGARH,7,2010,No Education,1167,486,1653
CHHATTISGARH,7,2010,Primary,1256,550,1806
CHHATTISGARH,7,2010,Middle,1188,597,1785
CHHATTISGARH,7,2010,Matriculate/Secondary,660,258,918
CHHATTISGARH,7,2010,Hr. Secondary/Intermediate/Pre-University,227,67,294
CHHATTISGARH,7,2010,Diploma,7,1,8
CHHATTISGARH,7,2010,Graduate,33,17,50
CHHATTISGARH,7,2010,Post Graduate and Above,7,1,8
CHHATTISGARH,7,2011,No Education,963,692,1655
CHHATTISGARH,7,2011,Primary,1228,537,1765
CHHATTISGARH,7,2011,Middle,1282,629,1911
CHHATTISGARH,7,2011,Matriculate/Secondary,722,269,991
CHHATTISGARH,7,2011,Hr. Secondary/Intermediate/Pre-University,263,85,348
CHHATTISGARH,7,2011,Diploma,21,3,24
CHHATTISGARH,7,2011,Graduate,44,13,57
CHHATTISGARH,7,2011,Post Graduate and Above,4,1,5
CHHATTISGARH,7,2012,No Education,811,507,1318
CHHATTISGARH,7,2012,Primary,1054,408,1462
CHHATTISGARH,7,2012,Middle,1200,412,1612
CHHATTISGARH,7,2012,Matriculate/Secondary,569,200,769
CHHATTISGARH,7,2012,Hr. Secondary/Intermediate/Pre-University,233,63,296
CHHATTISGARH,7,2012,Diploma,41,13,54
CHHATTISGARH,7,2012,Graduate,72,24,96
CHHATTISGARH,7,2012,Post Graduate and Above,34,13,47
CHHATTISGARH,7,2013,No Education,868,551,1419
CHHATTISGARH,7,2013,Primary,798,437,1235
CHHATTISGARH,7,2013,Middle,974,415,1389
CHHATTISGARH,7,2013,Matriculate/Secondary,645,281,926
CHHATTISGARH,7,2013,Hr. Secondary/Intermediate/Pre-University,307,82,389
CHHATTISGARH,7,2013,Diploma,5,12,17
CHHATTISGARH,7,2013,Graduate,45,10,55
CHHATTISGARH,7,2013,Post Graduate and Above,6,0,6
CHHATTISGARH,7,2014,No Education,452,297,749
CHHATTISGARH,7,2014,Primary,789,442,1231
CHHATTISGARH,7,2014,Middle,819,468,1287
CHHATTISGARH,7,2014,Matriculate/Secondary,688,293,981
CHHATTISGARH,7,2014,Hr. Secondary/Intermediate/Pre-University,383,182,565
CHHATTISGARH,7,2014,Diploma,32,20,52
CHHATTISGARH,7,2014,Graduate,111,30,141
CHHATTISGARH,7,2014,Post Graduate and Above,10,4,14
D & N HAVELI,8,2001,No Education,18,7,25
D & N HAVELI,8,2001,Primary,9,4,13
D & N HAVELI,8,2001,Middle,3,2,5
D & N HAVELI,8,2001,Matriculate/Secondary,5,2,7
D & N HAVELI,8,2001,Hr. Secondary/Intermediate/Pre-University,0,0,0
D & N HAVELI,8,2001,Diploma,0,0,0
D & N HAVELI,8,2001,Graduate,0,0,0
D & N HAVELI,8,2001,Post Graduate and Above,0,0,0
D & N HAVELI,8,2002,No Education,13,8,21
D & N HAVELI,8,2002,Primary,16,8,24
D & N HAVELI,8,2002,Middle,1,1,2
D & N HAVELI,8,2002,Matriculate/Secondary,2,1,3
D & N HAVELI,8,2002,Hr. Secondary/Intermediate/Pre-University,0,0,0
D & N HAVELI,8,2002,Diploma,0,0,0
D & N HAVELI,8,2002,Graduate,0,0,0
D & N HAVELI,8,2002,Post Graduate and Above,0,0,0
D & N HAVELI,8,2003,No Education,21,12,33
D & N HAVELI,8,2003,Primary,1,1,2
D & N HAVELI,8,2003,Middle,1,1,2
D & N HAVELI,8,2003,Matriculate/Secondary,7,8,15
D & N HAVELI,8,2003,Hr. Secondary/Intermediate/Pre-University,0,0,0
D & N HAVELI,8,2003,Diploma,0,0,0
D & N HAVELI,8,2003,Graduate,0,0,0
D & N HAVELI,8,2003,Post Graduate and Above,0,0,0
D & N HAVELI,8,2004,No Education,12,10,22
D & N HAVELI,8,2004,Primary,4,5,9
D & N HAVELI,8,2004,Middle,2,0,2
D & N HAVELI,8,2004,Matriculate/Secondary,2,0,2
D & N HAVELI,8,2004,Hr. Secondary/Intermediate/Pre-University,0,4,4
D & N HAVELI,8,2004,Diploma,0,0,0
D & N HAVELI,8,2004,Graduate,0,0,0
D & N HAVELI,8,2004,Post Graduate and Above,0,0,0
D & N HAVELI,8,2005,No Education,16,14,30
D & N HAVELI,8,2005,Primary,5,3,8
D & N HAVELI,8,2005,Middle,8,5,13
D & N HAVELI,8,2005,Matriculate/Secondary,12,3,15
D & N HAVELI,8,2005,Hr. Secondary/Intermediate/Pre-University,0,3,3
D & N HAVELI,8,2005,Diploma,0,0,0
D & N HAVELI,8,2005,Graduate,0,0,0
D & N HAVELI,8,2005,Post Graduate and Above,0,0,0
D & N HAVELI,8,2006,No Education,15,16,31
D & N HAVELI,8,2006,Primary,2,0,2
D & N HAVELI,8,2006,Middle,4,1,5
D & N HAVELI,8,2006,Matriculate/Secondary,2,1,3
D & N HAVELI,8,2006,Hr. Secondary/Intermediate/Pre-University,0,0,0
D & N HAVELI,8,2006,Diploma,0,1,1
D & N HAVELI,8,2006,Graduate,0,0,0
D & N HAVELI,8,2006,Post Graduate and Above,0,0,0
D & N HAVELI,8,2007,No Education,27,19,46
D & N HAVELI,8,2007,Primary,6,5,11
D & N HAVELI,8,2007,Middle,4,4,8
D & N HAVELI,8,2007,Matriculate/Secondary,5,1,6
D & N HAVELI,8,2007,Hr. Secondary/Intermediate/Pre-University,2,2,4
D & N HAVELI,8,2007,Diploma,0,0,0
D & N HAVELI,8,2007,Graduate,0,1,1
D & N HAVELI,8,2007,Post Graduate and Above,0,0,0
D & N HAVELI,8,2008,No Education,10,13,23
D & N HAVELI,8,2008,Primary,11,10,21
D & N HAVELI,8,2008,Middle,5,2,7
D & N HAVELI,8,2008,Matriculate/Secondary,1,3,4
D & N HAVELI,8,2008,Hr. Secondary/Intermediate/Pre-University,1,0,1
D & N HAVELI,8,2008,Diploma,1,0,1
D & N HAVELI,8,2008,Graduate,3,0,3
D & N HAVELI,8,2008,Post Graduate and Above,0,0,0
D & N HAVELI,8,2009,No Education,8,9,17
D & N HAVELI,8,2009,Primary,9,6,15
D & N HAVELI,8,2009,Middle,7,8,15
D & N HAVELI,8,2009,Matriculate/Secondary,3,1,4
D & N HAVELI,8,2009,Hr. Secondary/Intermediate/Pre-University,2,2,4
D & N HAVELI,8,2009,Diploma,1,0,1
D & N HAVELI,8,2009,Graduate,0,0,0
D & N HAVELI,8,2009,Post Graduate and Above,0,0,0
D & N HAVELI,8,2010,No Education,15,8,23
D & N HAVELI,8,2010,Primary,11,12,23
D & N HAVELI,8,2010,Middle,6,4,10
D & N HAVELI,8,2010,Matriculate/Secondary,1,2,3
D & N HAVELI,8,2010,Hr. Secondary/Intermediate/Pre-University,2,0,2
D & N HAVELI,8,2010,Diploma,0,0,0
D & N HAVELI,8,2010,Graduate,2,0,2
D & N HAVELI,8,2010,Post Graduate and Above,0,0,0
D & N HAVELI,8,2011,No Education,11,11,22
D & N HAVELI,8,2011,Primary,16,6,22
D & N HAVELI,8,2011,Middle,7,1,8
D & N HAVELI,8,2011,Matriculate/Secondary,5,2,7
D & N HAVELI,8,2011,Hr. Secondary/Intermediate/Pre-University,2,2,4
D & N HAVELI,8,2011,Diploma,0,0,0
D & N HAVELI,8,2011,Graduate,0,0,0
D & N HAVELI,8,2011,Post Graduate and Above,0,0,0
D & N HAVELI,8,2012,No Education,9,8,17
D & N HAVELI,8,2012,Primary,14,9,23
D & N HAVELI,8,2012,Middle,8,6,14
D & N HAVELI,8,2012,Matriculate/Secondary,5,1,6
D & N HAVELI,8,2012,Hr. Secondary/Intermediate/Pre-University,3,1,4
D & N HAVELI,8,2012,Diploma,1,0,1
D & N HAVELI,8,2012,Graduate,1,0,1
D & N HAVELI,8,2012,Post Graduate and Above,0,0,0
D & N HAVELI,8,2013,No Education,17,9,26
D & N HAVELI,8,2013,Primary,11,8,19
D & N HAVELI,8,2013,Middle,10,5,15
D & N HAVELI,8,2013,Matriculate/Secondary,10,3,13
D & N HAVELI,8,2013,Hr. Secondary/Intermediate/Pre-University,5,0,5
D & N HAVELI,8,2013,Diploma,0,0,0
D & N HAVELI,8,2013,Graduate,2,4,6
D & N HAVELI,8,2013,Post Graduate and Above,0,0,0
D & N HAVELI,8,2014,No Education,9,10,19
D & N HAVELI,8,2014,Primary,14,10,24
D & N HAVELI,8,2014,Middle,12,6,18
D & N HAVELI,8,2014,Matriculate/Secondary,5,4,9
D & N HAVELI,8,2014,Hr. Secondary/Intermediate/Pre-University,2,1,3
D & N HAVELI,8,2014,Diploma,0,0,0
D & N HAVELI,8,2014,Graduate,3,0,3
D & N HAVELI,8,2014,Post Graduate and Above,0,0,0
DAMAN & DIU,9,2001,No Education,0,0,0
DAMAN & DIU,9,2001,Primary,2,0,2
DAMAN & DIU,9,2001,Middle,4,1,5
DAMAN & DIU,9,2001,Matriculate/Secondary,3,2,5
DAMAN & DIU,9,2001,Hr. Secondary/Intermediate/Pre-University,0,0,0
DAMAN & DIU,9,2001,Diploma,0,0,0
DAMAN & DIU,9,2001,Graduate,0,1,1
DAMAN & DIU,9,2001,Post Graduate and Above,1,0,1
DAMAN & DIU,9,2002,No Education,1,0,1
DAMAN & DIU,9,2002,Primary,9,1,10
DAMAN & DIU,9,2002,Middle,1,0,1
DAMAN & DIU,9,2002,Matriculate/Secondary,4,1,5
DAMAN & DIU,9,2002,Hr. Secondary/Intermediate/Pre-University,0,0,0
DAMAN & DIU,9,2002,Diploma,0,0,0
DAMAN & DIU,9,2002,Graduate,0,0,0
DAMAN & DIU,9,2002,Post Graduate and Above,0,0,0
DAMAN & DIU,9,2003,No Education,3,1,4
DAMAN & DIU,9,2003,Primary,7,2,9
DAMAN & DIU,9,2003,Middle,4,3,7
DAMAN & DIU,9,2003,Matriculate/Secondary,2,0,2
DAMAN & DIU,9,2003,Hr. Secondary/Intermediate/Pre-University,1,0,1
DAMAN & DIU,9,2003,Diploma,0,0,0
DAMAN & DIU,9,2003,Graduate,0,0,0
DAMAN & DIU,9,2003,Post Graduate and Above,1,0,1
DAMAN & DIU,9,2004,No Education,2,1,3
DAMAN & DIU,9,2004,Primary,1,4,5
DAMAN & DIU,9,2004,Middle,1,2,3
DAMAN & DIU,9,2004,Matriculate/Secondary,1,1,2
DAMAN & DIU,9,2004,Hr. Secondary/Intermediate/Pre-University,0,0,0
DAMAN & DIU,9,2004,Diploma,0,0,0
DAMAN & DIU,9,2004,Graduate,0,0,0
DAMAN & DIU,9,2004,Post Graduate and Above,0,0,0
DAMAN & DIU,9,2005,No Education,6,1,7
DAMAN & DIU,9,2005,Primary,7,2,9
DAMAN & DIU,9,2005,Middle,5,3,8
DAMAN & DIU,9,2005,Matriculate/Secondary,4,1,5
DAMAN & DIU,9,2005,Hr. Secondary/Intermediate/Pre-University,2,0,2
DAMAN & DIU,9,2005,Diploma,0,0,0
DAMAN & DIU,9,2005,Graduate,1,0,1
DAMAN & DIU,9,2005,Post Graduate and Above,0,0,0
DAMAN & DIU,9,2006,No Education,1,4,5
DAMAN & DIU,9,2006,Primary,6,2,8
DAMAN & DIU,9,2006,Middle,2,1,3
DAMAN & DIU,9,2006,Matriculate/Secondary,3,0,3
DAMAN & DIU,9,2006,Hr. Secondary/Intermediate/Pre-University,1,1,2
DAMAN & DIU,9,2006,Diploma,0,0,0
DAMAN & DIU,9,2006,Graduate,1,0,1
DAMAN & DIU,9,2006,Post Graduate and Above,0,0,0
DAMAN & DIU,9,2007,No Education,0,0,0
DAMAN & DIU,9,2007,Primary,1,2,3
DAMAN & DIU,9,2007,Middle,2,6,8
DAMAN & DIU,9,2007,Matriculate/Secondary,3,1,4
DAMAN & DIU,9,2007,Hr. Secondary/Intermediate/Pre-University,0,0,0
DAMAN & DIU,9,2007,Diploma,0,0,0
DAMAN & DIU,9,2007,Graduate,0,0,0
DAMAN & DIU,9,2007,Post Graduate and Above,0,0,0
DAMAN & DIU,9,2008,No Education,1,2,3
DAMAN & DIU,9,2008,Primary,2,1,3
DAMAN & DIU,9,2008,Middle,2,0,2
DAMAN & DIU,9,2008,Matriculate/Secondary,7,1,8
DAMAN & DIU,9,2008,Hr. Secondary/Intermediate/Pre-University,1,1,2
DAMAN & DIU,9,2008,Diploma,0,0,0
DAMAN & DIU,9,2008,Graduate,1,0,1
DAMAN & DIU,9,2008,Post Graduate and Above,0,0,0
DAMAN & DIU,9,2009,No Education,0,1,1
DAMAN & DIU,9,2009,Primary,5,2,7
DAMAN & DIU,9,2009,Middle,5,3,8
DAMAN & DIU,9,2009,Matriculate/Secondary,4,1,5
DAMAN & DIU,9,2009,Hr. Secondary/Intermediate/Pre-University,0,1,1
DAMAN & DIU,9,2009,Diploma,0,0,0
DAMAN & DIU,9,2009,Graduate,1,0,1
DAMAN & DIU,9,2009,Post Graduate and Above,0,0,0
DAMAN & DIU,9,2010,No Education,1,0,1
DAMAN & DIU,9,2010,Primary,6,3,9
DAMAN & DIU,9,2010,Middle,4,2,6
DAMAN & DIU,9,2010,Matriculate/Secondary,2,3,5
DAMAN & DIU,9,2010,Hr. Secondary/Intermediate/Pre-University,1,1,2
DAMAN & DIU,9,2010,Diploma,4,2,6
DAMAN & DIU,9,2010,Graduate,1,1,2
DAMAN & DIU,9,2010,Post Graduate and Above,0,0,0
DAMAN & DIU,9,2011,No Education,1,0,1
DAMAN & DIU,9,2011,Primary,3,2,5
DAMAN & DIU,9,2011,Middle,5,1,6
DAMAN & DIU,9,2011,Matriculate/Secondary,5,10,15
DAMAN & DIU,9,2011,Hr. Secondary/Intermediate/Pre-University,2,0,2
DAMAN & DIU,9,2011,Diploma,1,0,1
DAMAN & DIU,9,2011,Graduate,0,2,2
DAMAN & DIU,9,2011,Post Graduate and Above,1,0,1
DAMAN & DIU,9,2012,No Education,3,1,4
DAMAN & DIU,9,2012,Primary,4,4,8
DAMAN & DIU,9,2012,Middle,6,6,12
DAMAN & DIU,9,2012,Matriculate/Secondary,9,0,9
DAMAN & DIU,9,2012,Hr. Secondary/Intermediate/Pre-University,1,0,1
DAMAN & DIU,9,2012,Diploma,0,0,0
DAMAN & DIU,9,2012,Graduate,0,0,0
DAMAN & DIU,9,2012,Post Graduate and Above,2,0,2
DAMAN & DIU,9,2013,No Education,0,2,2
DAMAN & DIU,9,2013,Primary,2,5,7
DAMAN & DIU,9,2013,Middle,3,2,5
DAMAN & DIU,9,2013,Matriculate/Secondary,4,4,8
DAMAN & DIU,9,2013,Hr. Secondary/Intermediate/Pre-University,4,3,7
DAMAN & DIU,9,2013,Diploma,0,0,0
DAMAN & DIU,9,2013,Graduate,0,0,0
DAMAN & DIU,9,2013,Post Graduate and Above,0,0,0
DAMAN & DIU,9,2014,No Education,0,0,0
DAMAN & DIU,9,2014,Primary,0,0,0
DAMAN & DIU,9,2014,Middle,0,1,1
DAMAN & DIU,9,2014,Matriculate/Secondary,7,3,10
DAMAN & DIU,9,2014,Hr. Secondary/Intermediate/Pre-University,0,0,0
DAMAN & DIU,9,2014,Diploma,0,0,0
DAMAN & DIU,9,2014,Graduate,0,0,0
DAMAN & DIU,9,2014,Post Graduate and Above,0,0,0
DELHI (UT),10,2001,No Education,124,120,244
DELHI (UT),10,2001,Primary,113,99,212
DELHI (UT),10,2001,Middle,221,151,372
DELHI (UT),10,2001,Matriculate/Secondary,167,76,243
DELHI (UT),10,2001,Hr. Secondary/Intermediate/Pre-University,74,54,128
DELHI (UT),10,2001,Diploma,9,1,10
DELHI (UT),10,2001,Graduate,19,7,26
DELHI (UT),10,2001,Post Graduate and Above,3,1,4
DELHI (UT),10,2002,No Education,107,114,221
DELHI (UT),10,2002,Primary,121,84,205
DELHI (UT),10,2002,Middle,150,79,229
DELHI (UT),10,2002,Matriculate/Secondary,166,101,267
DELHI (UT),10,2002,Hr. Secondary/Intermediate/Pre-University,68,25,93
DELHI (UT),10,2002,Diploma,8,0,8
DELHI (UT),10,2002,Graduate,20,5,25
DELHI (UT),10,2002,Post Graduate and Above,3,2,5
DELHI (UT),10,2003,No Education,103,86,189
DELHI (UT),10,2003,Primary,157,102,259
DELHI (UT),10,2003,Middle,189,89,278
DELHI (UT),10,2003,Matriculate/Secondary,153,93,246
DELHI (UT),10,2003,Hr. Secondary/Intermediate/Pre-University,112,26,138
DELHI (UT),10,2003,Diploma,5,4,9
DELHI (UT),10,2003,Graduate,21,12,33
DELHI (UT),10,2003,Post Graduate and Above,1,0,1
DELHI (UT),10,2004,No Education,120,83,203
DELHI (UT),10,2004,Primary,147,81,228
DELHI (UT),10,2004,Middle,239,122,361
DELHI (UT),10,2004,Matriculate/Secondary,196,129,325
DELHI (UT),10,2004,Hr. Secondary/Intermediate/Pre-University,68,31,99
DELHI (UT),10,2004,Diploma,5,3,8
DELHI (UT),10,2004,Graduate,21,6,27
DELHI (UT),10,2004,Post Graduate and Above,3,2,5
DELHI (UT),10,2005,No Education,155,130,285
DELHI (UT),10,2005,Primary,160,102,262
DELHI (UT),10,2005,Middle,156,94,250
DELHI (UT),10,2005,Matriculate/Secondary,200,96,296
DELHI (UT),10,2005,Hr. Secondary/Intermediate/Pre-University,77,31,108
DELHI (UT),10,2005,Diploma,3,2,5
DELHI (UT),10,2005,Graduate,23,12,35
DELHI (UT),10,2005,Post Graduate and Above,3,1,4
DELHI (UT),10,2006,No Education,166,119,285
DELHI (UT),10,2006,Primary,148,111,259
DELHI (UT),10,2006,Middle,251,134,385
DELHI (UT),10,2006,Matriculate/Secondary,190,102,292
DELHI (UT),10,2006,Hr. Secondary/Intermediate/Pre-University,120,43,163
DELHI (UT),10,2006,Diploma,47,6,53
DELHI (UT),10,2006,Graduate,35,15,50
DELHI (UT),10,2006,Post Graduate and Above,3,2,5
DELHI (UT),10,2007,No Education,145,124,269
DELHI (UT),10,2007,Primary,169,82,251
DELHI (UT),10,2007,Middle,245,117,362
DELHI (UT),10,2007,Matriculate/Secondary,228,119,347
DELHI (UT),10,2007,Hr. Secondary/Intermediate/Pre-University,138,52,190
DELHI (UT),10,2007,Diploma,7,5,12
DELHI (UT),10,2007,Graduate,34,14,48
DELHI (UT),10,2007,Post Graduate and Above,0,2,2
DELHI (UT),10,2008,No Education,97,88,185
DELHI (UT),10,2008,Primary,144,85,229
DELHI (UT),10,2008,Middle,187,114,301
DELHI (UT),10,2008,Matriculate/Secondary,205,134,339
DELHI (UT),10,2008,Hr. Secondary/Intermediate/Pre-University,113,68,181
DELHI (UT),10,2008,Diploma,6,4,10
DELHI (UT),10,2008,Graduate,35,13,48
DELHI (UT),10,2008,Post Graduate and Above,8,2,10
DELHI (UT),10,2009,No Education,140,112,252
DELHI (UT),10,2009,Primary,145,84,229
DELHI (UT),10,2009,Middle,222,141,363
DELHI (UT),10,2009,Matriculate/Secondary,267,124,391
DELHI (UT),10,2009,Hr. Secondary/Intermediate/Pre-University,100,65,165
DELHI (UT),10,2009,Diploma,9,3,12
DELHI (UT),10,2009,Graduate,35,15,50
DELHI (UT),10,2009,Post Graduate and Above,15,0,15
DELHI (UT),10,2010,No Education,136,98,234
DELHI (UT),10,2010,Primary,161,122,283
DELHI (UT),10,2010,Middle,214,145,359
DELHI (UT),10,2010,Matriculate/Secondary,240,117,357
DELHI (UT),10,2010,Hr. Secondary/Intermediate/Pre-University,142,69,211
DELHI (UT),10,2010,Diploma,10,3,13
DELHI (UT),10,2010,Graduate,38,25,63
DELHI (UT),10,2010,Post Graduate and Above,20,3,23
DELHI (UT),10,2011,No Education,121,72,193
DELHI (UT),10,2011,Primary,189,93,282
DELHI (UT),10,2011,Middle,262,129,391
DELHI (UT),10,2011,Matriculate/Secondary,348,148,496
DELHI (UT),10,2011,Hr. Secondary/Intermediate/Pre-University,178,84,262
DELHI (UT),10,2011,Diploma,13,5,18
DELHI (UT),10,2011,Graduate,56,16,72
DELHI (UT),10,2011,Post Graduate and Above,1,1,2
DELHI (UT),10,2012,No Education,177,78,255
DELHI (UT),10,2012,Primary,156,94,250
DELHI (UT),10,2012,Middle,277,156,433
DELHI (UT),10,2012,Matriculate/Secondary,342,195,537
DELHI (UT),10,2012,Hr. Secondary/Intermediate/Pre-University,211,95,306
DELHI (UT),10,2012,Diploma,4,2,6
DELHI (UT),10,2012,Graduate,69,31,100
DELHI (UT),10,2012,Post Graduate and Above,10,2,12
DELHI (UT),10,2013,No Education,186,81,267
DELHI (UT),10,2013,Primary,215,99,314
DELHI (UT),10,2013,Middle,309,123,432
DELHI (UT),10,2013,Matriculate/Secondary,365,171,536
DELHI (UT),10,2013,Hr. Secondary/Intermediate/Pre-University,259,128,387
DELHI (UT),10,2013,Diploma,13,5,18
DELHI (UT),10,2013,Graduate,63,32,95
DELHI (UT),10,2013,Post Graduate and Above,7,3,10
DELHI (UT),10,2014,No Education,168,111,279
DELHI (UT),10,2014,Primary,221,103,324
DELHI (UT),10,2014,Middle,149,73,222
DELHI (UT),10,2014,Matriculate/Secondary,310,122,432
DELHI (UT),10,2014,Hr. Secondary/Intermediate/Pre-University,179,76,255
DELHI (UT),10,2014,Diploma,25,14,39
DELHI (UT),10,2014,Graduate,49,17,66
DELHI (UT),10,2014,Post Graduate and Above,12,3,15
GOA,11,2001,No Education,55,19,74
GOA,11,2001,Primary,34,24,58
GOA,11,2001,Middle,49,27,76
GOA,11,2001,Matriculate/Secondary,24,18,42
GOA,11,2001,Hr. Secondary/Intermediate/Pre-University,5,1,6
GOA,11,2001,Diploma,0,0,0
GOA,11,2001,Graduate,0,0,0
GOA,11,2001,Post Graduate and Above,0,0,0
GOA,11,2002,No Education,46,14,60
GOA,11,2002,Primary,48,18,66
GOA,11,2002,Middle,76,25,101
GOA,11,2002,Matriculate/Secondary,45,18,63
GOA,11,2002,Hr. Secondary/Intermediate/Pre-University,5,6,11
GOA,11,2002,Diploma,1,1,2
GOA,11,2002,Graduate,3,1,4
GOA,11,2002,Post Graduate and Above,2,0,2
GOA,11,2003,No Education,44,18,62
GOA,11,2003,Primary,39,15,54
GOA,11,2003,Middle,55,30,85
GOA,11,2003,Matriculate/Secondary,57,15,72
GOA,11,2003,Hr. Secondary/Intermediate/Pre-University,12,5,17
GOA,11,2003,Diploma,1,0,1
GOA,11,2003,Graduate,3,3,6
GOA,11,2003,Post Graduate and Above,2,1,3
GOA,11,2004,No Education,51,19,70
GOA,11,2004,Primary,36,25,61
GOA,11,2004,Middle,46,26,72
GOA,11,2004,Matriculate/Secondary,51,21,72
GOA,11,2004,Hr. Secondary/Intermediate/Pre-University,22,8,30
GOA,11,2004,Diploma,0,0,0
GOA,11,2004,Graduate,4,2,6
GOA,11,2004,Post Graduate and Above,2,1,3
GOA,11,2005,No Education,42,15,57
GOA,11,2005,Primary,27,21,48
GOA,11,2005,Middle,48,20,68
GOA,11,2005,Matriculate/Secondary,43,14,57
GOA,11,2005,Hr. Secondary/Intermediate/Pre-University,24,9,33
GOA,11,2005,Diploma,1,0,1
GOA,11,2005,Graduate,8,6,14
GOA,11,2005,Post Graduate and Above,4,0,4
GOA,11,2006,No Education,30,23,53
GOA,11,2006,Primary,36,16,52
GOA,11,2006,Middle,66,26,92
GOA,11,2006,Matriculate/Secondary,37,15,52
GOA,11,2006,Hr. Secondary/Intermediate/Pre-University,11,10,21
GOA,11,2006,Diploma,0,0,0
GOA,11,2006,Graduate,3,2,5
GOA,11,2006,Post Graduate and Above,0,0,0
GOA,11,2007,No Education,41,15,56
GOA,11,2007,Primary,36,21,57
GOA,11,2007,Middle,44,25,69
GOA,11,2007,Matriculate/Secondary,29,22,51
GOA,11,2007,Hr. Secondary/Intermediate/Pre-University,21,5,26
GOA,11,2007,Diploma,1,0,1
GOA,11,2007,Graduate,5,4,9
GOA,11,2007,Post Graduate and Above,1,0,1
GOA,11,2008,No Education,35,12,47
GOA,11,2008,Primary,32,18,50
GOA,11,2008,Middle,49,35,84
GOA,11,2008,Matriculate/Secondary,36,20,56
GOA,11,2008,Hr. Secondary/Intermediate/Pre-University,22,16,38
GOA,11,2008,Diploma,1,1,2
GOA,11,2008,Graduate,1,2,3
GOA,11,2008,Post Graduate and Above,7,0,7
GOA,11,2009,No Education,33,20,53
GOA,11,2009,Primary,25,18,43
GOA,11,2009,Middle,46,26,72
GOA,11,2009,Matriculate/Secondary,45,16,61
GOA,11,2009,Hr. Secondary/Intermediate/Pre-University,23,10,33
GOA,11,2009,Diploma,4,0,4
GOA,11,2009,Graduate,2,2,4
GOA,11,2009,Post Graduate and Above,6,2,8
GOA,11,2010,No Education,40,18,58
GOA,11,2010,Primary,33,9,42
GOA,11,2010,Middle,63,24,87
GOA,11,2010,Matriculate/Secondary,59,26,85
GOA,11,2010,Hr. Secondary/Intermediate/Pre-University,24,7,31
GOA,11,2010,Diploma,1,0,1
GOA,11,2010,Graduate,8,2,10
GOA,11,2010,Post Graduate and Above,8,0,8
GOA,11,2011,No Education,20,12,32
GOA,11,2011,Primary,34,10,44
GOA,11,2011,Middle,69,36,105
GOA,11,2011,Matriculate/Secondary,52,28,80
GOA,11,2011,Hr. Secondary/Intermediate/Pre-University,16,8,24
GOA,11,2011,Diploma,0,0,0
GOA,11,2011,Graduate,4,3,7
GOA,11,2011,Post Graduate and Above,0,1,1
GOA,11,2012,No Education,21,8,29
GOA,11,2012,Primary,30,15,45
GOA,11,2012,Middle,46,22,68
GOA,11,2012,Matriculate/Secondary,45,22,67
GOA,11,2012,Hr. Secondary/Intermediate/Pre-University,37,24,61
GOA,11,2012,Diploma,1,1,2
GOA,11,2012,Graduate,15,1,16
GOA,11,2012,Post Graduate and Above,1,0,1
GOA,11,2013,No Education,21,15,36
GOA,11,2013,Primary,22,11,33
GOA,11,2013,Middle,64,35,99
GOA,11,2013,Matriculate/Secondary,66,27,93
GOA,11,2013,Hr. Secondary/Intermediate/Pre-University,51,9,60
GOA,11,2013,Diploma,0,0,0
GOA,11,2013,Graduate,5,1,6
GOA,11,2013,Post Graduate and Above,1,0,1
GOA,11,2014,No Education,3,7,10
GOA,11,2014,Primary,17,9,26
GOA,11,2014,Middle,48,27,75
GOA,11,2014,Matriculate/Secondary,58,25,83
GOA,11,2014,Hr. Secondary/Intermediate/Pre-University,26,10,36
GOA,11,2014,Diploma,5,0,5
GOA,11,2014,Graduate,8,4,12
GOA,11,2014,Post Graduate and Above,1,0,1
GUJARAT,12,2001,No Education,568,558,1126
GUJARAT,12,2001,Primary,862,845,1707
GUJARAT,12,2001,Middle,572,397,969
GUJARAT,12,2001,Matriculate/Secondary,477,276,753
GUJARAT,12,2001,Hr. Secondary/Intermediate/Pre-University,114,56,170
GUJARAT,12,2001,Diploma,13,2,15
GUJARAT,12,2001,Graduate,31,8,39
GUJARAT,12,2001,Post Graduate and Above,12,0,12
GUJARAT,12,2002,No Education,554,505,1059
GUJARAT,12,2002,Primary,974,820,1794
GUJARAT,12,2002,Middle,518,284,802
GUJARAT,12,2002,Matriculate/Secondary,461,233,694
GUJARAT,12,2002,Hr. Secondary/Intermediate/Pre-University,133,74,207
GUJARAT,12,2002,Diploma,22,1,23
GUJARAT,12,2002,Graduate,36,19,55
GUJARAT,12,2002,Post Graduate and Above,8,2,10
GUJARAT,12,2003,No Education,606,537,1143
GUJARAT,12,2003,Primary,988,728,1716
GUJARAT,12,2003,Middle,492,311,803
GUJARAT,12,2003,Matriculate/Secondary,392,220,612
GUJARAT,12,2003,Hr. Secondary/Intermediate/Pre-University,122,86,208
GUJARAT,12,2003,Diploma,11,6,17
GUJARAT,12,2003,Graduate,33,22,55
GUJARAT,12,2003,Post Graduate and Above,6,6,12
GUJARAT,12,2004,No Education,743,556,1299
GUJARAT,12,2004,Primary,975,824,1799
GUJARAT,12,2004,Middle,467,250,717
GUJARAT,12,2004,Matriculate/Secondary,464,211,675
GUJARAT,12,2004,Hr. Secondary/Intermediate/Pre-University,146,66,212
GUJARAT,12,2004,Diploma,12,4,16
GUJARAT,12,2004,Graduate,34,14,48
GUJARAT,12,2004,Post Graduate and Above,9,1,10
GUJARAT,12,2005,No Education,629,491,1120
GUJARAT,12,2005,Primary,1090,793,1883
GUJARAT,12,2005,Middle,520,267,787
GUJARAT,12,2005,Matriculate/Secondary,438,217,655
GUJARAT,12,2005,Hr. Secondary/Intermediate/Pre-University,149,70,219
GUJARAT,12,2005,Diploma,14,1,15
GUJARAT,12,2005,Graduate,35,14,49
GUJARAT,12,2005,Post Graduate and Above,27,10,37
GUJARAT,12,2006,No Education,694,559,1253
GUJARAT,12,2006,Primary,1138,796,1934
GUJARAT,12,2006,Middle,549,330,879
GUJARAT,12,2006,Matriculate/Secondary,461,228,689
GUJARAT,12,2006,Hr. Secondary/Intermediate/Pre-University,146,56,202
GUJARAT,12,2006,Diploma,11,2,13
GUJARAT,12,2006,Graduate,35,14,49
GUJARAT,12,2006,Post Graduate and Above,14,2,16
GUJARAT,12,2007,No Education,666,525,1191
GUJARAT,12,2007,Primary,1164,874,2038
GUJARAT,12,2007,Middle,640,408,1048
GUJARAT,12,2007,Matriculate/Secondary,604,283,887
GUJARAT,12,2007,Hr. Secondary/Intermediate/Pre-University,198,89,287
GUJARAT,12,2007,Diploma,16,8,24
GUJARAT,12,2007,Graduate,80,18,98
GUJARAT,12,2007,Post Graduate and Above,7,0,7
GUJARAT,12,2008,No Education,824,569,1393
GUJARAT,12,2008,Primary,1239,930,2169
GUJARAT,12,2008,Middle,742,455,1197
GUJARAT,12,2008,Matriculate/Secondary,617,353,970
GUJARAT,12,2008,Hr. Secondary/Intermediate/Pre-University,219,104,323
GUJARAT,12,2008,Diploma,13,3,16
GUJARAT,12,2008,Graduate,74,15,89
GUJARAT,12,2008,Post Graduate and Above,7,1,8
GUJARAT,12,2009,No Education,655,618,1273
GUJARAT,12,2009,Primary,1322,922,2244
GUJARAT,12,2009,Middle,744,474,1218
GUJARAT,12,2009,Matriculate/Secondary,643,331,974
GUJARAT,12,2009,Hr. Secondary/Intermediate/Pre-University,226,102,328
GUJARAT,12,2009,Diploma,15,13,28
GUJARAT,12,2009,Graduate,60,24,84
GUJARAT,12,2009,Post Graduate and Above,6,1,7
GUJARAT,12,2010,No Education,744,574,1318
GUJARAT,12,2010,Primary,1245,938,2183
GUJARAT,12,2010,Middle,775,473,1248
GUJARAT,12,2010,Matriculate/Secondary,639,290,929
GUJARAT,12,2010,Hr. Secondary/Intermediate/Pre-University,295,86,381
GUJARAT,12,2010,Diploma,21,3,24
GUJARAT,12,2010,Graduate,80,27,107
GUJARAT,12,2010,Post Graduate and Above,14,3,17
GUJARAT,12,2011,No Education,636,538,1174
GUJARAT,12,2011,Primary,1464,951,2415
GUJARAT,12,2011,Middle,774,484,1258
GUJARAT,12,2011,Matriculate/Secondary,681,340,1021
GUJARAT,12,2011,Hr. Secondary/Intermediate/Pre-University,251,98,349
GUJARAT,12,2011,Diploma,25,13,38
GUJARAT,12,2011,Graduate,73,39,112
GUJARAT,12,2011,Post Graduate and Above,8,7,15
GUJARAT,12,2012,No Education,660,495,1155
GUJARAT,12,2012,Primary,1549,1024,2573
GUJARAT,12,2012,Middle,765,545,1310
GUJARAT,12,2012,Matriculate/Secondary,890,455,1345
GUJARAT,12,2012,Hr. Secondary/Intermediate/Pre-University,318,164,482
GUJARAT,12,2012,Diploma,30,5,35
GUJARAT,12,2012,Graduate,131,49,180
GUJARAT,12,2012,Post Graduate and Above,19,11,30
GUJARAT,12,2013,No Education,614,434,1048
GUJARAT,12,2013,Primary,1631,1064,2695
GUJARAT,12,2013,Middle,889,449,1338
GUJARAT,12,2013,Matriculate/Secondary,874,448,1322
GUJARAT,12,2013,Hr. Secondary/Intermediate/Pre-University,316,169,485
GUJARAT,12,2013,Diploma,52,13,65
GUJARAT,12,2013,Graduate,141,53,194
GUJARAT,12,2013,Post Graduate and Above,15,4,19
GUJARAT,12,2014,No Education,514,419,933
GUJARAT,12,2014,Primary,1115,719,1834
GUJARAT,12,2014,Middle,873,504,1377
GUJARAT,12,2014,Matriculate/Secondary,921,409,1330
GUJARAT,12,2014,Hr. Secondary/Intermediate/Pre-University,492,250,742
GUJARAT,12,2014,Diploma,33,10,43
GUJARAT,12,2014,Graduate,117,33,150
GUJARAT,12,2014,Post Graduate and Above,6,1,7
HARYANA,13,2001,No Education,314,169,483
HARYANA,13,2001,Primary,208,95,303
HARYANA,13,2001,Middle,305,129,434
HARYANA,13,2001,Matriculate/Secondary,356,165,521
HARYANA,13,2001,Hr. Secondary/Intermediate/Pre-University,115,67,182
HARYANA,13,2001,Diploma,48,15,63
HARYANA,13,2001,Graduate,13,3,16
HARYANA,13,2001,Post Graduate and Above,5,0,5
HARYANA,13,2002,No Education,383,164,547
HARYANA,13,2002,Primary,272,88,360
HARYANA,13,2002,Middle,385,117,502
HARYANA,13,2002,Matriculate/Secondary,384,214,598
HARYANA,13,2002,Hr. Secondary/Intermediate/Pre-University,77,33,110
HARYANA,13,2002,Diploma,40,7,47
HARYANA,13,2002,Graduate,21,7,28
HARYANA,13,2002,Post Graduate and Above,8,0,8
HARYANA,13,2003,No Education,353,128,481
HARYANA,13,2003,Primary,245,103,348
HARYANA,13,2003,Middle,374,129,503
HARYANA,13,2003,Matriculate/Secondary,425,168,593
HARYANA,13,2003,Hr. Secondary/Intermediate/Pre-University,125,59,184
HARYANA,13,2003,Diploma,57,15,72
HARYANA,13,2003,Graduate,31,8,39
HARYANA,13,2003,Post Graduate and Above,3,4,7
HARYANA,13,2004,No Education,350,150,500
HARYANA,13,2004,Primary,231,90,321
HARYANA,13,2004,Middle,325,97,422
HARYANA,13,2004,Matriculate/Secondary,378,219,597
HARYANA,13,2004,Hr. Secondary/Intermediate/Pre-University,104,42,146
HARYANA,13,2004,Diploma,29,17,46
HARYANA,13,2004,Graduate,29,11,40
HARYANA,13,2004,Post Graduate and Above,8,2,10
HARYANA,13,2005,No Education,255,130,385
HARYANA,13,2005,Primary,245,103,348
HARYANA,13,2005,Middle,314,113,427
HARYANA,13,2005,Matriculate/Secondary,450,182,632
HARYANA,13,2005,Hr. Secondary/Intermediate/Pre-University,157,21,178
HARYANA,13,2005,Diploma,39,2,41
HARYANA,13,2005,Graduate,32,2,34
HARYANA,13,2005,Post Graduate and Above,1,0,1
HARYANA,13,2006,No Education,284,139,423
HARYANA,13,2006,Primary,268,148,416
HARYANA,13,2006,Middle,471,152,623
HARYANA,13,2006,Matriculate/Secondary,463,76,539
HARYANA,13,2006,Hr. Secondary/Intermediate/Pre-University,196,23,219
HARYANA,13,2006,Diploma,29,6,35
HARYANA,13,2006,Graduate,24,6,30
HARYANA,13,2006,Post Graduate and Above,31,0,31
HARYANA,13,2007,No Education,315,140,455
HARYANA,13,2007,Primary,256,124,380
HARYANA,13,2007,Middle,367,120,487
HARYANA,13,2007,Matriculate/Secondary,606,151,757
HARYANA,13,2007,Hr. Secondary/Intermediate/Pre-University,208,34,242
HARYANA,13,2007,Diploma,46,6,52
HARYANA,13,2007,Graduate,44,4,48
HARYANA,13,2007,Post Graduate and Above,10,2,12
HARYANA,13,2008,No Education,364,148,512
HARYANA,13,2008,Primary,361,148,509
HARYANA,13,2008,Middle,361,153,514
HARYANA,13,2008,Matriculate/Secondary,563,161,724
HARYANA,13,2008,Hr. Secondary/Intermediate/Pre-University,214,52,266
HARYANA,13,2008,Diploma,49,11,60
HARYANA,13,2008,Graduate,41,8,49
HARYANA,13,2008,Post Graduate and Above,21,1,22
HARYANA,13,2009,No Education,452,142,594
HARYANA,13,2009,Primary,416,184,600
HARYANA,13,2009,Middle,345,123,468
HARYANA,13,2009,Matriculate/Secondary,348,151,499
HARYANA,13,2009,Hr. Secondary/Intermediate/Pre-University,151,53,204
HARYANA,13,2009,Diploma,35,12,47
HARYANA,13,2009,Graduate,47,15,62
HARYANA,13,2009,Post Graduate and Above,21,8,29
HARYANA,13,2010,No Education,297,143,440
HARYANA,13,2010,Primary,384,134,518
HARYANA,13,2010,Middle,409,141,550
HARYANA,13,2010,Matriculate/Secondary,415,137,552
HARYANA,13,2010,Hr. Secondary/Intermediate/Pre-University,240,81,321
HARYANA,13,2010,Diploma,48,8,56
HARYANA,13,2010,Graduate,61,21,82
HARYANA,13,2010,Post Graduate and Above,324,52,376
HARYANA,13,2011,No Education,575,155,730
HARYANA,13,2011,Primary,487,140,627
HARYANA,13,2011,Middle,392,148,540
HARYANA,13,2011,Matriculate/Secondary,660,194,854
HARYANA,13,2011,Hr. Secondary/Intermediate/Pre-University,248,109,357
HARYANA,13,2011,Diploma,43,12,55
HARYANA,13,2011,Graduate,54,23,77
HARYANA,13,2011,Post Graduate and Above,5,0,5
HARYANA,13,2012,No Education,351,120,471
HARYANA,13,2012,Primary,301,157,458
HARYANA,13,2012,Middle,378,173,551
HARYANA,13,2012,Matriculate/Secondary,570,204,774
HARYANA,13,2012,Hr. Secondary/Intermediate/Pre-University,270,68,338
HARYANA,13,2012,Diploma,92,20,112
HARYANA,13,2012,Graduate,74,13,87
HARYANA,13,2012,Post Graduate and Above,35,1,36
HARYANA,13,2013,No Education,437,153,590
HARYANA,13,2013,Primary,421,180,601
HARYANA,13,2013,Middle,559,175,734
HARYANA,13,2013,Matriculate/Secondary,660,186,846
HARYANA,13,2013,Hr. Secondary/Intermediate/Pre-University,259,85,344
HARYANA,13,2013,Diploma,79,17,96
HARYANA,13,2013,Graduate,67,15,82
HARYANA,13,2013,Post Graduate and Above,20,3,23
HARYANA,13,2014,No Education,342,98,440
HARYANA,13,2014,Primary,301,72,373
HARYANA,13,2014,Middle,424,104,528
HARYANA,13,2014,Matriculate/Secondary,572,170,742
HARYANA,13,2014,Hr. Secondary/Intermediate/Pre-University,324,79,403
HARYANA,13,2014,Diploma,49,13,62
HARYANA,13,2014,Graduate,33,9,42
HARYANA,13,2014,Post Graduate and Above,7,1,8
HIMACHAL PRADESH,14,2001,No Education,27,25,52
HIMACHAL PRADESH,14,2001,Primary,39,34,73
HIMACHAL PRADESH,14,2001,Middle,38,22,60
HIMACHAL PRADESH,14,2001,Matriculate/Secondary,60,40,100
HIMACHAL PRADESH,14,2001,Hr. Secondary/Intermediate/Pre-University,6,5,11
HIMACHAL PRADESH,14,2001,Diploma,1,0,1
HIMACHAL PRADESH,14,2001,Graduate,3,4,7
HIMACHAL PRADESH,14,2001,Post Graduate and Above,3,0,3
HIMACHAL PRADESH,14,2002,No Education,26,20,46
HIMACHAL PRADESH,14,2002,Primary,33,28,61
HIMACHAL PRADESH,14,2002,Middle,31,34,65
HIMACHAL PRADESH,14,2002,Matriculate/Secondary,89,33,122
HIMACHAL PRADESH,14,2002,Hr. Secondary/Intermediate/Pre-University,25,8,33
HIMACHAL PRADESH,14,2002,Diploma,1,0,1
HIMACHAL PRADESH,14,2002,Graduate,2,2,4
HIMACHAL PRADESH,14,2002,Post Graduate and Above,1,1,2
HIMACHAL PRADESH,14,2003,No Education,35,16,51
HIMACHAL PRADESH,14,2003,Primary,40,28,68
HIMACHAL PRADESH,14,2003,Middle,50,34,84
HIMACHAL PRADESH,14,2003,Matriculate/Secondary,68,39,107
HIMACHAL PRADESH,14,2003,Hr. Secondary/Intermediate/Pre-University,35,24,59
HIMACHAL PRADESH,14,2003,Diploma,4,1,5
HIMACHAL PRADESH,14,2003,Graduate,8,3,11
HIMACHAL PRADESH,14,2003,Post Graduate and Above,0,1,1
HIMACHAL PRADESH,14,2004,No Education,16,16,32
HIMACHAL PRADESH,14,2004,Primary,43,29,72
HIMACHAL PRADESH,14,2004,Middle,64,43,107
HIMACHAL PRADESH,14,2004,Matriculate/Secondary,85,37,122
HIMACHAL PRADESH,14,2004,Hr. Secondary/Intermediate/Pre-University,16,7,23
HIMACHAL PRADESH,14,2004,Diploma,4,0,4
HIMACHAL PRADESH,14,2004,Graduate,5,2,7
HIMACHAL PRADESH,14,2004,Post Graduate and Above,3,1,4
HIMACHAL PRADESH,14,2005,No Education,14,16,30
HIMACHAL PRADESH,14,2005,Primary,15,20,35
HIMACHAL PRADESH,14,2005,Middle,57,37,94
HIMACHAL PRADESH,14,2005,Matriculate/Secondary,88,43,131
HIMACHAL PRADESH,14,2005,Hr. Secondary/Intermediate/Pre-University,26,23,49
HIMACHAL PRADESH,14,2005,Diploma,3,0,3
HIMACHAL PRADESH,14,2005,Graduate,9,5,14
HIMACHAL PRADESH,14,2005,Post Graduate and Above,2,1,3
HIMACHAL PRADESH,14,2006,No Education,23,20,43
HIMACHAL PRADESH,14,2006,Primary,31,34,65
HIMACHAL PRADESH,14,2006,Middle,64,35,99
HIMACHAL PRADESH,14,2006,Matriculate/Secondary,121,48,169
HIMACHAL PRADESH,14,2006,Hr. Secondary/Intermediate/Pre-University,43,11,54
HIMACHAL PRADESH,14,2006,Diploma,3,2,5
HIMACHAL PRADESH,14,2006,Graduate,11,4,15
HIMACHAL PRADESH,14,2006,Post Graduate and Above,5,2,7
HIMACHAL PRADESH,14,2007,No Education,14,10,24
HIMACHAL PRADESH,14,2007,Primary,32,27,59
HIMACHAL PRADESH,14,2007,Middle,62,32,94
HIMACHAL PRADESH,14,2007,Matriculate/Secondary,116,54,170
HIMACHAL PRADESH,14,2007,Hr. Secondary/Intermediate/Pre-University,22,14,36
HIMACHAL PRADESH,14,2007,Diploma,5,3,8
HIMACHAL PRADESH,14,2007,Graduate,6,4,10
HIMACHAL PRADESH,14,2007,Post Graduate and Above,1,0,1
HIMACHAL PRADESH,14,2008,No Education,29,12,41
HIMACHAL PRADESH,14,2008,Primary,59,32,91
HIMACHAL PRADESH,14,2008,Middle,96,49,145
HIMACHAL PRADESH,14,2008,Matriculate/Secondary,184,76,260
HIMACHAL PRADESH,14,2008,Hr. Secondary/Intermediate/Pre-University,36,39,75
HIMACHAL PRADESH,14,2008,Diploma,1,0,1
HIMACHAL PRADESH,14,2008,Graduate,11,5,16
HIMACHAL PRADESH,14,2008,Post Graduate and Above,1,0,1
HIMACHAL PRADESH,14,2009,No Education,28,22,50
HIMACHAL PRADESH,14,2009,Primary,34,29,63
HIMACHAL PRADESH,14,2009,Middle,71,29,100
HIMACHAL PRADESH,14,2009,Matriculate/Secondary,138,79,217
HIMACHAL PRADESH,14,2009,Hr. Secondary/Intermediate/Pre-University,65,28,93
HIMACHAL PRADESH,14,2009,Diploma,7,1,8
HIMACHAL PRADESH,14,2009,Graduate,23,6,29
HIMACHAL PRADESH,14,2009,Post Graduate and Above,0,0,0
HIMACHAL PRADESH,14,2010,No Education,39,27,66
HIMACHAL PRADESH,14,2010,Primary,45,29,74
HIMACHAL PRADESH,14,2010,Middle,59,36,95
HIMACHAL PRADESH,14,2010,Matriculate/Secondary,126,60,186
HIMACHAL PRADESH,14,2010,Hr. Secondary/Intermediate/Pre-University,51,30,81
HIMACHAL PRADESH,14,2010,Diploma,15,6,21
HIMACHAL PRADESH,14,2010,Graduate,9,6,15
HIMACHAL PRADESH,14,2010,Post Graduate and Above,4,0,4
HIMACHAL PRADESH,14,2011,No Education,37,12,49
HIMACHAL PRADESH,14,2011,Primary,26,25,51
HIMACHAL PRADESH,14,2011,Middle,43,36,79
HIMACHAL PRADESH,14,2011,Matriculate/Secondary,95,62,157
HIMACHAL PRADESH,14,2011,Hr. Secondary/Intermediate/Pre-University,35,30,65
HIMACHAL PRADESH,14,2011,Diploma,7,1,8
HIMACHAL PRADESH,14,2011,Graduate,23,7,30
HIMACHAL PRADESH,14,2011,Post Graduate and Above,3,1,4
HIMACHAL PRADESH,14,2012,No Education,48,21,69
HIMACHAL PRADESH,14,2012,Primary,46,27,73
HIMACHAL PRADESH,14,2012,Middle,58,30,88
HIMACHAL PRADESH,14,2012,Matriculate/Secondary,125,55,180
HIMACHAL PRADESH,14,2012,Hr. Secondary/Intermediate/Pre-University,50,27,77
HIMACHAL PRADESH,14,2012,Diploma,8,3,11
HIMACHAL PRADESH,14,2012,Graduate,11,7,18
HIMACHAL PRADESH,14,2012,Post Graduate and Above,8,4,12
HIMACHAL PRADESH,14,2013,No Education,42,16,58
HIMACHAL PRADESH,14,2013,Primary,58,35,93
HIMACHAL PRADESH,14,2013,Middle,57,32,89
HIMACHAL PRADESH,14,2013,Matriculate/Secondary,116,60,176
HIMACHAL PRADESH,14,2013,Hr. Secondary/Intermediate/Pre-University,44,26,70
HIMACHAL PRADESH,14,2013,Diploma,19,3,22
HIMACHAL PRADESH,14,2013,Graduate,24,14,38
HIMACHAL PRADESH,14,2013,Post Graduate and Above,4,4,8
HIMACHAL PRADESH,14,2014,No Education,56,30,86
HIMACHAL PRADESH,14,2014,Primary,52,35,87
HIMACHAL PRADESH,14,2014,Middle,77,47,124
HIMACHAL PRADESH,14,2014,Matriculate/Secondary,125,85,210
HIMACHAL PRADESH,14,2014,Hr. Secondary/Intermediate/Pre-University,46,35,81
HIMACHAL PRADESH,14,2014,Diploma,1,0,1
HIMACHAL PRADESH,14,2014,Graduate,28,11,39
HIMACHAL PRADESH,14,2014,Post Graduate and Above,2,0,2
JAMMU & KASHMIR,15,2001,No Education,29,19,48
JAMMU & KASHMIR,15,2001,Primary,11,17,28
JAMMU & KASHMIR,15,2001,Middle,17,10,27
JAMMU & KASHMIR,15,2001,Matriculate/Secondary,20,9,29
JAMMU & KASHMIR,15,2001,Hr. Secondary/Intermediate/Pre-University,10,4,14
JAMMU & KASHMIR,15,2001,Diploma,2,0,2
JAMMU & KASHMIR,15,2001,Graduate,2,2,4
JAMMU & KASHMIR,15,2001,Post Graduate and Above,0,1,1
JAMMU & KASHMIR,15,2002,No Education,18,32,50
JAMMU & KASHMIR,15,2002,Primary,18,17,35
JAMMU & KASHMIR,15,2002,Middle,27,19,46
JAMMU & KASHMIR,15,2002,Matriculate/Secondary,20,12,32
JAMMU & KASHMIR,15,2002,Hr. Secondary/Intermediate/Pre-University,8,3,11
JAMMU & KASHMIR,15,2002,Diploma,1,0,1
JAMMU & KASHMIR,15,2002,Graduate,0,1,1
JAMMU & KASHMIR,15,2002,Post Graduate and Above,4,4,8
JAMMU & KASHMIR,15,2003,No Education,9,27,36
JAMMU & KASHMIR,15,2003,Primary,11,16,27
JAMMU & KASHMIR,15,2003,Middle,19,16,35
JAMMU & KASHMIR,15,2003,Matriculate/Secondary,15,9,24
JAMMU & KASHMIR,15,2003,Hr. Secondary/Intermediate/Pre-University,7,2,9
JAMMU & KASHMIR,15,2003,Diploma,0,0,0
JAMMU & KASHMIR,15,2003,Graduate,0,1,1
JAMMU & KASHMIR,15,2003,Post Graduate and Above,2,4,6
JAMMU & KASHMIR,15,2004,No Education,12,20,32
JAMMU & KASHMIR,15,2004,Primary,12,13,25
JAMMU & KASHMIR,15,2004,Middle,9,14,23
JAMMU & KASHMIR,15,2004,Matriculate/Secondary,13,10,23
JAMMU & KASHMIR,15,2004,Hr. Secondary/Intermediate/Pre-University,4,0,4
JAMMU & KASHMIR,15,2004,Diploma,0,0,0
JAMMU & KASHMIR,15,2004,Graduate,0,1,1
JAMMU & KASHMIR,15,2004,Post Graduate and Above,1,3,4
JAMMU & KASHMIR,15,2005,No Education,45,26,71
JAMMU & KASHMIR,15,2005,Primary,41,22,63
JAMMU & KASHMIR,15,2005,Middle,60,30,90
JAMMU & KASHMIR,15,2005,Matriculate/Secondary,31,9,40
JAMMU & KASHMIR,15,2005,Hr. Secondary/Intermediate/Pre-University,13,8,21
JAMMU & KASHMIR,15,2005,Diploma,0,0,0
JAMMU & KASHMIR,15,2005,Graduate,6,3,9
JAMMU & KASHMIR,15,2005,Post Graduate and Above,0,0,0
JAMMU & KASHMIR,15,2006,No Education,30,33,63
JAMMU & KASHMIR,15,2006,Primary,24,20,44
JAMMU & KASHMIR,15,2006,Middle,45,20,65
JAMMU & KASHMIR,15,2006,Matriculate/Secondary,41,25,66
JAMMU & KASHMIR,15,2006,Hr. Secondary/Intermediate/Pre-University,4,6,10
JAMMU & KASHMIR,15,2006,Diploma,1,0,1
JAMMU & KASHMIR,15,2006,Graduate,3,4,7
JAMMU & KASHMIR,15,2006,Post Graduate and Above,4,2,6
JAMMU & KASHMIR,15,2007,No Education,38,22,60
JAMMU & KASHMIR,15,2007,Primary,24,15,39
JAMMU & KASHMIR,15,2007,Middle,39,18,57
JAMMU & KASHMIR,15,2007,Matriculate/Secondary,41,19,60
JAMMU & KASHMIR,15,2007,Hr. Secondary/Intermediate/Pre-University,9,6,15
JAMMU & KASHMIR,15,2007,Diploma,0,0,0
JAMMU & KASHMIR,15,2007,Graduate,1,1,2
JAMMU & KASHMIR,15,2007,Post Graduate and Above,1,0,1
JAMMU & KASHMIR,15,2008,No Education,26,31,57
JAMMU & KASHMIR,15,2008,Primary,14,15,29
JAMMU & KASHMIR,15,2008,Middle,39,28,67
JAMMU & KASHMIR,15,2008,Matriculate/Secondary,56,47,103
JAMMU & KASHMIR,15,2008,Hr. Secondary/Intermediate/Pre-University,24,10,34
JAMMU & KASHMIR,15,2008,Diploma,13,2,15
JAMMU & KASHMIR,15,2008,Graduate,2,0,2
JAMMU & KASHMIR,15,2008,Post Graduate and Above,3,0,3
JAMMU & KASHMIR,15,2009,No Education,23,29,52
JAMMU & KASHMIR,15,2009,Primary,7,20,27
JAMMU & KASHMIR,15,2009,Middle,34,27,61
JAMMU & KASHMIR,15,2009,Matriculate/Secondary,56,45,101
JAMMU & KASHMIR,15,2009,Hr. Secondary/Intermediate/Pre-University,13,11,24
JAMMU & KASHMIR,15,2009,Diploma,7,3,10
JAMMU & KASHMIR,15,2009,Graduate,13,10,23
JAMMU & KASHMIR,15,2009,Post Graduate and Above,15,8,23
JAMMU & KASHMIR,15,2010,No Education,37,34,71
JAMMU & KASHMIR,15,2010,Primary,17,21,38
JAMMU & KASHMIR,15,2010,Middle,26,35,61
JAMMU & KASHMIR,15,2010,Matriculate/Secondary,29,33,62
JAMMU & KASHMIR,15,2010,Hr. Secondary/Intermediate/Pre-University,6,13,19
JAMMU & KASHMIR,15,2010,Diploma,2,0,2
JAMMU & KASHMIR,15,2010,Graduate,4,0,4
JAMMU & KASHMIR,15,2010,Post Graduate and Above,1,1,2
JAMMU & KASHMIR,15,2011,No Education,45,35,80
JAMMU & KASHMIR,15,2011,Primary,16,27,43
JAMMU & KASHMIR,15,2011,Middle,28,34,62
JAMMU & KASHMIR,15,2011,Matriculate/Secondary,32,30,62
JAMMU & KASHMIR,15,2011,Hr. Secondary/Intermediate/Pre-University,11,9,20
JAMMU & KASHMIR,15,2011,Diploma,5,1,6
JAMMU & KASHMIR,15,2011,Graduate,4,3,7
JAMMU & KASHMIR,15,2011,Post Graduate and Above,3,4,7
JAMMU & KASHMIR,15,2012,No Education,36,62,98
JAMMU & KASHMIR,15,2012,Primary,25,44,69
JAMMU & KASHMIR,15,2012,Middle,47,40,87
JAMMU & KASHMIR,15,2012,Matriculate/Secondary,58,52,110
JAMMU & KASHMIR,15,2012,Hr. Secondary/Intermediate/Pre-University,17,17,34
JAMMU & KASHMIR,15,2012,Diploma,3,2,5
JAMMU & KASHMIR,15,2012,Graduate,5,5,10
JAMMU & KASHMIR,15,2012,Post Graduate and Above,1,0,1
JAMMU & KASHMIR,15,2013,No Education,33,45,78
JAMMU & KASHMIR,15,2013,Primary,30,12,42
JAMMU & KASHMIR,15,2013,Middle,40,26,66
JAMMU & KASHMIR,15,2013,Matriculate/Secondary,43,35,78
JAMMU & KASHMIR,15,2013,Hr. Secondary/Intermediate/Pre-University,18,12,30
JAMMU & KASHMIR,15,2013,Diploma,1,0,1
JAMMU & KASHMIR,15,2013,Graduate,2,2,4
JAMMU & KASHMIR,15,2013,Post Graduate and Above,1,2,3
JAMMU & KASHMIR,15,2014,No Education,34,20,54
JAMMU & KASHMIR,15,2014,Primary,17,8,25
JAMMU & KASHMIR,15,2014,Middle,32,19,51
JAMMU & KASHMIR,15,2014,Matriculate/Secondary,45,19,64
JAMMU & KASHMIR,15,2014,Hr. Secondary/Intermediate/Pre-University,3,17,20
JAMMU & KASHMIR,15,2014,Diploma,0,0,0
JAMMU & KASHMIR,15,2014,Graduate,1,1,2
JAMMU & KASHMIR,15,2014,Post Graduate and Above,0,0,0
JHARKHAND,16,2001,No Education,84,84,168
JHARKHAND,16,2001,Primary,23,10,33
JHARKHAND,16,2001,Middle,19,5,24
JHARKHAND,16,2001,Matriculate/Secondary,13,5,18
JHARKHAND,16,2001,Hr. Secondary/Intermediate/Pre-University,1,5,6
JHARKHAND,16,2001,Diploma,0,0,0
JHARKHAND,16,2001,Graduate,1,0,1
JHARKHAND,16,2001,Post Graduate and Above,0,0,0
JHARKHAND,16,2002,No Education,65,60,125
JHARKHAND,16,2002,Primary,12,15,27
JHARKHAND,16,2002,Middle,12,14,26
JHARKHAND,16,2002,Matriculate/Secondary,15,4,19
JHARKHAND,16,2002,Hr. Secondary/Intermediate/Pre-University,30,1,31
JHARKHAND,16,2002,Diploma,2,0,2
JHARKHAND,16,2002,Graduate,11,25,36
JHARKHAND,16,2002,Post Graduate and Above,6,0,6
JHARKHAND,16,2003,No Education,64,65,129
JHARKHAND,16,2003,Primary,14,14,28
JHARKHAND,16,2003,Middle,13,15,28
JHARKHAND,16,2003,Matriculate/Secondary,16,5,21
JHARKHAND,16,2003,Hr. Secondary/Intermediate/Pre-University,24,2,26
JHARKHAND,16,2003,Diploma,3,0,3
JHARKHAND,16,2003,Graduate,12,18,30
JHARKHAND,16,2003,Post Graduate and Above,7,0,7
JHARKHAND,16,2004,No Education,73,71,144
JHARKHAND,16,2004,Primary,29,23,52
JHARKHAND,16,2004,Middle,21,33,54
JHARKHAND,16,2004,Matriculate/Secondary,36,22,58
JHARKHAND,16,2004,Hr. Secondary/Intermediate/Pre-University,40,10,50
JHARKHAND,16,2004,Diploma,5,0,5
JHARKHAND,16,2004,Graduate,17,23,40
JHARKHAND,16,2004,Post Graduate and Above,12,2,14
JHARKHAND,16,2005,No Education,112,123,235
JHARKHAND,16,2005,Primary,106,40,146
JHARKHAND,16,2005,Middle,85,40,125
JHARKHAND,16,2005,Matriculate/Secondary,118,48,166
JHARKHAND,16,2005,Hr. Secondary/Intermediate/Pre-University,74,22,96
JHARKHAND,16,2005,Diploma,4,0,4
JHARKHAND,16,2005,Graduate,22,10,32
JHARKHAND,16,2005,Post Graduate and Above,2,2,4
JHARKHAND,16,2006,No Education,151,97,248
JHARKHAND,16,2006,Primary,102,49,151
JHARKHAND,16,2006,Middle,98,71,169
JHARKHAND,16,2006,Matriculate/Secondary,82,75,157
JHARKHAND,16,2006,Hr. Secondary/Intermediate/Pre-University,66,26,92
JHARKHAND,16,2006,Diploma,4,1,5
JHARKHAND,16,2006,Graduate,16,15,31
JHARKHAND,16,2006,Post Graduate and Above,2,1,3
JHARKHAND,16,2007,No Education,286,180,466
JHARKHAND,16,2007,Primary,127,49,176
JHARKHAND,16,2007,Middle,185,68,253
JHARKHAND,16,2007,Matriculate/Secondary,164,52,216
JHARKHAND,16,2007,Hr. Secondary/Intermediate/Pre-University,79,30,109
JHARKHAND,16,2007,Diploma,8,1,9
JHARKHAND,16,2007,Graduate,30,27,57
JHARKHAND,16,2007,Post Graduate and Above,1,2,3
JHARKHAND,16,2008,No Education,171,120,291
JHARKHAND,16,2008,Primary,128,48,176
JHARKHAND,16,2008,Middle,126,50,176
JHARKHAND,16,2008,Matriculate/Secondary,98,54,152
JHARKHAND,16,2008,Hr. Secondary/Intermediate/Pre-University,51,20,71
JHARKHAND,16,2008,Diploma,6,0,6
JHARKHAND,16,2008,Graduate,21,11,32
JHARKHAND,16,2008,Post Graduate and Above,1,6,7
JHARKHAND,16,2009,No Education,238,106,344
JHARKHAND,16,2009,Primary,117,80,197
JHARKHAND,16,2009,Middle,126,78,204
JHARKHAND,16,2009,Matriculate/Secondary,105,43,148
JHARKHAND,16,2009,Hr. Secondary/Intermediate/Pre-University,119,46,165
JHARKHAND,16,2009,Diploma,8,0,8
JHARKHAND,16,2009,Graduate,27,13,40
JHARKHAND,16,2009,Post Graduate and Above,4,2,6
JHARKHAND,16,2010,No Education,151,140,291
JHARKHAND,16,2010,Primary,107,74,181
JHARKHAND,16,2010,Middle,142,83,225
JHARKHAND,16,2010,Matriculate/Secondary,171,78,249
JHARKHAND,16,2010,Hr. Secondary/Intermediate/Pre-University,124,45,169
JHARKHAND,16,2010,Diploma,10,1,11
JHARKHAND,16,2010,Graduate,29,13,42
JHARKHAND,16,2010,Post Graduate and Above,61,3,64
JHARKHAND,16,2011,No Education,148,100,248
JHARKHAND,16,2011,Primary,138,70,208
JHARKHAND,16,2011,Middle,149,67,216
JHARKHAND,16,2011,Matriculate/Secondary,223,76,299
JHARKHAND,16,2011,Hr. Secondary/Intermediate/Pre-University,84,35,119
JHARKHAND,16,2011,Diploma,8,3,11
JHARKHAND,16,2011,Graduate,75,36,111
JHARKHAND,16,2011,Post Graduate and Above,0,0,0
JHARKHAND,16,2012,No Education,199,130,329
JHARKHAND,16,2012,Primary,83,83,166
JHARKHAND,16,2012,Middle,177,128,305
JHARKHAND,16,2012,Matriculate/Secondary,183,69,252
JHARKHAND,16,2012,Hr. Secondary/Intermediate/Pre-University,144,49,193
JHARKHAND,16,2012,Diploma,19,9,28
JHARKHAND,16,2012,Graduate,28,11,39
JHARKHAND,16,2012,Post Graduate and Above,5,2,7
JHARKHAND,16,2013,No Education,225,136,361
JHARKHAND,16,2013,Primary,163,91,254
JHARKHAND,16,2013,Middle,147,95,242
JHARKHAND,16,2013,Matriculate/Secondary,282,92,374
JHARKHAND,16,2013,Hr. Secondary/Intermediate/Pre-University,100,43,143
JHARKHAND,16,2013,Diploma,10,4,14
JHARKHAND,16,2013,Graduate,45,12,57
JHARKHAND,16,2013,Post Graduate and Above,12,3,15
JHARKHAND,16,2014,No Education,293,146,439
JHARKHAND,16,2014,Primary,277,128,405
JHARKHAND,16,2014,Middle,80,23,103
JHARKHAND,16,2014,Matriculate/Secondary,49,45,94
JHARKHAND,16,2014,Hr. Secondary/Intermediate/Pre-University,42,7,49
JHARKHAND,16,2014,Diploma,13,2,15
JHARKHAND,16,2014,Graduate,44,15,59
JHARKHAND,16,2014,Post Graduate and Above,4,1,5
KARNATAKA,17,2001,No Education,2640,1550,4190
KARNATAKA,17,2001,Primary,2059,1006,3065
KARNATAKA,17,2001,Middle,1485,780,2265
KARNATAKA,17,2001,Matriculate/Secondary,1051,412,1463
KARNATAKA,17,2001,Hr. Secondary/Intermediate/Pre-University,408,199,607
KARNATAKA,17,2001,Diploma,87,10,97
KARNATAKA,17,2001,Graduate,123,47,170
KARNATAKA,17,2001,Post Graduate and Above,18,6,24
KARNATAKA,17,2002,No Education,2435,1519,3954
KARNATAKA,17,2002,Primary,2093,1060,3153
KARNATAKA,17,2002,Middle,1703,731,2434
KARNATAKA,17,2002,Matriculate/Secondary,1035,456,1491
KARNATAKA,17,2002,Hr. Secondary/Intermediate/Pre-University,572,241,813
KARNATAKA,17,2002,Diploma,76,74,150
KARNATAKA,17,2002,Graduate,139,102,241
KARNATAKA,17,2002,Post Graduate and Above,27,7,34
KARNATAKA,17,2003,No Education,2619,1433,4052
KARNATAKA,17,2003,Primary,2281,1062,3343
KARNATAKA,17,2003,Middle,1542,776,2318
KARNATAKA,17,2003,Matriculate/Secondary,1151,469,1620
KARNATAKA,17,2003,Hr. Secondary/Intermediate/Pre-University,554,184,738
KARNATAKA,17,2003,Diploma,70,25,95
KARNATAKA,17,2003,Graduate,135,34,169
KARNATAKA,17,2003,Post Graduate and Above,23,3,26
KARNATAKA,17,2004,No Education,2159,1263,3422
KARNATAKA,17,2004,Primary,2173,1008,3181
KARNATAKA,17,2004,Middle,1729,881,2610
KARNATAKA,17,2004,Matriculate/Secondary,1184,471,1655
KARNATAKA,17,2004,Hr. Secondary/Intermediate/Pre-University,501,213,714
KARNATAKA,17,2004,Diploma,49,10,59
KARNATAKA,17,2004,Graduate,162,51,213
KARNATAKA,17,2004,Post Graduate and Above,61,22,83
KARNATAKA,17,2005,No Education,2021,1125,3146
KARNATAKA,17,2005,Primary,2051,1142,3193
KARNATAKA,17,2005,Middle,1835,832,2667
KARNATAKA,17,2005,Matriculate/Secondary,1165,480,1645
KARNATAKA,17,2005,Hr. Secondary/Intermediate/Pre-University,456,206,662
KARNATAKA,17,2005,Diploma,45,17,62
KARNATAKA,17,2005,Graduate,111,44,155
KARNATAKA,17,2005,Post Graduate and Above,23,4,27
KARNATAKA,17,2006,No Education,2179,1320,3499
KARNATAKA,17,2006,Primary,2054,1104,3158
KARNATAKA,17,2006,Middle,1679,795,2474
KARNATAKA,17,2006,Matriculate/Secondary,1357,595,1952
KARNATAKA,17,2006,Hr. Secondary/Intermediate/Pre-University,550,288,838
KARNATAKA,17,2006,Diploma,69,8,77
KARNATAKA,17,2006,Graduate,142,51,193
KARNATAKA,17,2006,Post Graduate and Above,18,3,21
KARNATAKA,17,2007,No Education,1979,1190,3169
KARNATAKA,17,2007,Primary,2348,1171,3519
KARNATAKA,17,2007,Middle,1712,635,2347
KARNATAKA,17,2007,Matriculate/Secondary,1522,584,2106
KARNATAKA,17,2007,Hr. Secondary/Intermediate/Pre-University,580,237,817
KARNATAKA,17,2007,Diploma,78,19,97
KARNATAKA,17,2007,Graduate,152,65,217
KARNATAKA,17,2007,Post Graduate and Above,21,11,32
KARNATAKA,17,2008,No Education,1961,1100,3061
KARNATAKA,17,2008,Primary,2102,1095,3197
KARNATAKA,17,2008,Middle,1637,708,2345
KARNATAKA,17,2008,Matriculate/Secondary,1550,684,2234
KARNATAKA,17,2008,Hr. Secondary/Intermediate/Pre-University,605,294,899
KARNATAKA,17,2008,Diploma,69,16,85
KARNATAKA,17,2008,Graduate,273,99,372
KARNATAKA,17,2008,Post Graduate and Above,19,10,29
KARNATAKA,17,2009,No Education,2683,1455,4138
KARNATAKA,17,2009,Primary,2003,960,2963
KARNATAKA,17,2009,Middle,1378,542,1920
KARNATAKA,17,2009,Matriculate/Secondary,1268,625,1893
KARNATAKA,17,2009,Hr. Secondary/Intermediate/Pre-University,576,301,877
KARNATAKA,17,2009,Diploma,61,20,81
KARNATAKA,17,2009,Graduate,203,69,272
KARNATAKA,17,2009,Post Graduate and Above,37,14,51
KARNATAKA,17,2010,No Education,1903,1300,3203
KARNATAKA,17,2010,Primary,2192,1058,3250
KARNATAKA,17,2010,Middle,1585,666,2251
KARNATAKA,17,2010,Matriculate/Secondary,1696,828,2524
KARNATAKA,17,2010,Hr. Secondary/Intermediate/Pre-University,623,285,908
KARNATAKA,17,2010,Diploma,158,28,186
KARNATAKA,17,2010,Graduate,218,63,281
KARNATAKA,17,2010,Post Graduate and Above,32,16,48
KARNATAKA,17,2011,No Education,2111,1301,3412
KARNATAKA,17,2011,Primary,2138,952,3090
KARNATAKA,17,2011,Middle,1650,741,2391
KARNATAKA,17,2011,Matriculate/Secondary,1319,577,1896
KARNATAKA,17,2011,Hr. Secondary/Intermediate/Pre-University,745,344,1089
KARNATAKA,17,2011,Diploma,143,63,206
KARNATAKA,17,2011,Graduate,299,127,426
KARNATAKA,17,2011,Post Graduate and Above,67,45,112
KARNATAKA,17,2012,No Education,2027,1038,3065
KARNATAKA,17,2012,Primary,2002,993,2995
KARNATAKA,17,2012,Middle,1806,898,2704
KARNATAKA,17,2012,Matriculate/Secondary,1435,658,2093
KARNATAKA,17,2012,Hr. Secondary/Intermediate/Pre-University,923,421,1344
KARNATAKA,17,2012,Diploma,85,19,104
KARNATAKA,17,2012,Graduate,250,117,367
KARNATAKA,17,2012,Post Graduate and Above,68,13,81
KARNATAKA,17,2013,No Education,1559,817,2376
KARNATAKA,17,2013,Primary,1554,749,2303
KARNATAKA,17,2013,Middle,1680,731,2411
KARNATAKA,17,2013,Matriculate/Secondary,1602,670,2272
KARNATAKA,17,2013,Hr. Secondary/Intermediate/Pre-University,883,372,1255
KARNATAKA,17,2013,Diploma,109,57,166
KARNATAKA,17,2013,Graduate,287,120,407
KARNATAKA,17,2013,Post Graduate and Above,59,17,76
KARNATAKA,17,2014,No Education,1216,555,1771
KARNATAKA,17,2014,Primary,1423,608,2031
KARNATAKA,17,2014,Middle,1230,549,1779
KARNATAKA,17,2014,Matriculate/Secondary,1673,738,2411
KARNATAKA,17,2014,Hr. Secondary/Intermediate/Pre-University,891,369,1260
KARNATAKA,17,2014,Diploma,81,30,111
KARNATAKA,17,2014,Graduate,249,119,368
KARNATAKA,17,2014,Post Graduate and Above,32,9,41
KERALA,18,2001,No Education,311,186,497
KERALA,18,2001,Primary,1691,781,2472
KERALA,18,2001,Middle,2303,923,3226
KERALA,18,2001,Matriculate/Secondary,1734,582,2316
KERALA,18,2001,Hr. Secondary/Intermediate/Pre-University,512,221,733
KERALA,18,2001,Diploma,47,8,55
KERALA,18,2001,Graduate,139,61,200
KERALA,18,2001,Post Graduate and Above,50,23,73
KERALA,18,2002,No Education,453,207,660
KERALA,18,2002,Primary,1695,729,2424
KERALA,18,2002,Middle,2305,755,3060
KERALA,18,2002,Matriculate/Secondary,1920,693,2613
KERALA,18,2002,Hr. Secondary/Intermediate/Pre-University,540,159,699
KERALA,18,2002,Diploma,88,20,108
KERALA,18,2002,Graduate,124,63,187
KERALA,18,2002,Post Graduate and Above,40,19,59
KERALA,18,2003,No Education,512,260,772
KERALA,18,2003,Primary,2084,752,2836
KERALA,18,2003,Middle,2216,703,2919
KERALA,18,2003,Matriculate/Secondary,1593,539,2132
KERALA,18,2003,Hr. Secondary/Intermediate/Pre-University,375,158,533
KERALA,18,2003,Diploma,33,19,52
KERALA,18,2003,Graduate,106,60,166
KERALA,18,2003,Post Graduate and Above,16,12,28
KERALA,18,2004,No Education,483,244,727
KERALA,18,2004,Primary,1749,701,2450
KERALA,18,2004,Middle,2188,683,2871
KERALA,18,2004,Matriculate/Secondary,1583,561,2144
KERALA,18,2004,Hr. Secondary/Intermediate/Pre-University,433,187,620
KERALA,18,2004,Diploma,46,16,62
KERALA,18,2004,Graduate,107,53,160
KERALA,18,2004,Post Graduate and Above,9,10,19
KERALA,18,2005,No Education,300,178,478
KERALA,18,2005,Primary,1379,554,1933
KERALA,18,2005,Middle,2289,678,2967
KERALA,18,2005,Matriculate/Secondary,2152,659,2811
KERALA,18,2005,Hr. Secondary/Intermediate/Pre-University,550,252,802
KERALA,18,2005,Diploma,42,13,55
KERALA,18,2005,Graduate,101,68,169
KERALA,18,2005,Post Graduate and Above,17,12,29
KERALA,18,2006,No Education,274,160,434
KERALA,18,2006,Primary,1368,534,1902
KERALA,18,2006,Middle,2205,707,2912
KERALA,18,2006,Matriculate/Secondary,1933,670,2603
KERALA,18,2006,Hr. Secondary/Intermediate/Pre-University,613,272,885
KERALA,18,2006,Diploma,54,12,66
KERALA,18,2006,Graduate,120,77,197
KERALA,18,2006,Post Graduate and Above,16,11,27
KERALA,18,2007,No Education,202,142,344
KERALA,18,2007,Primary,1414,478,1892
KERALA,18,2007,Middle,2065,657,2722
KERALA,18,2007,Matriculate/Secondary,2031,671,2702
KERALA,18,2007,Hr. Secondary/Intermediate/Pre-University,610,290,900
KERALA,18,2007,Diploma,73,33,106
KERALA,18,2007,Graduate,166,88,254
KERALA,18,2007,Post Graduate and Above,27,15,42
KERALA,18,2008,No Education,199,102,301
KERALA,18,2008,Primary,1254,536,1790
KERALA,18,2008,Middle,1990,636,2626
KERALA,18,2008,Matriculate/Secondary,1840,742,2582
KERALA,18,2008,Hr. Secondary/Intermediate/Pre-University,601,304,905
KERALA,18,2008,Diploma,52,21,73
KERALA,18,2008,Graduate,162,78,240
KERALA,18,2008,Post Graduate and Above,32,20,52
KERALA,18,2009,No Education,116,61,177
KERALA,18,2009,Primary,1156,498,1654
KERALA,18,2009,Middle,2083,625,2708
KERALA,18,2009,Matriculate/Secondary,1853,740,2593
KERALA,18,2009,Hr. Secondary/Intermediate/Pre-University,841,384,1225
KERALA,18,2009,Diploma,59,20,79
KERALA,18,2009,Graduate,182,92,274
KERALA,18,2009,Post Graduate and Above,32,13,45
KERALA,18,2010,No Education,190,96,286
KERALA,18,2010,Primary,1339,531,1870
KERALA,18,2010,Middle,1972,544,2516
KERALA,18,2010,Matriculate/Secondary,1762,640,2402
KERALA,18,2010,Hr. Secondary/Intermediate/Pre-University,775,319,1094
KERALA,18,2010,Diploma,66,15,81
KERALA,18,2010,Graduate,195,82,277
KERALA,18,2010,Post Graduate and Above,47,13,60
KERALA,18,2011,No Education,100,70,170
KERALA,18,2011,Primary,1196,489,1685
KERALA,18,2011,Middle,2020,578,2598
KERALA,18,2011,Matriculate/Secondary,1774,572,2346
KERALA,18,2011,Hr. Secondary/Intermediate/Pre-University,793,357,1150
KERALA,18,2011,Diploma,71,25,96
KERALA,18,2011,Graduate,224,101,325
KERALA,18,2011,Post Graduate and Above,34,27,61
KERALA,18,2012,No Education,98,57,155
KERALA,18,2012,Primary,1403,475,1878
KERALA,18,2012,Middle,1806,470,2276
KERALA,18,2012,Matriculate/Secondary,1991,591,2582
KERALA,18,2012,Hr. Secondary/Intermediate/Pre-University,736,329,1065
KERALA,18,2012,Diploma,90,29,119
KERALA,18,2012,Graduate,246,113,359
KERALA,18,2012,Post Graduate and Above,39,17,56
KERALA,18,2013,No Education,119,56,175
KERALA,18,2013,Primary,1368,433,1801
KERALA,18,2013,Middle,1838,435,2273
KERALA,18,2013,Matriculate/Secondary,2049,491,2540
KERALA,18,2013,Hr. Secondary/Intermediate/Pre-University,942,354,1296
KERALA,18,2013,Diploma,91,31,122
KERALA,18,2013,Graduate,265,123,388
KERALA,18,2013,Post Graduate and Above,29,22,51
KERALA,18,2014,No Education,213,94,307
KERALA,18,2014,Primary,1099,396,1495
KERALA,18,2014,Middle,1336,432,1768
KERALA,18,2014,Matriculate/Secondary,2067,584,2651
KERALA,18,2014,Hr. Secondary/Intermediate/Pre-University,1051,342,1393
KERALA,18,2014,Diploma,130,21,151
KERALA,18,2014,Graduate,199,93,292
KERALA,18,2014,Post Graduate and Above,7,10,17
LAKSHADWEEP,19,2001,No Education,0,0,0
LAKSHADWEEP,19,2001,Primary,0,0,0
LAKSHADWEEP,19,2001,Middle,0,0,0
LAKSHADWEEP,19,2001,Matriculate/Secondary,0,0,0
LAKSHADWEEP,19,2001,Hr. Secondary/Intermediate/Pre-University,0,0,0
LAKSHADWEEP,19,2001,Diploma,0,0,0
LAKSHADWEEP,19,2001,Graduate,0,0,0
LAKSHADWEEP,19,2001,Post Graduate and Above,0,0,0
LAKSHADWEEP,19,2002,No Education,0,0,0
LAKSHADWEEP,19,2002,Primary,0,0,0
LAKSHADWEEP,19,2002,Middle,0,0,0
LAKSHADWEEP,19,2002,Matriculate/Secondary,0,0,0
LAKSHADWEEP,19,2002,Hr. Secondary/Intermediate/Pre-University,0,0,0
LAKSHADWEEP,19,2002,Diploma,0,0,0
LAKSHADWEEP,19,2002,Graduate,0,0,0
LAKSHADWEEP,19,2002,Post Graduate and Above,0,0,0
LAKSHADWEEP,19,2003,No Education,0,0,0
LAKSHADWEEP,19,2003,Primary,1,0,1
LAKSHADWEEP,19,2003,Middle,0,1,1
LAKSHADWEEP,19,2003,Matriculate/Secondary,0,0,0
LAKSHADWEEP,19,2003,Hr. Secondary/Intermediate/Pre-University,0,0,0
LAKSHADWEEP,19,2003,Diploma,0,0,0
LAKSHADWEEP,19,2003,Graduate,0,0,0
LAKSHADWEEP,19,2003,Post Graduate and Above,0,0,0
LAKSHADWEEP,19,2004,No Education,0,0,0
LAKSHADWEEP,19,2004,Primary,0,0,0
LAKSHADWEEP,19,2004,Middle,0,0,0
LAKSHADWEEP,19,2004,Matriculate/Secondary,0,0,0
LAKSHADWEEP,19,2004,Hr. Secondary/Intermediate/Pre-University,0,0,0
LAKSHADWEEP,19,2004,Diploma,0,0,0
LAKSHADWEEP,19,2004,Graduate,0,0,0
LAKSHADWEEP,19,2004,Post Graduate and Above,0,0,0
LAKSHADWEEP,19,2005,No Education,0,0,0
LAKSHADWEEP,19,2005,Primary,0,0,0
LAKSHADWEEP,19,2005,Middle,0,0,0
LAKSHADWEEP,19,2005,Matriculate/Secondary,0,0,0
LAKSHADWEEP,19,2005,Hr. Secondary/Intermediate/Pre-University,0,0,0
LAKSHADWEEP,19,2005,Diploma,0,0,0
LAKSHADWEEP,19,2005,Graduate,0,0,0
LAKSHADWEEP,19,2005,Post Graduate and Above,0,0,0
LAKSHADWEEP,19,2006,No Education,0,0,0
LAKSHADWEEP,19,2006,Primary,0,0,0
LAKSHADWEEP,19,2006,Middle,0,0,0
LAKSHADWEEP,19,2006,Matriculate/Secondary,0,1,1
LAKSHADWEEP,19,2006,Hr. Secondary/Intermediate/Pre-University,0,0,0
LAKSHADWEEP,19,2006,Diploma,0,0,0
LAKSHADWEEP,19,2006,Graduate,1,0,1
LAKSHADWEEP,19,2006,Post Graduate and Above,0,0,0
LAKSHADWEEP,19,2007,No Education,0,0,0
LAKSHADWEEP,19,2007,Primary,0,0,0
LAKSHADWEEP,19,2007,Middle,0,0,0
LAKSHADWEEP,19,2007,Matriculate/Secondary,1,2,3
LAKSHADWEEP,19,2007,Hr. Secondary/Intermediate/Pre-University,0,0,0
LAKSHADWEEP,19,2007,Diploma,0,0,0
LAKSHADWEEP,19,2007,Graduate,0,0,0
LAKSHADWEEP,19,2007,Post Graduate and Above,0,0,0
LAKSHADWEEP,19,2008,No Education,0,0,0
LAKSHADWEEP,19,2008,Primary,0,0,0
LAKSHADWEEP,19,2008,Middle,0,0,0
LAKSHADWEEP,19,2008,Matriculate/Secondary,0,0,0
LAKSHADWEEP,19,2008,Hr. Secondary/Intermediate/Pre-University,0,0,0
LAKSHADWEEP,19,2008,Diploma,0,0,0
LAKSHADWEEP,19,2008,Graduate,0,0,0
LAKSHADWEEP,19,2008,Post Graduate and Above,0,0,0
LAKSHADWEEP,19,2009,No Education,0,0,0
LAKSHADWEEP,19,2009,Primary,0,0,0
LAKSHADWEEP,19,2009,Middle,0,0,0
LAKSHADWEEP,19,2009,Matriculate/Secondary,0,1,1
LAKSHADWEEP,19,2009,Hr. Secondary/Intermediate/Pre-University,0,0,0
LAKSHADWEEP,19,2009,Diploma,0,0,0
LAKSHADWEEP,19,2009,Graduate,0,0,0
LAKSHADWEEP,19,2009,Post Graduate and Above,0,0,0
LAKSHADWEEP,19,2010,No Education,0,0,0
LAKSHADWEEP,19,2010,Primary,0,0,0
LAKSHADWEEP,19,2010,Middle,0,1,1
LAKSHADWEEP,19,2010,Matriculate/Secondary,0,0,0
LAKSHADWEEP,19,2010,Hr. Secondary/Intermediate/Pre-University,0,0,0
LAKSHADWEEP,19,2010,Diploma,0,0,0
LAKSHADWEEP,19,2010,Graduate,0,0,0
LAKSHADWEEP,19,2010,Post Graduate and Above,0,0,0
LAKSHADWEEP,19,2011,No Education,0,0,0
LAKSHADWEEP,19,2011,Primary,0,0,0
LAKSHADWEEP,19,2011,Middle,0,0,0
LAKSHADWEEP,19,2011,Matriculate/Secondary,0,0,0
LAKSHADWEEP,19,2011,Hr. Secondary/Intermediate/Pre-University,0,0,0
LAKSHADWEEP,19,2011,Diploma,0,0,0
LAKSHADWEEP,19,2011,Graduate,0,0,0
LAKSHADWEEP,19,2011,Post Graduate and Above,0,0,0
LAKSHADWEEP,19,2012,No Education,0,0,0
LAKSHADWEEP,19,2012,Primary,1,0,1
LAKSHADWEEP,19,2012,Middle,0,0,0
LAKSHADWEEP,19,2012,Matriculate/Secondary,0,0,0
LAKSHADWEEP,19,2012,Hr. Secondary/Intermediate/Pre-University,0,0,0
LAKSHADWEEP,19,2012,Diploma,0,0,0
LAKSHADWEEP,19,2012,Graduate,0,0,0
LAKSHADWEEP,19,2012,Post Graduate and Above,0,0,0
LAKSHADWEEP,19,2013,No Education,0,0,0
LAKSHADWEEP,19,2013,Primary,0,0,0
LAKSHADWEEP,19,2013,Middle,1,1,2
LAKSHADWEEP,19,2013,Matriculate/Secondary,0,0,0
LAKSHADWEEP,19,2013,Hr. Secondary/Intermediate/Pre-University,0,0,0
LAKSHADWEEP,19,2013,Diploma,0,1,1
LAKSHADWEEP,19,2013,Graduate,0,0,0
LAKSHADWEEP,19,2013,Post Graduate and Above,0,0,0
LAKSHADWEEP,19,2014,No Education,0,0,0
LAKSHADWEEP,19,2014,Primary,0,0,0
LAKSHADWEEP,19,2014,Middle,0,0,0
LAKSHADWEEP,19,2014,Matriculate/Secondary,0,0,0
LAKSHADWEEP,19,2014,Hr. Secondary/Intermediate/Pre-University,2,1,3
LAKSHADWEEP,19,2014,Diploma,0,0,0
LAKSHADWEEP,19,2014,Graduate,0,0,0
LAKSHADWEEP,19,2014,Post Graduate and Above,0,0,0
MADHYA PRADESH,20,2001,No Education,1008,1259,2267
MADHYA PRADESH,20,2001,Primary,984,795,1779
MADHYA PRADESH,20,2001,Middle,714,668,1382
MADHYA PRADESH,20,2001,Matriculate/Secondary,449,361,810
MADHYA PRADESH,20,2001,Hr. Secondary/Intermediate/Pre-University,288,193,481
MADHYA PRADESH,20,2001,Diploma,32,7,39
MADHYA PRADESH,20,2001,Graduate,35,24,59
MADHYA PRADESH,20,2001,Post Graduate and Above,26,17,43
MADHYA PRADESH,20,2002,No Education,855,1062,1917
MADHYA PRADESH,20,2002,Primary,983,913,1896
MADHYA PRADESH,20,2002,Middle,855,685,1540
MADHYA PRADESH,20,2002,Matriculate/Secondary,503,421,924
MADHYA PRADESH,20,2002,Hr. Secondary/Intermediate/Pre-University,311,206,517
MADHYA PRADESH,20,2002,Diploma,18,10,28
MADHYA PRADESH,20,2002,Graduate,42,19,61
MADHYA PRADESH,20,2002,Post Graduate and Above,12,4,16
MADHYA PRADESH,20,2003,No Education,920,1050,1970
MADHYA PRADESH,20,2003,Primary,1005,811,1816
MADHYA PRADESH,20,2003,Middle,704,696,1400
MADHYA PRADESH,20,2003,Matriculate/Secondary,565,435,1000
MADHYA PRADESH,20,2003,Hr. Secondary/Intermediate/Pre-University,285,185,470
MADHYA PRADESH,20,2003,Diploma,13,6,19
MADHYA PRADESH,20,2003,Graduate,42,34,76
MADHYA PRADESH,20,2003,Post Graduate and Above,4,7,11
MADHYA PRADESH,20,2004,No Education,723,867,1590
MADHYA PRADESH,20,2004,Primary,862,791,1653
MADHYA PRADESH,20,2004,Middle,815,669,1484
MADHYA PRADESH,20,2004,Matriculate/Secondary,650,479,1129
MADHYA PRADESH,20,2004,Hr. Secondary/Intermediate/Pre-University,412,269,681
MADHYA PRADESH,20,2004,Diploma,25,11,36
MADHYA PRADESH,20,2004,Graduate,63,33,96
MADHYA PRADESH,20,2004,Post Graduate and Above,84,42,126
MADHYA PRADESH,20,2005,No Education,754,841,1595
MADHYA PRADESH,20,2005,Primary,650,642,1292
MADHYA PRADESH,20,2005,Middle,682,580,1262
MADHYA PRADESH,20,2005,Matriculate/Secondary,470,348,818
MADHYA PRADESH,20,2005,Hr. Secondary/Intermediate/Pre-University,211,139,350
MADHYA PRADESH,20,2005,Diploma,24,21,45
MADHYA PRADESH,20,2005,Graduate,49,16,65
MADHYA PRADESH,20,2005,Post Graduate and Above,11,10,21
MADHYA PRADESH,20,2006,No Education,948,863,1811
MADHYA PRADESH,20,2006,Primary,929,792,1721
MADHYA PRADESH,20,2006,Middle,657,592,1249
MADHYA PRADESH,20,2006,Matriculate/Secondary,544,387,931
MADHYA PRADESH,20,2006,Hr. Secondary/Intermediate/Pre-University,334,238,572
MADHYA PRADESH,20,2006,Diploma,28,23,51
MADHYA PRADESH,20,2006,Graduate,37,29,66
MADHYA PRADESH,20,2006,Post Graduate and Above,26,8,34
MADHYA PRADESH,20,2007,No Education,855,739,1594
MADHYA PRADESH,20,2007,Primary,777,740,1517
MADHYA PRADESH,20,2007,Middle,789,628,1417
MADHYA PRADESH,20,2007,Matriculate/Secondary,665,473,1138
MADHYA PRADESH,20,2007,Hr. Secondary/Intermediate/Pre-University,321,240,561
MADHYA PRADESH,20,2007,Diploma,18,18,36
MADHYA PRADESH,20,2007,Graduate,38,19,57
MADHYA PRADESH,20,2007,Post Graduate and Above,7,2,9
MADHYA PRADESH,20,2008,No Education,991,922,1913
MADHYA PRADESH,20,2008,Primary,971,854,1825
MADHYA PRADESH,20,2008,Middle,947,681,1628
MADHYA PRADESH,20,2008,Matriculate/Secondary,748,387,1135
MADHYA PRADESH,20,2008,Hr. Secondary/Intermediate/Pre-University,522,366,888
MADHYA PRADESH,20,2008,Diploma,42,18,60
MADHYA PRADESH,20,2008,Graduate,107,34,141
MADHYA PRADESH,20,2008,Post Graduate and Above,37,2,39
MADHYA PRADESH,20,2009,No Education,1132,1100,2232
MADHYA PRADESH,20,2009,Primary,1149,864,2013
MADHYA PRADESH,20,2009,Middle,1143,892,2035
MADHYA PRADESH,20,2009,Matriculate/Secondary,818,573,1391
MADHYA PRADESH,20,2009,Hr. Secondary/Intermediate/Pre-University,627,473,1100
MADHYA PRADESH,20,2009,Diploma,66,45,111
MADHYA PRADESH,20,2009,Graduate,71,41,112
MADHYA PRADESH,20,2009,Post Graduate and Above,94,25,119
MADHYA PRADESH,20,2010,No Education,1149,988,2137
MADHYA PRADESH,20,2010,Primary,1088,910,1998
MADHYA PRADESH,20,2010,Middle,1115,863,1978
MADHYA PRADESH,20,2010,Matriculate/Secondary,937,621,1558
MADHYA PRADESH,20,2010,Hr. Secondary/Intermediate/Pre-University,536,382,918
MADHYA PRADESH,20,2010,Diploma,83,60,143
MADHYA PRADESH,20,2010,Graduate,111,59,170
MADHYA PRADESH,20,2010,Post Graduate and Above,68,33,101
MADHYA PRADESH,20,2011,No Education,1043,905,1948
MADHYA PRADESH,20,2011,Primary,1156,918,2074
MADHYA PRADESH,20,2011,Middle,1161,956,2117
MADHYA PRADESH,20,2011,Matriculate/Secondary,1071,733,1804
MADHYA PRADESH,20,2011,Hr. Secondary/Intermediate/Pre-University,598,447,1045
MADHYA PRADESH,20,2011,Diploma,68,21,89
MADHYA PRADESH,20,2011,Graduate,96,37,133
MADHYA PRADESH,20,2011,Post Graduate and Above,47,2,49
MADHYA PRADESH,20,2012,No Education,1272,1138,2410
MADHYA PRADESH,20,2012,Primary,1229,817,2046
MADHYA PRADESH,20,2012,Middle,1205,827,2032
MADHYA PRADESH,20,2012,Matriculate/Secondary,1143,721,1864
MADHYA PRADESH,20,2012,Hr. Secondary/Intermediate/Pre-University,630,388,1018
MADHYA PRADESH,20,2012,Diploma,84,26,110
MADHYA PRADESH,20,2012,Graduate,162,66,228
MADHYA PRADESH,20,2012,Post Graduate and Above,49,18,67
MADHYA PRADESH,20,2013,No Education,1088,961,2049
MADHYA PRADESH,20,2013,Primary,1215,912,2127
MADHYA PRADESH,20,2013,Middle,1261,852,2113
MADHYA PRADESH,20,2013,Matriculate/Secondary,1171,598,1769
MADHYA PRADESH,20,2013,Hr. Secondary/Intermediate/Pre-University,721,392,1113
MADHYA PRADESH,20,2013,Diploma,54,15,69
MADHYA PRADESH,20,2013,Graduate,134,43,177
MADHYA PRADESH,20,2013,Post Graduate and Above,26,3,29
MADHYA PRADESH,20,2014,No Education,949,700,1649
MADHYA PRADESH,20,2014,Primary,1001,754,1755
MADHYA PRADESH,20,2014,Middle,1135,803,1938
MADHYA PRADESH,20,2014,Matriculate/Secondary,937,543,1480
MADHYA PRADESH,20,2014,Hr. Secondary/Intermediate/Pre-University,760,585,1345
MADHYA PRADESH,20,2014,Diploma,28,9,37
MADHYA PRADESH,20,2014,Graduate,96,38,134
MADHYA PRADESH,20,2014,Post Graduate and Above,9,4,13
MAHARASHTRA,21,2001,No Education,1552,1189,2741
MAHARASHTRA,21,2001,Primary,2478,1471,3949
MAHARASHTRA,21,2001,Middle,2587,1375,3962
MAHARASHTRA,21,2001,Matriculate/Secondary,2060,895,2955
MAHARASHTRA,21,2001,Hr. Secondary/Intermediate/Pre-University,448,265,713
MAHARASHTRA,21,2001,Diploma,78,23,101
MAHARASHTRA,21,2001,Graduate,102,50,152
MAHARASHTRA,21,2001,Post Graduate and Above,33,12,45
MAHARASHTRA,21,2002,No Education,1650,1141,2791
MAHARASHTRA,21,2002,Primary,2464,1360,3824
MAHARASHTRA,21,2002,Middle,2512,1333,3845
MAHARASHTRA,21,2002,Matriculate/Secondary,2061,943,3004
MAHARASHTRA,21,2002,Hr. Secondary/Intermediate/Pre-University,526,245,771
MAHARASHTRA,21,2002,Diploma,88,18,106
MAHARASHTRA,21,2002,Graduate,127,37,164
MAHARASHTRA,21,2002,Post Graduate and Above,19,5,24
MAHARASHTRA,21,2003,No Education,1526,1128,2654
MAHARASHTRA,21,2003,Primary,2638,1395,4033
MAHARASHTRA,21,2003,Middle,2546,1228,3774
MAHARASHTRA,21,2003,Matriculate/Secondary,2265,946,3211
MAHARASHTRA,21,2003,Hr. Secondary/Intermediate/Pre-University,642,213,855
MAHARASHTRA,21,2003,Diploma,71,12,83
MAHARASHTRA,21,2003,Graduate,88,22,110
MAHARASHTRA,21,2003,Post Graduate and Above,34,6,40
MAHARASHTRA,21,2004,No Education,1476,1089,2565
MAHARASHTRA,21,2004,Primary,2681,1382,4063
MAHARASHTRA,21,2004,Middle,2477,1106,3583
MAHARASHTRA,21,2004,Matriculate/Secondary,2363,966,3329
MAHARASHTRA,21,2004,Hr. Secondary/Intermediate/Pre-University,695,231,926
MAHARASHTRA,21,2004,Diploma,75,16,91
MAHARASHTRA,21,2004,Graduate,116,32,148
MAHARASHTRA,21,2004,Post Graduate and Above,20,4,24
MAHARASHTRA,21,2005,No Education,1423,959,2382
MAHARASHTRA,21,2005,Primary,2570,1414,3984
MAHARASHTRA,21,2005,Middle,2634,1190,3824
MAHARASHTRA,21,2005,Matriculate/Secondary,2143,915,3058
MAHARASHTRA,21,2005,Hr. Secondary/Intermediate/Pre-University,606,262,868
MAHARASHTRA,21,2005,Diploma,98,20,118
MAHARASHTRA,21,2005,Graduate,108,48,156
MAHARASHTRA,21,2005,Post Graduate and Above,21,15,36
MAHARASHTRA,21,2006,No Education,1340,923,2263
MAHARASHTRA,21,2006,Primary,2719,1361,4080
MAHARASHTRA,21,2006,Middle,3055,1371,4426
MAHARASHTRA,21,2006,Matriculate/Secondary,2397,987,3384
MAHARASHTRA,21,2006,Hr. Secondary/Intermediate/Pre-University,736,264,1000
MAHARASHTRA,21,2006,Diploma,86,25,111
MAHARASHTRA,21,2006,Graduate,157,47,204
MAHARASHTRA,21,2006,Post Graduate and Above,20,6,26
MAHARASHTRA,21,2007,No Education,1334,802,2136
MAHARASHTRA,21,2007,Primary,2875,1312,4187
MAHARASHTRA,21,2007,Middle,2913,1365,4278
MAHARASHTRA,21,2007,Matriculate/Secondary,2334,932,3266
MAHARASHTRA,21,2007,Hr. Secondary/Intermediate/Pre-University,703,275,978
MAHARASHTRA,21,2007,Diploma,111,24,135
MAHARASHTRA,21,2007,Graduate,126,52,178
MAHARASHTRA,21,2007,Post Graduate and Above,24,2,26
MAHARASHTRA,21,2008,No Education,1264,736,2000
MAHARASHTRA,21,2008,Primary,2808,1292,4100
MAHARASHTRA,21,2008,Middle,2598,1263,3861
MAHARASHTRA,21,2008,Matriculate/Secondary,2305,881,3186
MAHARASHTRA,21,2008,Hr. Secondary/Intermediate/Pre-University,705,260,965
MAHARASHTRA,21,2008,Diploma,72,19,91
MAHARASHTRA,21,2008,Graduate,122,27,149
MAHARASHTRA,21,2008,Post Graduate and Above,15,7,22
MAHARASHTRA,21,2009,No Education,1260,700,1960
MAHARASHTRA,21,2009,Primary,2465,1140,3605
MAHARASHTRA,21,2009,Middle,2765,1312,4077
MAHARASHTRA,21,2009,Matriculate/Secondary,2302,977,3279
MAHARASHTRA,21,2009,Hr. Secondary/Intermediate/Pre-University,746,297,1043
MAHARASHTRA,21,2009,Diploma,69,26,95
MAHARASHTRA,21,2009,Graduate,162,55,217
MAHARASHTRA,21,2009,Post Graduate and Above,16,8,24
MAHARASHTRA,21,2010,No Education,1207,694,1901
MAHARASHTRA,21,2010,Primary,2778,1387,4165
MAHARASHTRA,21,2010,Middle,2852,1227,4079
MAHARASHTRA,21,2010,Matriculate/Secondary,2958,1289,4247
MAHARASHTRA,21,2010,Hr. Secondary/Intermediate/Pre-University,778,353,1131
MAHARASHTRA,21,2010,Diploma,99,33,132
MAHARASHTRA,21,2010,Graduate,160,61,221
MAHARASHTRA,21,2010,Post Graduate and Above,26,14,40
MAHARASHTRA,21,2011,No Education,1159,694,1853
MAHARASHTRA,21,2011,Primary,2928,1350,4278
MAHARASHTRA,21,2011,Middle,2764,1290,4054
MAHARASHTRA,21,2011,Matriculate/Secondary,2891,1249,4140
MAHARASHTRA,21,2011,Hr. Secondary/Intermediate/Pre-University,881,375,1256
MAHARASHTRA,21,2011,Diploma,93,35,128
MAHARASHTRA,21,2011,Graduate,151,61,212
MAHARASHTRA,21,2011,Post Graduate and Above,20,6,26
MAHARASHTRA,21,2012,No Education,1187,655,1842
MAHARASHTRA,21,2012,Primary,2926,1280,4206
MAHARASHTRA,21,2012,Middle,2962,1202,4164
MAHARASHTRA,21,2012,Matriculate/Secondary,3070,1175,4245
MAHARASHTRA,21,2012,Hr. Secondary/Intermediate/Pre-University,831,378,1209
MAHARASHTRA,21,2012,Diploma,140,46,186
MAHARASHTRA,21,2012,Graduate,170,65,235
MAHARASHTRA,21,2012,Post Graduate and Above,18,7,25
MAHARASHTRA,21,2013,No Education,1255,647,1902
MAHARASHTRA,21,2013,Primary,2730,1191,3921
MAHARASHTRA,21,2013,Middle,3224,1260,4484
MAHARASHTRA,21,2013,Matriculate/Secondary,3221,1137,4358
MAHARASHTRA,21,2013,Hr. Secondary/Intermediate/Pre-University,1072,361,1433
MAHARASHTRA,21,2013,Diploma,137,36,173
MAHARASHTRA,21,2013,Graduate,222,86,308
MAHARASHTRA,21,2013,Post Graduate and Above,31,12,43
MAHARASHTRA,21,2014,No Education,1064,552,1616
MAHARASHTRA,21,2014,Primary,2495,948,3443
MAHARASHTRA,21,2014,Middle,2820,1063,3883
MAHARASHTRA,21,2014,Matriculate/Secondary,3388,1177,4565
MAHARASHTRA,21,2014,Hr. Secondary/Intermediate/Pre-University,1449,505,1954
MAHARASHTRA,21,2014,Diploma,115,45,160
MAHARASHTRA,21,2014,Graduate,243,88,331
MAHARASHTRA,21,2014,Post Graduate and Above,11,5,16
MANIPUR,22,2001,No Education,3,4,7
MANIPUR,22,2001,Primary,4,2,6
MANIPUR,22,2001,Middle,4,5,9
MANIPUR,22,2001,Matriculate/Secondary,10,5,15
MANIPUR,22,2001,Hr. Secondary/Intermediate/Pre-University,3,0,3
MANIPUR,22,2001,Diploma,0,0,0
MANIPUR,22,2001,Graduate,0,1,1
MANIPUR,22,2001,Post Graduate and Above,0,0,0
MANIPUR,22,2002,No Education,3,1,4
MANIPUR,22,2002,Primary,2,1,3
MANIPUR,22,2002,Middle,11,3,14
MANIPUR,22,2002,Matriculate/Secondary,6,2,8
MANIPUR,22,2002,Hr. Secondary/Intermediate/Pre-University,7,2,9
MANIPUR,22,2002,Diploma,0,0,0
MANIPUR,22,2002,Graduate,1,0,1
MANIPUR,22,2002,Post Graduate and Above,0,0,0
MANIPUR,22,2003,No Education,0,0,0
MANIPUR,22,2003,Primary,0,0,0
MANIPUR,22,2003,Middle,8,3,11
MANIPUR,22,2003,Matriculate/Secondary,5,1,6
MANIPUR,22,2003,Hr. Secondary/Intermediate/Pre-University,8,1,9
MANIPUR,22,2003,Diploma,0,0,0
MANIPUR,22,2003,Graduate,0,0,0
MANIPUR,22,2003,Post Graduate and Above,0,0,0
MANIPUR,22,2004,No Education,1,0,1
MANIPUR,22,2004,Primary,3,0,3
MANIPUR,22,2004,Middle,12,5,17
MANIPUR,22,2004,Matriculate/Secondary,12,4,16
MANIPUR,22,2004,Hr. Secondary/Intermediate/Pre-University,2,0,2
MANIPUR,22,2004,Diploma,1,0,1
MANIPUR,22,2004,Graduate,1,0,1
MANIPUR,22,2004,Post Graduate and Above,0,0,0
MANIPUR,22,2005,No Education,2,1,3
MANIPUR,22,2005,Primary,1,1,2
MANIPUR,22,2005,Middle,8,1,9
MANIPUR,22,2005,Matriculate/Secondary,10,1,11
MANIPUR,22,2005,Hr. Secondary/Intermediate/Pre-University,2,0,2
MANIPUR,22,2005,Diploma,0,0,0
MANIPUR,22,2005,Graduate,0,0,0
MANIPUR,22,2005,Post Graduate and Above,0,0,0
MANIPUR,22,2006,No Education,1,0,1
MANIPUR,22,2006,Primary,1,1,2
MANIPUR,22,2006,Middle,10,0,10
MANIPUR,22,2006,Matriculate/Secondary,8,8,16
MANIPUR,22,2006,Hr. Secondary/Intermediate/Pre-University,4,3,7
MANIPUR,22,2006,Diploma,0,0,0
MANIPUR,22,2006,Graduate,0,0,0
MANIPUR,22,2006,Post Graduate and Above,0,0,0
MANIPUR,22,2007,No Education,2,2,4
MANIPUR,22,2007,Primary,0,3,3
MANIPUR,22,2007,Middle,10,3,13
MANIPUR,22,2007,Matriculate/Secondary,11,2,13
MANIPUR,22,2007,Hr. Secondary/Intermediate/Pre-University,5,1,6
MANIPUR,22,2007,Diploma,0,0,0
MANIPUR,22,2007,Graduate,0,0,0
MANIPUR,22,2007,Post Graduate and Above,0,0,0
MANIPUR,22,2008,No Education,2,0,2
MANIPUR,22,2008,Primary,0,1,1
MANIPUR,22,2008,Middle,11,6,17
MANIPUR,22,2008,Matriculate/Secondary,7,3,10
MANIPUR,22,2008,Hr. Secondary/Intermediate/Pre-University,2,1,3
MANIPUR,22,2008,Diploma,1,0,1
MANIPUR,22,2008,Graduate,0,0,0
MANIPUR,22,2008,Post Graduate and Above,0,0,0
MANIPUR,22,2009,No Education,1,3,4
MANIPUR,22,2009,Primary,3,2,5
MANIPUR,22,2009,Middle,2,3,5
MANIPUR,22,2009,Matriculate/Secondary,12,1,13
MANIPUR,22,2009,Hr. Secondary/Intermediate/Pre-University,0,0,0
MANIPUR,22,2009,Diploma,0,0,0
MANIPUR,22,2009,Graduate,0,0,0
MANIPUR,22,2009,Post Graduate and Above,0,0,0
MANIPUR,22,2010,No Education,0,1,1
MANIPUR,22,2010,Primary,7,4,11
MANIPUR,22,2010,Middle,5,5,10
MANIPUR,22,2010,Matriculate/Secondary,9,3,12
MANIPUR,22,2010,Hr. Secondary/Intermediate/Pre-University,3,0,3
MANIPUR,22,2010,Diploma,0,0,0
MANIPUR,22,2010,Graduate,0,0,0
MANIPUR,22,2010,Post Graduate and Above,0,0,0
MANIPUR,22,2011,No Education,1,1,2
MANIPUR,22,2011,Primary,2,4,6
MANIPUR,22,2011,Middle,4,5,9
MANIPUR,22,2011,Matriculate/Secondary,6,5,11
MANIPUR,22,2011,Hr. Secondary/Intermediate/Pre-University,4,0,4
MANIPUR,22,2011,Diploma,0,0,0
MANIPUR,22,2011,Graduate,1,0,1
MANIPUR,22,2011,Post Graduate and Above,0,0,0
MANIPUR,22,2012,No Education,0,4,4
MANIPUR,22,2012,Primary,1,0,1
MANIPUR,22,2012,Middle,1,4,5
MANIPUR,22,2012,Matriculate/Secondary,10,8,18
MANIPUR,22,2012,Hr. Secondary/Intermediate/Pre-University,10,2,12
MANIPUR,22,2012,Diploma,0,0,0
MANIPUR,22,2012,Graduate,1,0,1
MANIPUR,22,2012,Post Graduate and Above,0,0,0
MANIPUR,22,2013,No Education,2,0,2
MANIPUR,22,2013,Primary,4,2,6
MANIPUR,22,2013,Middle,3,3,6
MANIPUR,22,2013,Matriculate/Secondary,7,5,12
MANIPUR,22,2013,Hr. Secondary/Intermediate/Pre-University,6,4,10
MANIPUR,22,2013,Diploma,0,1,1
MANIPUR,22,2013,Graduate,0,0,0
MANIPUR,22,2013,Post Graduate and Above,0,0,0
MANIPUR,22,2014,No Education,3,3,6
MANIPUR,22,2014,Primary,0,0,0
MANIPUR,22,2014,Middle,3,2,5
MANIPUR,22,2014,Matriculate/Secondary,10,7,17
MANIPUR,22,2014,Hr. Secondary/Intermediate/Pre-University,6,3,9
MANIPUR,22,2014,Diploma,0,0,0
MANIPUR,22,2014,Graduate,0,0,0
MANIPUR,22,2014,Post Graduate and Above,0,0,0
MEGHALAYA,23,2001,No Education,16,5,21
MEGHALAYA,23,2001,Primary,13,6,19
MEGHALAYA,23,2001,Middle,26,6,32
MEGHALAYA,23,2001,Matriculate/Secondary,6,1,7
MEGHALAYA,23,2001,Hr. Secondary/Intermediate/Pre-University,4,0,4
MEGHALAYA,23,2001,Diploma,0,0,0
MEGHALAYA,23,2001,Graduate,4,0,4
MEGHALAYA,23,2001,Post Graduate and Above,0,0,0
MEGHALAYA,23,2002,No Education,21,10,31
MEGHALAYA,23,2002,Primary,9,5,14
MEGHALAYA,23,2002,Middle,9,3,12
MEGHALAYA,23,2002,Matriculate/Secondary,8,0,8
MEGHALAYA,23,2002,Hr. Secondary/Intermediate/Pre-University,2,0,2
MEGHALAYA,23,2002,Diploma,0,0,0
MEGHALAYA,23,2002,Graduate,0,0,0
MEGHALAYA,23,2002,Post Graduate and Above,0,0,0
MEGHALAYA,23,2003,No Education,10,2,12
MEGHALAYA,23,2003,Primary,4,0,4
MEGHALAYA,23,2003,Middle,10,3,13
MEGHALAYA,23,2003,Matriculate/Secondary,5,2,7
MEGHALAYA,23,2003,Hr. Secondary/Intermediate/Pre-University,2,2,4
MEGHALAYA,23,2003,Diploma,0,0,0
MEGHALAYA,23,2003,Graduate,1,0,1
MEGHALAYA,23,2003,Post Graduate and Above,0,0,0
MEGHALAYA,23,2004,No Education,9,6,15
MEGHALAYA,23,2004,Primary,7,3,10
MEGHALAYA,23,2004,Middle,9,3,12
MEGHALAYA,23,2004,Matriculate/Secondary,6,1,7
MEGHALAYA,23,2004,Hr. Secondary/Intermediate/Pre-University,6,3,9
MEGHALAYA,23,2004,Diploma,0,0,0
MEGHALAYA,23,2004,Graduate,1,0,1
MEGHALAYA,23,2004,Post Graduate and Above,1,0,1
MEGHALAYA,23,2005,No Education,16,6,22
MEGHALAYA,23,2005,Primary,15,6,21
MEGHALAYA,23,2005,Middle,12,5,17
MEGHALAYA,23,2005,Matriculate/Secondary,6,2,8
MEGHALAYA,23,2005,Hr. Secondary/Intermediate/Pre-University,1,1,2
MEGHALAYA,23,2005,Diploma,0,0,0
MEGHALAYA,23,2005,Graduate,0,1,1
MEGHALAYA,23,2005,Post Graduate and Above,0,0,0
MEGHALAYA,23,2006,No Education,6,1,7
MEGHALAYA,23,2006,Primary,12,6,18
MEGHALAYA,23,2006,Middle,28,11,39
MEGHALAYA,23,2006,Matriculate/Secondary,13,5,18
MEGHALAYA,23,2006,Hr. Secondary/Intermediate/Pre-University,9,0,9
MEGHALAYA,23,2006,Diploma,0,0,0
MEGHALAYA,23,2006,Graduate,0,0,0
MEGHALAYA,23,2006,Post Graduate and Above,1,0,1
MEGHALAYA,23,2007,No Education,15,7,22
MEGHALAYA,23,2007,Primary,7,1,8
MEGHALAYA,23,2007,Middle,19,9,28
MEGHALAYA,23,2007,Matriculate/Secondary,14,7,21
MEGHALAYA,23,2007,Hr. Secondary/Intermediate/Pre-University,5,3,8
MEGHALAYA,23,2007,Diploma,0,0,0
MEGHALAYA,23,2007,Graduate,0,0,0
MEGHALAYA,23,2007,Post Graduate and Above,0,0,0
MEGHALAYA,23,2008,No Education,15,8,23
MEGHALAYA,23,2008,Primary,3,3,6
MEGHALAYA,23,2008,Middle,17,6,23
MEGHALAYA,23,2008,Matriculate/Secondary,12,7,19
MEGHALAYA,23,2008,Hr. Secondary/Intermediate/Pre-University,10,3,13
MEGHALAYA,23,2008,Diploma,0,0,0
MEGHALAYA,23,2008,Graduate,0,1,1
MEGHALAYA,23,2008,Post Graduate and Above,0,0,0
MEGHALAYA,23,2009,No Education,9,6,15
MEGHALAYA,23,2009,Primary,10,3,13
MEGHALAYA,23,2009,Middle,17,19,36
MEGHALAYA,23,2009,Matriculate/Secondary,13,8,21
MEGHALAYA,23,2009,Hr. Secondary/Intermediate/Pre-University,17,9,26
MEGHALAYA,23,2009,Diploma,0,0,0
MEGHALAYA,23,2009,Graduate,1,0,1
MEGHALAYA,23,2009,Post Graduate and Above,0,0,0
MEGHALAYA,23,2010,No Education,15,11,26
MEGHALAYA,23,2010,Primary,31,5,36
MEGHALAYA,23,2010,Middle,15,9,24
MEGHALAYA,23,2010,Matriculate/Secondary,15,3,18
MEGHALAYA,23,2010,Hr. Secondary/Intermediate/Pre-University,2,0,2
MEGHALAYA,23,2010,Diploma,0,0,0
MEGHALAYA,23,2010,Graduate,2,0,2
MEGHALAYA,23,2010,Post Graduate and Above,0,0,0
MEGHALAYA,23,2011,No Education,15,3,18
MEGHALAYA,23,2011,Primary,21,17,38
MEGHALAYA,23,2011,Middle,22,9,31
MEGHALAYA,23,2011,Matriculate/Secondary,25,6,31
MEGHALAYA,23,2011,Hr. Secondary/Intermediate/Pre-University,13,2,15
MEGHALAYA,23,2011,Diploma,10,0,10
MEGHALAYA,23,2011,Graduate,5,3,8
MEGHALAYA,23,2011,Post Graduate and Above,0,2,2
MEGHALAYA,23,2012,No Education,18,11,29
MEGHALAYA,23,2012,Primary,29,14,43
MEGHALAYA,23,2012,Middle,20,6,26
MEGHALAYA,23,2012,Matriculate/Secondary,23,6,29
MEGHALAYA,23,2012,Hr. Secondary/Intermediate/Pre-University,0,1,1
MEGHALAYA,23,2012,Diploma,0,0,0
MEGHALAYA,23,2012,Graduate,0,0,0
MEGHALAYA,23,2012,Post Graduate and Above,0,0,0
MEGHALAYA,23,2013,No Education,17,9,26
MEGHALAYA,23,2013,Primary,25,11,36
MEGHALAYA,23,2013,Middle,36,15,51
MEGHALAYA,23,2013,Matriculate/Secondary,18,4,22
MEGHALAYA,23,2013,Hr. Secondary/Intermediate/Pre-University,0,0,0
MEGHALAYA,23,2013,Diploma,0,0,0
MEGHALAYA,23,2013,Graduate,0,2,2
MEGHALAYA,23,2013,Post Graduate and Above,0,0,0
MEGHALAYA,23,2014,No Education,11,4,15
MEGHALAYA,23,2014,Primary,12,7,19
MEGHALAYA,23,2014,Middle,14,4,18
MEGHALAYA,23,2014,Matriculate/Secondary,13,2,15
MEGHALAYA,23,2014,Hr. Secondary/Intermediate/Pre-University,3,1,4
MEGHALAYA,23,2014,Diploma,0,0,0
MEGHALAYA,23,2014,Graduate,0,0,0
MEGHALAYA,23,2014,Post Graduate and Above,0,0,0
MIZORAM,24,2001,No Education,0,0,0
MIZORAM,24,2001,Primary,4,2,6
MIZORAM,24,2001,Middle,21,3,24
MIZORAM,24,2001,Matriculate/Secondary,12,2,14
MIZORAM,24,2001,Hr. Secondary/Intermediate/Pre-University,9,1,10
MIZORAM,24,2001,Diploma,0,0,0
MIZORAM,24,2001,Graduate,0,0,0
MIZORAM,24,2001,Post Graduate and Above,0,0,0
MIZORAM,24,2002,No Education,8,0,8
MIZORAM,24,2002,Primary,16,7,23
MIZORAM,24,2002,Middle,25,3,28
MIZORAM,24,2002,Matriculate/Secondary,5,0,5
MIZORAM,24,2002,Hr. Secondary/Intermediate/Pre-University,1,0,1
MIZORAM,24,2002,Diploma,0,0,0
MIZORAM,24,2002,Graduate,1,0,1
MIZORAM,24,2002,Post Graduate and Above,0,0,0
MIZORAM,24,2003,No Education,0,1,1
MIZORAM,24,2003,Primary,16,3,19
MIZORAM,24,2003,Middle,16,5,21
MIZORAM,24,2003,Matriculate/Secondary,8,2,10
MIZORAM,24,2003,Hr. Secondary/Intermediate/Pre-University,1,0,1
MIZORAM,24,2003,Diploma,0,0,0
MIZORAM,24,2003,Graduate,0,0,0
MIZORAM,24,2003,Post Graduate and Above,0,0,0
MIZORAM,24,2004,No Education,5,0,5
MIZORAM,24,2004,Primary,15,4,19
MIZORAM,24,2004,Middle,26,1,27
MIZORAM,24,2004,Matriculate/Secondary,5,0,5
MIZORAM,24,2004,Hr. Secondary/Intermediate/Pre-University,1,1,2
MIZORAM,24,2004,Diploma,1,0,1
MIZORAM,24,2004,Graduate,0,1,1
MIZORAM,24,2004,Post Graduate and Above,0,0,0
MIZORAM,24,2005,No Education,5,0,5
MIZORAM,24,2005,Primary,16,3,19
MIZORAM,24,2005,Middle,22,4,26
MIZORAM,24,2005,Matriculate/Secondary,3,1,4
MIZORAM,24,2005,Hr. Secondary/Intermediate/Pre-University,0,0,0
MIZORAM,24,2005,Diploma,0,0,0
MIZORAM,24,2005,Graduate,1,0,1
MIZORAM,24,2005,Post Graduate and Above,0,0,0
MIZORAM,24,2006,No Education,4,0,4
MIZORAM,24,2006,Primary,10,4,14
MIZORAM,24,2006,Middle,26,3,29
MIZORAM,24,2006,Matriculate/Secondary,6,0,6
MIZORAM,24,2006,Hr. Secondary/Intermediate/Pre-University,0,0,0
MIZORAM,24,2006,Diploma,14,3,17
MIZORAM,24,2006,Graduate,0,0,0
MIZORAM,24,2006,Post Graduate and Above,0,0,0
MIZORAM,24,2007,No Education,2,2,4
MIZORAM,24,2007,Primary,2,0,2
MIZORAM,24,2007,Middle,0,0,0
MIZORAM,24,2007,Matriculate/Secondary,7,2,9
MIZORAM,24,2007,Hr. Secondary/Intermediate/Pre-University,9,1,10
MIZORAM,24,2007,Diploma,0,0,0
MIZORAM,24,2007,Graduate,2,1,3
MIZORAM,24,2007,Post Graduate and Above,0,0,0
MIZORAM,24,2008,No Education,0,2,2
MIZORAM,24,2008,Primary,5,2,7
MIZORAM,24,2008,Middle,22,1,23
MIZORAM,24,2008,Matriculate/Secondary,7,0,7
MIZORAM,24,2008,Hr. Secondary/Intermediate/Pre-University,1,1,2
MIZORAM,24,2008,Diploma,0,0,0
MIZORAM,24,2008,Graduate,0,0,0
MIZORAM,24,2008,Post Graduate and Above,0,0,0
MIZORAM,24,2009,No Education,4,1,5
MIZORAM,24,2009,Primary,16,1,17
MIZORAM,24,2009,Middle,42,5,47
MIZORAM,24,2009,Matriculate/Secondary,0,0,0
MIZORAM,24,2009,Hr. Secondary/Intermediate/Pre-University,0,0,0
MIZORAM,24,2009,Diploma,0,0,0
MIZORAM,24,2009,Graduate,0,0,0
MIZORAM,24,2009,Post Graduate and Above,0,0,0
MIZORAM,24,2010,No Education,1,4,5
MIZORAM,24,2010,Primary,25,3,28
MIZORAM,24,2010,Middle,30,2,32
MIZORAM,24,2010,Matriculate/Secondary,9,0,9
MIZORAM,24,2010,Hr. Secondary/Intermediate/Pre-University,2,0,2
MIZORAM,24,2010,Diploma,0,0,0
MIZORAM,24,2010,Graduate,0,0,0
MIZORAM,24,2010,Post Graduate and Above,0,0,0
MIZORAM,24,2011,No Education,0,1,1
MIZORAM,24,2011,Primary,27,1,28
MIZORAM,24,2011,Middle,28,5,33
MIZORAM,24,2011,Matriculate/Secondary,17,5,22
MIZORAM,24,2011,Hr. Secondary/Intermediate/Pre-University,5,1,6
MIZORAM,24,2011,Diploma,0,0,0
MIZORAM,24,2011,Graduate,0,0,0
MIZORAM,24,2011,Post Graduate and Above,0,0,0
MIZORAM,24,2012,No Education,51,2,53
MIZORAM,24,2012,Primary,11,5,16
MIZORAM,24,2012,Middle,60,7,67
MIZORAM,24,2012,Matriculate/Secondary,33,2,35
MIZORAM,24,2012,Hr. Secondary/Intermediate/Pre-University,2,0,2
MIZORAM,24,2012,Diploma,0,0,0
MIZORAM,24,2012,Graduate,0,0,0
MIZORAM,24,2012,Post Graduate and Above,0,0,0
MIZORAM,24,2013,No Education,4,2,6
MIZORAM,24,2013,Primary,7,1,8
MIZORAM,24,2013,Middle,49,9,58
MIZORAM,24,2013,Matriculate/Secondary,13,3,16
MIZORAM,24,2013,Hr. Secondary/Intermediate/Pre-University,6,0,6
MIZORAM,24,2013,Diploma,0,0,0
MIZORAM,24,2013,Graduate,0,1,1
MIZORAM,24,2013,Post Graduate and Above,0,0,0
MIZORAM,24,2014,No Education,1,0,1
MIZORAM,24,2014,Primary,4,1,5
MIZORAM,24,2014,Middle,45,3,48
MIZORAM,24,2014,Matriculate/Secondary,39,10,49
MIZORAM,24,2014,Hr. Secondary/Intermediate/Pre-University,10,2,12
MIZORAM,24,2014,Diploma,0,0,0
MIZORAM,24,2014,Graduate,1,0,1
MIZORAM,24,2014,Post Graduate and Above,0,0,0
NAGALAND,25,2001,No Education,1,2,3
NAGALAND,25,2001,Primary,7,4,11
NAGALAND,25,2001,Middle,10,7,17
NAGALAND,25,2001,Matriculate/Secondary,4,2,6
NAGALAND,25,2001,Hr. Secondary/Intermediate/Pre-University,2,0,2
NAGALAND,25,2001,Diploma,1,0,1
NAGALAND,25,2001,Graduate,0,0,0
NAGALAND,25,2001,Post Graduate and Above,0,0,0
NAGALAND,25,2002,No Education,3,1,4
NAGALAND,25,2002,Primary,2,2,4
NAGALAND,25,2002,Middle,6,3,9
NAGALAND,25,2002,Matriculate/Secondary,7,2,9
NAGALAND,25,2002,Hr. Secondary/Intermediate/Pre-University,0,0,0
NAGALAND,25,2002,Diploma,0,0,0
NAGALAND,25,2002,Graduate,0,0,0
NAGALAND,25,2002,Post Graduate and Above,1,0,1
NAGALAND,25,2003,No Education,0,1,1
NAGALAND,25,2003,Primary,6,2,8
NAGALAND,25,2003,Middle,7,2,9
NAGALAND,25,2003,Matriculate/Secondary,3,0,3
NAGALAND,25,2003,Hr. Secondary/Intermediate/Pre-University,1,0,1
NAGALAND,25,2003,Diploma,0,0,0
NAGALAND,25,2003,Graduate,0,0,0
NAGALAND,25,2003,Post Graduate and Above,0,0,0
NAGALAND,25,2004,No Education,4,1,5
NAGALAND,25,2004,Primary,4,0,4
NAGALAND,25,2004,Middle,11,2,13
NAGALAND,25,2004,Matriculate/Secondary,6,0,6
NAGALAND,25,2004,Hr. Secondary/Intermediate/Pre-University,0,3,3
NAGALAND,25,2004,Diploma,0,0,0
NAGALAND,25,2004,Graduate,0,0,0
NAGALAND,25,2004,Post Graduate and Above,0,0,0
NAGALAND,25,2005,No Education,3,1,4
NAGALAND,25,2005,Primary,3,3,6
NAGALAND,25,2005,Middle,7,2,9
NAGALAND,25,2005,Matriculate/Secondary,4,0,4
NAGALAND,25,2005,Hr. Secondary/Intermediate/Pre-University,2,0,2
NAGALAND,25,2005,Diploma,0,0,0
NAGALAND,25,2005,Graduate,2,0,2
NAGALAND,25,2005,Post Graduate and Above,0,0,0
NAGALAND,25,2006,No Education,5,1,6
NAGALAND,25,2006,Primary,1,1,2
NAGALAND,25,2006,Middle,6,5,11
NAGALAND,25,2006,Matriculate/Secondary,6,2,8
NAGALAND,25,2006,Hr. Secondary/Intermediate/Pre-University,1,0,1
NAGALAND,25,2006,Diploma,0,0,0
NAGALAND,25,2006,Graduate,0,0,0
NAGALAND,25,2006,Post Graduate and Above,0,0,0
NAGALAND,25,2007,No Education,0,0,0
NAGALAND,25,2007,Primary,0,0,0
NAGALAND,25,2007,Middle,9,5,14
NAGALAND,25,2007,Matriculate/Secondary,8,2,10
NAGALAND,25,2007,Hr. Secondary/Intermediate/Pre-University,0,0,0
NAGALAND,25,2007,Diploma,0,0,0
NAGALAND,25,2007,Graduate,0,0,0
NAGALAND,25,2007,Post Graduate and Above,0,0,0
NAGALAND,25,2008,No Education,4,0,4
NAGALAND,25,2008,Primary,16,4,20
NAGALAND,25,2008,Middle,4,4,8
NAGALAND,25,2008,Matriculate/Secondary,8,2,10
NAGALAND,25,2008,Hr. Secondary/Intermediate/Pre-University,0,0,0
NAGALAND,25,2008,Diploma,0,0,0
NAGALAND,25,2008,Graduate,0,0,0
NAGALAND,25,2008,Post Graduate and Above,0,0,0
NAGALAND,25,2009,No Education,4,2,6
NAGALAND,25,2009,Primary,2,2,4
NAGALAND,25,2009,Middle,8,1,9
NAGALAND,25,2009,Matriculate/Secondary,10,1,11
NAGALAND,25,2009,Hr. Secondary/Intermediate/Pre-University,1,0,1
NAGALAND,25,2009,Diploma,0,0,0
NAGALAND,25,2009,Graduate,0,0,0
NAGALAND,25,2009,Post Graduate and Above,0,0,0
NAGALAND,25,2010,No Education,1,0,1
NAGALAND,25,2010,Primary,5,1,6
NAGALAND,25,2010,Middle,1,0,1
NAGALAND,25,2010,Matriculate/Secondary,4,0,4
NAGALAND,25,2010,Hr. Secondary/Intermediate/Pre-University,0,0,0
NAGALAND,25,2010,Diploma,0,0,0
NAGALAND,25,2010,Graduate,0,0,0
NAGALAND,25,2010,Post Graduate and Above,0,0,0
NAGALAND,25,2011,No Education,1,0,1
NAGALAND,25,2011,Primary,9,0,9
NAGALAND,25,2011,Middle,6,5,11
NAGALAND,25,2011,Matriculate/Secondary,8,3,11
NAGALAND,25,2011,Hr. Secondary/Intermediate/Pre-University,1,0,1
NAGALAND,25,2011,Diploma,0,0,0
NAGALAND,25,2011,Graduate,0,0,0
NAGALAND,25,2011,Post Graduate and Above,0,0,0
NAGALAND,25,2012,No Education,6,0,6
NAGALAND,25,2012,Primary,4,3,7
NAGALAND,25,2012,Middle,10,2,12
NAGALAND,25,2012,Matriculate/Secondary,2,1,3
NAGALAND,25,2012,Hr. Secondary/Intermediate/Pre-University,2,0,2
NAGALAND,25,2012,Diploma,0,0,0
NAGALAND,25,2012,Graduate,0,0,0
NAGALAND,25,2012,Post Graduate and Above,0,0,0
NAGALAND,25,2013,No Education,3,2,5
NAGALAND,25,2013,Primary,9,3,12
NAGALAND,25,2013,Middle,8,6,14
NAGALAND,25,2013,Matriculate/Secondary,4,1,5
NAGALAND,25,2013,Hr. Secondary/Intermediate/Pre-University,1,0,1
NAGALAND,25,2013,Diploma,0,0,0
NAGALAND,25,2013,Graduate,0,0,0
NAGALAND,25,2013,Post Graduate and Above,0,0,0
NAGALAND,25,2014,No Education,0,0,0
NAGALAND,25,2014,Primary,0,0,0
NAGALAND,25,2014,Middle,0,3,3
NAGALAND,25,2014,Matriculate/Secondary,2,0,2
NAGALAND,25,2014,Hr. Secondary/Intermediate/Pre-University,3,0,3
NAGALAND,25,2014,Diploma,0,0,0
NAGALAND,25,2014,Graduate,0,0,0
NAGALAND,25,2014,Post Graduate and Above,0,0,0
ODISHA,26,2001,No Education,633,676,1309
ODISHA,26,2001,Primary,463,487,950
ODISHA,26,2001,Middle,465,326,791
ODISHA,26,2001,Matriculate/Secondary,334,306,640
ODISHA,26,2001,Hr. Secondary/Intermediate/Pre-University,132,123,255
ODISHA,26,2001,Diploma,16,3,19
ODISHA,26,2001,Graduate,38,33,71
ODISHA,26,2001,Post Graduate and Above,8,9,17
ODISHA,26,2002,No Education,554,606,1160
ODISHA,26,2002,Primary,623,440,1063
ODISHA,26,2002,Middle,612,333,945
ODISHA,26,2002,Matriculate/Secondary,501,273,774
ODISHA,26,2002,Hr. Secondary/Intermediate/Pre-University,200,74,274
ODISHA,26,2002,Diploma,24,6,30
ODISHA,26,2002,Graduate,108,20,128
ODISHA,26,2002,Post Graduate and Above,9,5,14
ODISHA,26,2003,No Education,541,520,1061
ODISHA,26,2003,Primary,707,436,1143
ODISHA,26,2003,Middle,612,321,933
ODISHA,26,2003,Matriculate/Secondary,515,250,765
ODISHA,26,2003,Hr. Secondary/Intermediate/Pre-University,234,106,340
ODISHA,26,2003,Diploma,22,5,27
ODISHA,26,2003,Graduate,100,34,134
ODISHA,26,2003,Post Graduate and Above,9,8,17
ODISHA,26,2004,No Education,558,563,1121
ODISHA,26,2004,Primary,527,388,915
ODISHA,26,2004,Middle,558,352,910
ODISHA,26,2004,Matriculate/Secondary,498,268,766
ODISHA,26,2004,Hr. Secondary/Intermediate/Pre-University,251,77,328
ODISHA,26,2004,Diploma,24,2,26
ODISHA,26,2004,Graduate,119,20,139
ODISHA,26,2004,Post Graduate and Above,9,1,10
ODISHA,26,2005,No Education,555,484,1039
ODISHA,26,2005,Primary,586,456,1042
ODISHA,26,2005,Middle,560,334,894
ODISHA,26,2005,Matriculate/Secondary,443,220,663
ODISHA,26,2005,Hr. Secondary/Intermediate/Pre-University,228,106,334
ODISHA,26,2005,Diploma,18,3,21
ODISHA,26,2005,Graduate,158,48,206
ODISHA,26,2005,Post Graduate and Above,6,3,9
ODISHA,26,2006,No Education,370,407,777
ODISHA,26,2006,Primary,509,403,912
ODISHA,26,2006,Middle,553,375,928
ODISHA,26,2006,Matriculate/Secondary,511,321,832
ODISHA,26,2006,Hr. Secondary/Intermediate/Pre-University,302,126,428
ODISHA,26,2006,Diploma,11,5,16
ODISHA,26,2006,Graduate,113,48,161
ODISHA,26,2006,Post Graduate and Above,4,7,11
ODISHA,26,2007,No Education,483,459,942
ODISHA,26,2007,Primary,517,379,896
ODISHA,26,2007,Middle,530,462,992
ODISHA,26,2007,Matriculate/Secondary,443,236,679
ODISHA,26,2007,Hr. Secondary/Intermediate/Pre-University,337,219,556
ODISHA,26,2007,Diploma,47,9,56
ODISHA,26,2007,Graduate,119,52,171
ODISHA,26,2007,Post Graduate and Above,12,4,16
ODISHA,26,2008,No Education,471,350,821
ODISHA,26,2008,Primary,707,395,1102
ODISHA,26,2008,Middle,699,338,1037
ODISHA,26,2008,Matriculate/Secondary,626,339,965
ODISHA,26,2008,Hr. Secondary/Intermediate/Pre-University,402,212,614
ODISHA,26,2008,Diploma,20,15,35
ODISHA,26,2008,Graduate,218,88,306
ODISHA,26,2008,Post Graduate and Above,12,12,24
ODISHA,26,2009,No Education,482,372,854
ODISHA,26,2009,Primary,528,418,946
ODISHA,26,2009,Middle,490,316,806
ODISHA,26,2009,Matriculate/Secondary,536,360,896
ODISHA,26,2009,Hr. Secondary/Intermediate/Pre-University,309,181,490
ODISHA,26,2009,Diploma,28,10,38
ODISHA,26,2009,Graduate,162,110,272
ODISHA,26,2009,Post Graduate and Above,32,31,63
ODISHA,26,2010,No Education,391,380,771
ODISHA,26,2010,Primary,505,446,951
ODISHA,26,2010,Middle,493,334,827
ODISHA,26,2010,Matriculate/Secondary,489,377,866
ODISHA,26,2010,Hr. Secondary/Intermediate/Pre-University,347,191,538
ODISHA,26,2010,Diploma,22,10,32
ODISHA,26,2010,Graduate,176,83,259
ODISHA,26,2010,Post Graduate and Above,7,4,11
ODISHA,26,2011,No Education,560,420,980
ODISHA,26,2011,Primary,613,461,1074
ODISHA,26,2011,Middle,617,395,1012
ODISHA,26,2011,Matriculate/Secondary,680,446,1126
ODISHA,26,2011,Hr. Secondary/Intermediate/Pre-University,350,299,649
ODISHA,26,2011,Diploma,26,33,59
ODISHA,26,2011,Graduate,181,122,303
ODISHA,26,2011,Post Graduate and Above,33,5,38
ODISHA,26,2012,No Education,650,392,1042
ODISHA,26,2012,Primary,568,474,1042
ODISHA,26,2012,Middle,625,497,1122
ODISHA,26,2012,Matriculate/Secondary,546,392,938
ODISHA,26,2012,Hr. Secondary/Intermediate/Pre-University,276,216,492
ODISHA,26,2012,Diploma,40,29,69
ODISHA,26,2012,Graduate,169,123,292
ODISHA,26,2012,Post Graduate and Above,22,8,30
ODISHA,26,2013,No Education,573,387,960
ODISHA,26,2013,Primary,604,394,998
ODISHA,26,2013,Middle,701,367,1068
ODISHA,26,2013,Matriculate/Secondary,760,423,1183
ODISHA,26,2013,Hr. Secondary/Intermediate/Pre-University,377,289,666
ODISHA,26,2013,Diploma,54,24,78
ODISHA,26,2013,Graduate,175,86,261
ODISHA,26,2013,Post Graduate and Above,28,10,38
ODISHA,26,2014,No Education,346,329,675
ODISHA,26,2014,Primary,370,324,694
ODISHA,26,2014,Middle,530,374,904
ODISHA,26,2014,Matriculate/Secondary,509,335,844
ODISHA,26,2014,Hr. Secondary/Intermediate/Pre-University,164,148,312
ODISHA,26,2014,Diploma,13,22,35
ODISHA,26,2014,Graduate,79,49,128
ODISHA,26,2014,Post Graduate and Above,6,0,6
PUDUCHERRY,27,2001,No Education,27,6,33
PUDUCHERRY,27,2001,Primary,103,51,154
PUDUCHERRY,27,2001,Middle,133,110,243
PUDUCHERRY,27,2001,Matriculate/Secondary,23,13,36
PUDUCHERRY,27,2001,Hr. Secondary/Intermediate/Pre-University,32,21,53
PUDUCHERRY,27,2001,Diploma,1,0,1
PUDUCHERRY,27,2001,Graduate,4,5,9
PUDUCHERRY,27,2001,Post Graduate and Above,0,0,0
PUDUCHERRY,27,2002,No Education,30,9,39
PUDUCHERRY,27,2002,Primary,116,23,139
PUDUCHERRY,27,2002,Middle,188,66,254
PUDUCHERRY,27,2002,Matriculate/Secondary,59,43,102
PUDUCHERRY,27,2002,Hr. Secondary/Intermediate/Pre-University,6,10,16
PUDUCHERRY,27,2002,Diploma,5,0,5
PUDUCHERRY,27,2002,Graduate,5,4,9
PUDUCHERRY,27,2002,Post Graduate and Above,1,2,3
PUDUCHERRY,27,2003,No Education,4,4,8
PUDUCHERRY,27,2003,Primary,127,41,168
PUDUCHERRY,27,2003,Middle,87,35,122
PUDUCHERRY,27,2003,Matriculate/Secondary,142,93,235
PUDUCHERRY,27,2003,Hr. Secondary/Intermediate/Pre-University,19,12,31
PUDUCHERRY,27,2003,Diploma,2,1,3
PUDUCHERRY,27,2003,Graduate,5,8,13
PUDUCHERRY,27,2003,Post Graduate and Above,2,0,2
PUDUCHERRY,27,2004,No Education,0,1,1
PUDUCHERRY,27,2004,Primary,53,21,74
PUDUCHERRY,27,2004,Middle,153,60,213
PUDUCHERRY,27,2004,Matriculate/Secondary,115,107,222
PUDUCHERRY,27,2004,Hr. Secondary/Intermediate/Pre-University,6,6,12
PUDUCHERRY,27,2004,Diploma,1,3,4
PUDUCHERRY,27,2004,Graduate,9,1,10
PUDUCHERRY,27,2004,Post Graduate and Above,1,2,3
PUDUCHERRY,27,2005,No Education,9,9,18
PUDUCHERRY,27,2005,Primary,53,22,75
PUDUCHERRY,27,2005,Middle,203,86,289
PUDUCHERRY,27,2005,Matriculate/Secondary,52,51,103
PUDUCHERRY,27,2005,Hr. Secondary/Intermediate/Pre-University,12,18,30
PUDUCHERRY,27,2005,Diploma,3,2,5
PUDUCHERRY,27,2005,Graduate,5,5,10
PUDUCHERRY,27,2005,Post Graduate and Above,3,5,8
PUDUCHERRY,27,2006,No Education,4,7,11
PUDUCHERRY,27,2006,Primary,39,8,47
PUDUCHERRY,27,2006,Middle,193,81,274
PUDUCHERRY,27,2006,Matriculate/Secondary,84,48,132
PUDUCHERRY,27,2006,Hr. Secondary/Intermediate/Pre-University,18,24,42
PUDUCHERRY,27,2006,Diploma,3,1,4
PUDUCHERRY,27,2006,Graduate,8,8,16
PUDUCHERRY,27,2006,Post Graduate and Above,0,0,0
PUDUCHERRY,27,2007,No Education,1,7,8
PUDUCHERRY,27,2007,Primary,24,13,37
PUDUCHERRY,27,2007,Middle,233,96,329
PUDUCHERRY,27,2007,Matriculate/Secondary,35,41,76
PUDUCHERRY,27,2007,Hr. Secondary/Intermediate/Pre-University,11,31,42
PUDUCHERRY,27,2007,Diploma,7,3,10
PUDUCHERRY,27,2007,Graduate,7,6,13
PUDUCHERRY,27,2007,Post Graduate and Above,1,1,2
PUDUCHERRY,27,2008,No Education,5,0,5
PUDUCHERRY,27,2008,Primary,13,8,21
PUDUCHERRY,27,2008,Middle,252,89,341
PUDUCHERRY,27,2008,Matriculate/Secondary,40,52,92
PUDUCHERRY,27,2008,Hr. Secondary/Intermediate/Pre-University,10,16,26
PUDUCHERRY,27,2008,Diploma,5,0,5
PUDUCHERRY,27,2008,Graduate,5,7,12
PUDUCHERRY,27,2008,Post Graduate and Above,4,1,5
PUDUCHERRY,27,2009,No Education,5,1,6
PUDUCHERRY,27,2009,Primary,11,6,17
PUDUCHERRY,27,2009,Middle,224,82,306
PUDUCHERRY,27,2009,Matriculate/Secondary,59,53,112
PUDUCHERRY,27,2009,Hr. Secondary/Intermediate/Pre-University,15,32,47
PUDUCHERRY,27,2009,Diploma,4,0,4
PUDUCHERRY,27,2009,Graduate,7,14,21
PUDUCHERRY,27,2009,Post Graduate and Above,1,4,5
PUDUCHERRY,27,2010,No Education,8,2,10
PUDUCHERRY,27,2010,Primary,5,3,8
PUDUCHERRY,27,2010,Middle,26,17,43
PUDUCHERRY,27,2010,Matriculate/Secondary,256,103,359
PUDUCHERRY,27,2010,Hr. Secondary/Intermediate/Pre-University,21,31,52
PUDUCHERRY,27,2010,Diploma,7,6,13
PUDUCHERRY,27,2010,Graduate,10,12,22
PUDUCHERRY,27,2010,Post Graduate and Above,0,1,1
PUDUCHERRY,27,2011,No Education,4,7,11
PUDUCHERRY,27,2011,Primary,18,6,24
PUDUCHERRY,27,2011,Middle,107,28,135
PUDUCHERRY,27,2011,Matriculate/Secondary,192,61,253
PUDUCHERRY,27,2011,Hr. Secondary/Intermediate/Pre-University,57,48,105
PUDUCHERRY,27,2011,Diploma,8,2,10
PUDUCHERRY,27,2011,Graduate,5,7,12
PUDUCHERRY,27,2011,Post Graduate and Above,5,2,7
PUDUCHERRY,27,2012,No Education,7,9,16
PUDUCHERRY,27,2012,Primary,28,10,38
PUDUCHERRY,27,2012,Middle,137,37,174
PUDUCHERRY,27,2012,Matriculate/Secondary,136,73,209
PUDUCHERRY,27,2012,Hr. Secondary/Intermediate/Pre-University,42,25,67
PUDUCHERRY,27,2012,Diploma,11,5,16
PUDUCHERRY,27,2012,Graduate,10,5,15
PUDUCHERRY,27,2012,Post Graduate and Above,1,5,6
PUDUCHERRY,27,2013,No Education,10,4,14
PUDUCHERRY,27,2013,Primary,14,3,17
PUDUCHERRY,27,2013,Middle,131,28,159
PUDUCHERRY,27,2013,Matriculate/Secondary,135,41,176
PUDUCHERRY,27,2013,Hr. Secondary/Intermediate/Pre-University,93,55,148
PUDUCHERRY,27,2013,Diploma,7,2,9
PUDUCHERRY,27,2013,Graduate,14,4,18
PUDUCHERRY,27,2013,Post Graduate and Above,4,1,5
PUDUCHERRY,27,2014,No Education,40,17,57
PUDUCHERRY,27,2014,Primary,96,43,139
PUDUCHERRY,27,2014,Middle,88,17,105
PUDUCHERRY,27,2014,Matriculate/Secondary,109,32,141
PUDUCHERRY,27,2014,Hr. Secondary/Intermediate/Pre-University,56,22,78
PUDUCHERRY,27,2014,Diploma,2,1,3
PUDUCHERRY,27,2014,Graduate,22,3,25
PUDUCHERRY,27,2014,Post Graduate and Above,0,0,0
PUNJAB,28,2001,No Education,146,58,204
PUNJAB,28,2001,Primary,95,44,139
PUNJAB,28,2001,Middle,57,36,93
PUNJAB,28,2001,Matriculate/Secondary,72,39,111
PUNJAB,28,2001,Hr. Secondary/Intermediate/Pre-University,17,47,64
PUNJAB,28,2001,Diploma,4,0,4
PUNJAB,28,2001,Graduate,4,0,4
PUNJAB,28,2001,Post Graduate and Above,1,28,29
PUNJAB,28,2002,No Education,155,27,182
PUNJAB,28,2002,Primary,72,21,93
PUNJAB,28,2002,Middle,48,20,68
PUNJAB,28,2002,Matriculate/Secondary,75,28,103
PUNJAB,28,2002,Hr. Secondary/Intermediate/Pre-University,35,10,45
PUNJAB,28,2002,Diploma,2,3,5
PUNJAB,28,2002,Graduate,9,1,10
PUNJAB,28,2002,Post Graduate and Above,1,0,1
PUNJAB,28,2003,No Education,145,33,178
PUNJAB,28,2003,Primary,78,20,98
PUNJAB,28,2003,Middle,68,15,83
PUNJAB,28,2003,Matriculate/Secondary,77,30,107
PUNJAB,28,2003,Hr. Secondary/Intermediate/Pre-University,62,9,71
PUNJAB,28,2003,Diploma,13,6,19
PUNJAB,28,2003,Graduate,35,8,43
PUNJAB,28,2003,Post Graduate and Above,28,4,32
PUNJAB,28,2004,No Education,162,35,197
PUNJAB,28,2004,Primary,72,17,89
PUNJAB,28,2004,Middle,60,18,78
PUNJAB,28,2004,Matriculate/Secondary,104,30,134
PUNJAB,28,2004,Hr. Secondary/Intermediate/Pre-University,21,16,37
PUNJAB,28,2004,Diploma,7,5,12
PUNJAB,28,2004,Graduate,6,1,7
PUNJAB,28,2004,Post Graduate and Above,84,7,91
PUNJAB,28,2005,No Education,138,31,169
PUNJAB,28,2005,Primary,49,11,60
PUNJAB,28,2005,Middle,76,21,97
PUNJAB,28,2005,Matriculate/Secondary,120,30,150
PUNJAB,28,2005,Hr. Secondary/Intermediate/Pre-University,26,10,36
PUNJAB,28,2005,Diploma,10,1,11
PUNJAB,28,2005,Graduate,4,1,5
PUNJAB,28,2005,Post Graduate and Above,59,1,60
PUNJAB,28,2006,No Education,210,56,266
PUNJAB,28,2006,Primary,75,19,94
PUNJAB,28,2006,Middle,83,25,108
PUNJAB,28,2006,Matriculate/Secondary,180,51,231
PUNJAB,28,2006,Hr. Secondary/Intermediate/Pre-University,36,7,43
PUNJAB,28,2006,Diploma,4,1,5
PUNJAB,28,2006,Graduate,17,2,19
PUNJAB,28,2006,Post Graduate and Above,5,1,6
PUNJAB,28,2007,No Education,248,63,311
PUNJAB,28,2007,Primary,62,36,98
PUNJAB,28,2007,Middle,93,47,140
PUNJAB,28,2007,Matriculate/Secondary,175,57,232
PUNJAB,28,2007,Hr. Secondary/Intermediate/Pre-University,39,6,45
PUNJAB,28,2007,Diploma,8,2,10
PUNJAB,28,2007,Graduate,5,1,6
PUNJAB,28,2007,Post Graduate and Above,2,3,5
PUNJAB,28,2008,No Education,213,65,278
PUNJAB,28,2008,Primary,91,31,122
PUNJAB,28,2008,Middle,107,39,146
PUNJAB,28,2008,Matriculate/Secondary,174,55,229
PUNJAB,28,2008,Hr. Secondary/Intermediate/Pre-University,34,26,60
PUNJAB,28,2008,Diploma,7,2,9
PUNJAB,28,2008,Graduate,11,5,16
PUNJAB,28,2008,Post Graduate and Above,6,3,9
PUNJAB,28,2009,No Education,238,48,286
PUNJAB,28,2009,Primary,85,20,105
PUNJAB,28,2009,Middle,99,36,135
PUNJAB,28,2009,Matriculate/Secondary,150,64,214
PUNJAB,28,2009,Hr. Secondary/Intermediate/Pre-University,39,29,68
PUNJAB,28,2009,Diploma,10,6,16
PUNJAB,28,2009,Graduate,10,7,17
PUNJAB,28,2009,Post Graduate and Above,4,2,6
PUNJAB,28,2010,No Education,252,55,307
PUNJAB,28,2010,Primary,98,20,118
PUNJAB,28,2010,Middle,113,40,153
PUNJAB,28,2010,Matriculate/Secondary,166,54,220
PUNJAB,28,2010,Hr. Secondary/Intermediate/Pre-University,66,21,87
PUNJAB,28,2010,Diploma,9,5,14
PUNJAB,28,2010,Graduate,14,5,19
PUNJAB,28,2010,Post Graduate and Above,1,1,2
PUNJAB,28,2011,No Education,273,46,319
PUNJAB,28,2011,Primary,66,39,105
PUNJAB,28,2011,Middle,127,36,163
PUNJAB,28,2011,Matriculate/Secondary,208,63,271
PUNJAB,28,2011,Hr. Secondary/Intermediate/Pre-University,73,23,96
PUNJAB,28,2011,Diploma,2,1,3
PUNJAB,28,2011,Graduate,6,2,8
PUNJAB,28,2011,Post Graduate and Above,0,1,1
PUNJAB,28,2012,No Education,291,57,348
PUNJAB,28,2012,Primary,96,51,147
PUNJAB,28,2012,Middle,126,21,147
PUNJAB,28,2012,Matriculate/Secondary,184,86,270
PUNJAB,28,2012,Hr. Secondary/Intermediate/Pre-University,74,19,93
PUNJAB,28,2012,Diploma,6,3,9
PUNJAB,28,2012,Graduate,7,9,16
PUNJAB,28,2012,Post Graduate and Above,0,0,0
PUNJAB,28,2013,No Education,174,55,229
PUNJAB,28,2013,Primary,97,33,130
PUNJAB,28,2013,Middle,135,42,177
PUNJAB,28,2013,Matriculate/Secondary,185,73,258
PUNJAB,28,2013,Hr. Secondary/Intermediate/Pre-University,82,32,114
PUNJAB,28,2013,Diploma,17,7,24
PUNJAB,28,2013,Graduate,19,16,35
PUNJAB,28,2013,Post Graduate and Above,4,1,5
PUNJAB,28,2014,No Education,166,51,217
PUNJAB,28,2014,Primary,106,33,139
PUNJAB,28,2014,Middle,78,25,103
PUNJAB,28,2014,Matriculate/Secondary,124,64,188
PUNJAB,28,2014,Hr. Secondary/Intermediate/Pre-University,93,30,123
PUNJAB,28,2014,Diploma,8,2,10
PUNJAB,28,2014,Graduate,19,8,27
PUNJAB,28,2014,Post Graduate and Above,4,3,7
RAJASTHAN,29,2001,No Education,357,472,829
RAJASTHAN,29,2001,Primary,548,374,922
RAJASTHAN,29,2001,Middle,449,156,605
RAJASTHAN,29,2001,Matriculate/Secondary,387,151,538
RAJASTHAN,29,2001,Hr. Secondary/Intermediate/Pre-University,143,59,202
RAJASTHAN,29,2001,Diploma,20,6,26
RAJASTHAN,29,2001,Graduate,36,14,50
RAJASTHAN,29,2001,Post Graduate and Above,19,4,23
RAJASTHAN,29,2002,No Education,403,403,806
RAJASTHAN,29,2002,Primary,556,353,909
RAJASTHAN,29,2002,Middle,498,180,678
RAJASTHAN,29,2002,Matriculate/Secondary,374,120,494
RAJASTHAN,29,2002,Hr. Secondary/Intermediate/Pre-University,153,70,223
RAJASTHAN,29,2002,Diploma,20,8,28
RAJASTHAN,29,2002,Graduate,57,16,73
RAJASTHAN,29,2002,Post Graduate and Above,31,6,37
RAJASTHAN,29,2003,No Education,569,488,1057
RAJASTHAN,29,2003,Primary,681,401,1082
RAJASTHAN,29,2003,Middle,453,209,662
RAJASTHAN,29,2003,Matriculate/Secondary,457,110,567
RAJASTHAN,29,2003,Hr. Secondary/Intermediate/Pre-University,132,44,176
RAJASTHAN,29,2003,Diploma,26,2,28
RAJASTHAN,29,2003,Graduate,52,15,67
RAJASTHAN,29,2003,Post Graduate and Above,19,3,22
RAJASTHAN,29,2004,No Education,504,464,968
RAJASTHAN,29,2004,Primary,681,375,1056
RAJASTHAN,29,2004,Middle,571,188,759
RAJASTHAN,29,2004,Matriculate/Secondary,532,132,664
RAJASTHAN,29,2004,Hr. Secondary/Intermediate/Pre-University,116,47,163
RAJASTHAN,29,2004,Diploma,11,17,28
RAJASTHAN,29,2004,Graduate,54,14,68
RAJASTHAN,29,2004,Post Graduate and Above,17,2,19
RAJASTHAN,29,2005,No Education,675,567,1242
RAJASTHAN,29,2005,Primary,616,317,933
RAJASTHAN,29,2005,Middle,550,212,762
RAJASTHAN,29,2005,Matriculate/Secondary,753,160,913
RAJASTHAN,29,2005,Hr. Secondary/Intermediate/Pre-University,180,40,220
RAJASTHAN,29,2005,Diploma,36,9,45
RAJASTHAN,29,2005,Graduate,36,13,49
RAJASTHAN,29,2005,Post Graduate and Above,12,2,14
RAJASTHAN,29,2006,No Education,812,626,1438
RAJASTHAN,29,2006,Primary,841,398,1239
RAJASTHAN,29,2006,Middle,600,205,805
RAJASTHAN,29,2006,Matriculate/Secondary,412,84,496
RAJASTHAN,29,2006,Hr. Secondary/Intermediate/Pre-University,203,23,226
RAJASTHAN,29,2006,Diploma,12,3,15
RAJASTHAN,29,2006,Graduate,24,10,34
RAJASTHAN,29,2006,Post Graduate and Above,6,4,10
RAJASTHAN,29,2007,No Education,709,514,1223
RAJASTHAN,29,2007,Primary,687,312,999
RAJASTHAN,29,2007,Middle,632,185,817
RAJASTHAN,29,2007,Matriculate/Secondary,646,152,798
RAJASTHAN,29,2007,Hr. Secondary/Intermediate/Pre-University,411,79,490
RAJASTHAN,29,2007,Diploma,11,3,14
RAJASTHAN,29,2007,Graduate,48,34,82
RAJASTHAN,29,2007,Post Graduate and Above,10,4,14
RAJASTHAN,29,2008,No Education,876,647,1523
RAJASTHAN,29,2008,Primary,759,303,1062
RAJASTHAN,29,2008,Middle,669,251,920
RAJASTHAN,29,2008,Matriculate/Secondary,736,192,928
RAJASTHAN,29,2008,Hr. Secondary/Intermediate/Pre-University,479,123,602
RAJASTHAN,29,2008,Diploma,10,5,15
RAJASTHAN,29,2008,Graduate,61,34,95
RAJASTHAN,29,2008,Post Graduate and Above,12,9,21
RAJASTHAN,29,2009,No Education,860,619,1479
RAJASTHAN,29,2009,Primary,776,362,1138
RAJASTHAN,29,2009,Middle,628,220,848
RAJASTHAN,29,2009,Matriculate/Secondary,824,209,1033
RAJASTHAN,29,2009,Hr. Secondary/Intermediate/Pre-University,341,99,440
RAJASTHAN,29,2009,Diploma,14,5,19
RAJASTHAN,29,2009,Graduate,55,32,87
RAJASTHAN,29,2009,Post Graduate and Above,13,8,21
RAJASTHAN,29,2010,No Education,856,607,1463
RAJASTHAN,29,2010,Primary,775,373,1148
RAJASTHAN,29,2010,Middle,645,254,899
RAJASTHAN,29,2010,Matriculate/Secondary,682,177,859
RAJASTHAN,29,2010,Hr. Secondary/Intermediate/Pre-University,259,73,332
RAJASTHAN,29,2010,Diploma,37,17,54
RAJASTHAN,29,2010,Graduate,83,39,122
RAJASTHAN,29,2010,Post Graduate and Above,28,15,43
RAJASTHAN,29,2011,No Education,626,458,1084
RAJASTHAN,29,2011,Primary,687,321,1008
RAJASTHAN,29,2011,Middle,705,249,954
RAJASTHAN,29,2011,Matriculate/Secondary,596,167,763
RAJASTHAN,29,2011,Hr. Secondary/Intermediate/Pre-University,235,83,318
RAJASTHAN,29,2011,Diploma,56,17,73
RAJASTHAN,29,2011,Graduate,87,31,118
RAJASTHAN,29,2011,Post Graduate and Above,24,6,30
RAJASTHAN,29,2012,No Education,868,673,1541
RAJASTHAN,29,2012,Primary,618,323,941
RAJASTHAN,29,2012,Middle,625,237,862
RAJASTHAN,29,2012,Matriculate/Secondary,702,192,894
RAJASTHAN,29,2012,Hr. Secondary/Intermediate/Pre-University,266,95,361
RAJASTHAN,29,2012,Diploma,37,7,44
RAJASTHAN,29,2012,Graduate,90,58,148
RAJASTHAN,29,2012,Post Graduate and Above,21,9,30
RAJASTHAN,29,2013,No Education,862,611,1473
RAJASTHAN,29,2013,Primary,642,296,938
RAJASTHAN,29,2013,Middle,679,239,918
RAJASTHAN,29,2013,Matriculate/Secondary,683,209,892
RAJASTHAN,29,2013,Hr. Secondary/Intermediate/Pre-University,338,83,421
RAJASTHAN,29,2013,Diploma,47,8,55
RAJASTHAN,29,2013,Graduate,103,33,136
RAJASTHAN,29,2013,Post Graduate and Above,23,4,27
RAJASTHAN,29,2014,No Education,840,434,1274
RAJASTHAN,29,2014,Primary,611,293,904
RAJASTHAN,29,2014,Middle,567,188,755
RAJASTHAN,29,2014,Matriculate/Secondary,650,151,801
RAJASTHAN,29,2014,Hr. Secondary/Intermediate/Pre-University,330,75,405
RAJASTHAN,29,2014,Diploma,36,11,47
RAJASTHAN,29,2014,Graduate,77,28,105
RAJASTHAN,29,2014,Post Graduate and Above,8,7,15
SIKKIM,30,2001,No Education,32,10,42
SIKKIM,30,2001,Primary,18,14,32
SIKKIM,30,2001,Middle,7,4,11
SIKKIM,30,2001,Matriculate/Secondary,1,3,4
SIKKIM,30,2001,Hr. Secondary/Intermediate/Pre-University,4,1,5
SIKKIM,30,2001,Diploma,0,0,0
SIKKIM,30,2001,Graduate,0,0,0
SIKKIM,30,2001,Post Graduate and Above,0,0,0
SIKKIM,30,2002,No Education,5,2,7
SIKKIM,30,2002,Primary,6,4,10
SIKKIM,30,2002,Middle,9,8,17
SIKKIM,30,2002,Matriculate/Secondary,15,8,23
SIKKIM,30,2002,Hr. Secondary/Intermediate/Pre-University,17,0,17
SIKKIM,30,2002,Diploma,0,0,0
SIKKIM,30,2002,Graduate,2,2,4
SIKKIM,30,2002,Post Graduate and Above,0,0,0
SIKKIM,30,2003,No Education,23,11,34
SIKKIM,30,2003,Primary,28,19,47
SIKKIM,30,2003,Middle,12,7,19
SIKKIM,30,2003,Matriculate/Secondary,2,0,2
SIKKIM,30,2003,Hr. Secondary/Intermediate/Pre-University,1,0,1
SIKKIM,30,2003,Diploma,2,0,2
SIKKIM,30,2003,Graduate,0,0,0
SIKKIM,30,2003,Post Graduate and Above,0,0,0
SIKKIM,30,2004,No Education,0,0,0
SIKKIM,30,2004,Primary,14,7,21
SIKKIM,30,2004,Middle,24,21,45
SIKKIM,30,2004,Matriculate/Secondary,11,14,25
SIKKIM,30,2004,Hr. Secondary/Intermediate/Pre-University,7,0,7
SIKKIM,30,2004,Diploma,0,0,0
SIKKIM,30,2004,Graduate,0,0,0
SIKKIM,30,2004,Post Graduate and Above,0,0,0
SIKKIM,30,2005,No Education,26,12,38
SIKKIM,30,2005,Primary,21,19,40
SIKKIM,30,2005,Middle,10,8,18
SIKKIM,30,2005,Matriculate/Secondary,4,7,11
SIKKIM,30,2005,Hr. Secondary/Intermediate/Pre-University,1,1,2
SIKKIM,30,2005,Diploma,0,0,0
SIKKIM,30,2005,Graduate,0,0,0
SIKKIM,30,2005,Post Graduate and Above,0,0,0
SIKKIM,30,2006,No Education,24,35,59
SIKKIM,30,2006,Primary,40,7,47
SIKKIM,30,2006,Middle,15,3,18
SIKKIM,30,2006,Matriculate/Secondary,17,2,19
SIKKIM,30,2006,Hr. Secondary/Intermediate/Pre-University,2,0,2
SIKKIM,30,2006,Diploma,0,0,0
SIKKIM,30,2006,Graduate,0,0,0
SIKKIM,30,2006,Post Graduate and Above,0,0,0
SIKKIM,30,2007,No Education,36,21,57
SIKKIM,30,2007,Primary,20,6,26
SIKKIM,30,2007,Middle,15,5,20
SIKKIM,30,2007,Matriculate/Secondary,4,3,7
SIKKIM,30,2007,Hr. Secondary/Intermediate/Pre-University,0,1,1
SIKKIM,30,2007,Diploma,4,2,6
SIKKIM,30,2007,Graduate,5,0,5
SIKKIM,30,2007,Post Graduate and Above,0,0,0
SIKKIM,30,2008,No Education,80,12,92
SIKKIM,30,2008,Primary,55,40,95
SIKKIM,30,2008,Middle,32,12,44
SIKKIM,30,2008,Matriculate/Secondary,42,2,44
SIKKIM,30,2008,Hr. Secondary/Intermediate/Pre-University,4,5,9
SIKKIM,30,2008,Diploma,2,0,2
SIKKIM,30,2008,Graduate,1,0,1
SIKKIM,30,2008,Post Graduate and Above,0,0,0
SIKKIM,30,2009,No Education,62,63,125
SIKKIM,30,2009,Primary,35,31,66
SIKKIM,30,2009,Middle,13,17,30
SIKKIM,30,2009,Matriculate/Secondary,9,5,14
SIKKIM,30,2009,Hr. Secondary/Intermediate/Pre-University,1,2,3
SIKKIM,30,2009,Diploma,1,0,1
SIKKIM,30,2009,Graduate,1,1,2
SIKKIM,30,2009,Post Graduate and Above,0,0,0
SIKKIM,30,2010,No Education,51,9,60
SIKKIM,30,2010,Primary,82,11,93
SIKKIM,30,2010,Middle,53,7,60
SIKKIM,30,2010,Matriculate/Secondary,23,8,31
SIKKIM,30,2010,Hr. Secondary/Intermediate/Pre-University,11,3,14
SIKKIM,30,2010,Diploma,7,3,10
SIKKIM,30,2010,Graduate,5,2,7
SIKKIM,30,2010,Post Graduate and Above,3,2,5
SIKKIM,30,2011,No Education,52,36,88
SIKKIM,30,2011,Primary,36,28,64
SIKKIM,30,2011,Middle,10,5,15
SIKKIM,30,2011,Matriculate/Secondary,2,4,6
SIKKIM,30,2011,Hr. Secondary/Intermediate/Pre-University,3,3,6
SIKKIM,30,2011,Diploma,2,0,2
SIKKIM,30,2011,Graduate,1,1,2
SIKKIM,30,2011,Post Graduate and Above,1,0,1
SIKKIM,30,2012,No Education,5,5,10
SIKKIM,30,2012,Primary,25,15,40
SIKKIM,30,2012,Middle,7,25,32
SIKKIM,30,2012,Matriculate/Secondary,35,25,60
SIKKIM,30,2012,Hr. Secondary/Intermediate/Pre-University,14,9,23
SIKKIM,30,2012,Diploma,0,0,0
SIKKIM,30,2012,Graduate,3,3,6
SIKKIM,30,2012,Post Graduate and Above,7,3,10
SIKKIM,30,2013,No Education,0,1,1
SIKKIM,30,2013,Primary,57,17,74
SIKKIM,30,2013,Middle,31,21,52
SIKKIM,30,2013,Matriculate/Secondary,29,11,40
SIKKIM,30,2013,Hr. Secondary/Intermediate/Pre-University,7,9,16
SIKKIM,30,2013,Diploma,0,0,0
SIKKIM,30,2013,Graduate,1,0,1
SIKKIM,30,2013,Post Graduate and Above,0,0,0
SIKKIM,30,2014,No Education,16,6,22
SIKKIM,30,2014,Primary,38,30,68
SIKKIM,30,2014,Middle,44,21,65
SIKKIM,30,2014,Matriculate/Secondary,11,8,19
SIKKIM,30,2014,Hr. Secondary/Intermediate/Pre-University,9,3,12
SIKKIM,30,2014,Diploma,0,0,0
SIKKIM,30,2014,Graduate,2,1,3
SIKKIM,30,2014,Post Graduate and Above,0,0,0
TAMIL NADU,31,2001,No Education,2388,1544,3932
TAMIL NADU,31,2001,Primary,1519,914,2433
TAMIL NADU,31,2001,Middle,1543,837,2380
TAMIL NADU,31,2001,Matriculate/Secondary,767,428,1195
TAMIL NADU,31,2001,Hr. Secondary/Intermediate/Pre-University,455,232,687
TAMIL NADU,31,2001,Diploma,172,71,243
TAMIL NADU,31,2001,Graduate,196,94,290
TAMIL NADU,31,2001,Post Graduate and Above,88,42,130
TAMIL NADU,31,2002,No Education,2214,1390,3604
TAMIL NADU,31,2002,Primary,1678,1040,2718
TAMIL NADU,31,2002,Middle,1466,840,2306
TAMIL NADU,31,2002,Matriculate/Secondary,754,497,1251
TAMIL NADU,31,2002,Hr. Secondary/Intermediate/Pre-University,554,343,897
TAMIL NADU,31,2002,Diploma,151,69,220
TAMIL NADU,31,2002,Graduate,137,56,193
TAMIL NADU,31,2002,Post Graduate and Above,29,26,55
TAMIL NADU,31,2003,No Education,1572,1158,2730
TAMIL NADU,31,2003,Primary,1769,1226,2995
TAMIL NADU,31,2003,Middle,1920,1210,3130
TAMIL NADU,31,2003,Matriculate/Secondary,909,514,1423
TAMIL NADU,31,2003,Hr. Secondary/Intermediate/Pre-University,609,364,973
TAMIL NADU,31,2003,Diploma,156,95,251
TAMIL NADU,31,2003,Graduate,160,87,247
TAMIL NADU,31,2003,Post Graduate and Above,59,64,123
TAMIL NADU,31,2004,No Education,2089,1226,3315
TAMIL NADU,31,2004,Primary,1588,1116,2704
TAMIL NADU,31,2004,Middle,1974,1318,3292
TAMIL NADU,31,2004,Matriculate/Secondary,1165,529,1694
TAMIL NADU,31,2004,Hr. Secondary/Intermediate/Pre-University,739,449,1188
TAMIL NADU,31,2004,Diploma,152,69,221
TAMIL NADU,31,2004,Graduate,188,152,340
TAMIL NADU,31,2004,Post Graduate and Above,51,34,85
TAMIL NADU,31,2005,No Education,1989,1201,3190
TAMIL NADU,31,2005,Primary,1498,1015,2513
TAMIL NADU,31,2005,Middle,1845,1214,3059
TAMIL NADU,31,2005,Matriculate/Secondary,1103,489,1592
TAMIL NADU,31,2005,Hr. Secondary/Intermediate/Pre-University,714,424,1138
TAMIL NADU,31,2005,Diploma,143,60,203
TAMIL NADU,31,2005,Graduate,174,142,316
TAMIL NADU,31,2005,Post Graduate and Above,41,24,65
TAMIL NADU,31,2006,No Education,1585,1160,2745
TAMIL NADU,31,2006,Primary,1619,1093,2712
TAMIL NADU,31,2006,Middle,1963,1366,3329
TAMIL NADU,31,2006,Matriculate/Secondary,1065,656,1721
TAMIL NADU,31,2006,Hr. Secondary/Intermediate/Pre-University,887,448,1335
TAMIL NADU,31,2006,Diploma,175,36,211
TAMIL NADU,31,2006,Graduate,190,102,292
TAMIL NADU,31,2006,Post Graduate and Above,25,11,36
TAMIL NADU,31,2007,No Education,1834,1219,3053
TAMIL NADU,31,2007,Primary,1873,1150,3023
TAMIL NADU,31,2007,Middle,2271,1437,3708
TAMIL NADU,31,2007,Matriculate/Secondary,1232,690,1922
TAMIL NADU,31,2007,Hr. Secondary/Intermediate/Pre-University,1026,471,1497
TAMIL NADU,31,2007,Diploma,202,38,240
TAMIL NADU,31,2007,Graduate,220,107,327
TAMIL NADU,31,2007,Post Graduate and Above,29,12,41
TAMIL NADU,31,2008,No Education,1909,1280,3189
TAMIL NADU,31,2008,Primary,1950,1208,3158
TAMIL NADU,31,2008,Middle,2364,1509,3873
TAMIL NADU,31,2008,Matriculate/Secondary,1282,725,2007
TAMIL NADU,31,2008,Hr. Secondary/Intermediate/Pre-University,1069,495,1564
TAMIL NADU,31,2008,Diploma,210,40,250
TAMIL NADU,31,2008,Graduate,229,112,341
TAMIL NADU,31,2008,Post Graduate and Above,30,13,43
TAMIL NADU,31,2009,No Education,1498,1117,2615
TAMIL NADU,31,2009,Primary,1781,941,2722
TAMIL NADU,31,2009,Middle,2478,1503,3981
TAMIL NADU,31,2009,Matriculate/Secondary,1696,981,2677
TAMIL NADU,31,2009,Hr. Secondary/Intermediate/Pre-University,872,594,1466
TAMIL NADU,31,2009,Diploma,169,83,252
TAMIL NADU,31,2009,Graduate,210,126,336
TAMIL NADU,31,2009,Post Graduate and Above,246,129,375
TAMIL NADU,31,2010,No Education,2045,1349,3394
TAMIL NADU,31,2010,Primary,2868,1308,4176
TAMIL NADU,31,2010,Middle,2685,1684,4369
TAMIL NADU,31,2010,Matriculate/Secondary,1362,830,2192
TAMIL NADU,31,2010,Hr. Secondary/Intermediate/Pre-University,1070,603,1673
TAMIL NADU,31,2010,Diploma,152,59,211
TAMIL NADU,31,2010,Graduate,291,133,424
TAMIL NADU,31,2010,Post Graduate and Above,79,43,122
TAMIL NADU,31,2011,No Education,2576,1346,3922
TAMIL NADU,31,2011,Primary,1900,1166,3066
TAMIL NADU,31,2011,Middle,2610,1436,4046
TAMIL NADU,31,2011,Matriculate/Secondary,1645,876,2521
TAMIL NADU,31,2011,Hr. Secondary/Intermediate/Pre-University,964,478,1442
TAMIL NADU,31,2011,Diploma,194,59,253
TAMIL NADU,31,2011,Graduate,296,245,541
TAMIL NADU,31,2011,Post Graduate and Above,97,75,172
TAMIL NADU,31,2012,No Education,2391,1419,3810
TAMIL NADU,31,2012,Primary,1527,1007,2534
TAMIL NADU,31,2012,Middle,2381,1326,3707
TAMIL NADU,31,2012,Matriculate/Secondary,1617,950,2567
TAMIL NADU,31,2012,Hr. Secondary/Intermediate/Pre-University,1643,741,2384
TAMIL NADU,31,2012,Diploma,468,325,793
TAMIL NADU,31,2012,Graduate,657,329,986
TAMIL NADU,31,2012,Post Graduate and Above,64,82,146
TAMIL NADU,31,2013,No Education,2298,1203,3501
TAMIL NADU,31,2013,Primary,1909,900,2809
TAMIL NADU,31,2013,Middle,2668,1379,4047
TAMIL NADU,31,2013,Matriculate/Secondary,2083,1000,3083
TAMIL NADU,31,2013,Hr. Secondary/Intermediate/Pre-University,1360,574,1934
TAMIL NADU,31,2013,Diploma,292,96,388
TAMIL NADU,31,2013,Graduate,458,226,684
TAMIL NADU,31,2013,Post Graduate and Above,114,41,155
TAMIL NADU,31,2014,No Education,1538,841,2379
TAMIL NADU,31,2014,Primary,1765,740,2505
TAMIL NADU,31,2014,Middle,2551,1304,3855
TAMIL NADU,31,2014,Matriculate/Secondary,2325,1027,3352
TAMIL NADU,31,2014,Hr. Secondary/Intermediate/Pre-University,1348,609,1957
TAMIL NADU,31,2014,Diploma,315,137,452
TAMIL NADU,31,2014,Graduate,490,275,765
TAMIL NADU,31,2014,Post Graduate and Above,90,27,117
TELANGANA,32,2001,No Education,0,0,0
TELANGANA,32,2001,Primary,0,0,0
TELANGANA,32,2001,Middle,0,0,0
TELANGANA,32,2001,Matriculate/Secondary,0,0,0
TELANGANA,32,2001,Hr. Secondary/Intermediate/Pre-University,0,0,0
TELANGANA,32,2001,Diploma,0,0,0
TELANGANA,32,2001,Graduate,0,0,0
TELANGANA,32,2001,Post Graduate and Above,0,0,0
TELANGANA,32,2002,No Education,0,0,0
TELANGANA,32,2002,Primary,0,0,0
TELANGANA,32,2002,Middle,0,0,0
TELANGANA,32,2002,Matriculate/Secondary,0,0,0
TELANGANA,32,2002,Hr. Secondary/Intermediate/Pre-University,0,0,0
TELANGANA,32,2002,Diploma,0,0,0
TELANGANA,32,2002,Graduate,0,0,0
TELANGANA,32,2002,Post Graduate and Above,0,0,0
TELANGANA,32,2003,No Education,0,0,0
TELANGANA,32,2003,Primary,0,0,0
TELANGANA,32,2003,Middle,0,0,0
TELANGANA,32,2003,Matriculate/Secondary,0,0,0
TELANGANA,32,2003,Hr. Secondary/Intermediate/Pre-University,0,0,0
TELANGANA,32,2003,Diploma,0,0,0
TELANGANA,32,2003,Graduate,0,0,0
TELANGANA,32,2003,Post Graduate and Above,0,0,0
TELANGANA,32,2004,No Education,0,0,0
TELANGANA,32,2004,Primary,0,0,0
TELANGANA,32,2004,Middle,0,0,0
TELANGANA,32,2004,Matriculate/Secondary,0,0,0
TELANGANA,32,2004,Hr. Secondary/Intermediate/Pre-University,0,0,0
TELANGANA,32,2004,Diploma,0,0,0
TELANGANA,32,2004,Graduate,0,0,0
TELANGANA,32,2004,Post Graduate and Above,0,0,0
TELANGANA,32,2005,No Education,0,0,0
TELANGANA,32,2005,Primary,0,0,0
TELANGANA,32,2005,Middle,0,0,0
TELANGANA,32,2005,Matriculate/Secondary,0,0,0
TELANGANA,32,2005,Hr. Secondary/Intermediate/Pre-University,0,0,0
TELANGANA,32,2005,Diploma,0,0,0
TELANGANA,32,2005,Graduate,0,0,0
TELANGANA,32,2005,Post Graduate and Above,0,0,0
TELANGANA,32,2006,No Education,0,0,0
TELANGANA,32,2006,Primary,0,0,0
TELANGANA,32,2006,Middle,0,0,0
TELANGANA,32,2006,Matriculate/Secondary,0,0,0
TELANGANA,32,2006,Hr. Secondary/Intermediate/Pre-University,0,0,0
TELANGANA,32,2006,Diploma,0,0,0
TELANGANA,32,2006,Graduate,0,0,0
TELANGANA,32,2006,Post Graduate and Above,0,0,0
TELANGANA,32,2007,No Education,0,0,0
TELANGANA,32,2007,Primary,0,0,0
TELANGANA,32,2007,Middle,0,0,0
TELANGANA,32,2007,Matriculate/Secondary,0,0,0
TELANGANA,32,2007,Hr. Secondary/Intermediate/Pre-University,0,0,0
TELANGANA,32,2007,Diploma,0,0,0
TELANGANA,32,2007,Graduate,0,0,0
TELANGANA,32,2007,Post Graduate and Above,0,0,0
TELANGANA,32,2008,No Education,0,0,0
TELANGANA,32,2008,Primary,0,0,0
TELANGANA,32,2008,Middle,0,0,0
TELANGANA,32,2008,Matriculate/Secondary,0,0,0
TELANGANA,32,2008,Hr. Secondary/Intermediate/Pre-University,0,0,0
TELANGANA,32,2008,Diploma,0,0,0
TELANGANA,32,2008,Graduate,0,0,0
TELANGANA,32,2008,Post Graduate and Above,0,0,0
TELANGANA,32,2009,No Education,0,0,0
TELANGANA,32,2009,Primary,0,0,0
TELANGANA,32,2009,Middle,0,0,0
TELANGANA,32,2009,Matriculate/Secondary,0,0,0
TELANGANA,32,2009,Hr. Secondary/Intermediate/Pre-University,0,0,0
TELANGANA,32,2009,Diploma,0,0,0
TELANGANA,32,2009,Graduate,0,0,0
TELANGANA,32,2009,Post Graduate and Above,0,0,0
TELANGANA,32,2010,No Education,0,0,0
TELANGANA,32,2010,Primary,0,0,0
TELANGANA,32,2010,Middle,0,0,0
TELANGANA,32,2010,Matriculate/Secondary,0,0,0
TELANGANA,32,2010,Hr. Secondary/Intermediate/Pre-University,0,0,0
TELANGANA,32,2010,Diploma,0,0,0
TELANGANA,32,2010,Graduate,0,0,0
TELANGANA,32,2010,Post Graduate and Above,0,0,0
TELANGANA,32,2011,No Education,0,0,0
TELANGANA,32,2011,Primary,0,0,0
TELANGANA,32,2011,Middle,0,0,0
TELANGANA,32,2011,Matriculate/Secondary,0,0,0
TELANGANA,32,2011,Hr. Secondary/Intermediate/Pre-University,0,0,0
TELANGANA,32,2011,Diploma,0,0,0
TELANGANA,32,2011,Graduate,0,0,0
TELANGANA,32,2011,Post Graduate and Above,0,0,0
TELANGANA,32,2012,No Education,0,0,0
TELANGANA,32,2012,Primary,0,0,0
TELANGANA,32,2012,Middle,0,0,0
TELANGANA,32,2012,Matriculate/Secondary,0,0,0
TELANGANA,32,2012,Hr. Secondary/Intermediate/Pre-University,0,0,0
TELANGANA,32,2012,Diploma,0,0,0
TELANGANA,32,2012,Graduate,0,0,0
TELANGANA,32,2012,Post Graduate and Above,0,0,0
TELANGANA,32,2013,No Education,0,0,0
TELANGANA,32,2013,Primary,0,0,0
TELANGANA,32,2013,Middle,0,0,0
TELANGANA,32,2013,Matriculate/Secondary,0,0,0
TELANGANA,32,2013,Hr. Secondary/Intermediate/Pre-University,0,0,0
TELANGANA,32,2013,Diploma,0,0,0
TELANGANA,32,2013,Graduate,0,0,0
TELANGANA,32,2013,Post Graduate and Above,0,0,0
TELANGANA,32,2013,No Education,0,0,0
TELANGANA,32,2013,Primary,0,0,0
TELANGANA,32,2013,Middle,0,0,0
TELANGANA,32,2013,Matriculate/Secondary,0,0,0
TELANGANA,32,2013,Hr. Secondary/Intermediate/Pre-University,0,0,0
TELANGANA,32,2013,Diploma,0,0,0
TELANGANA,32,2013,Graduate,0,0,0
TELANGANA,32,2013,Post Graduate and Above,0,0,0
TELANGANA,32,2014,No Education,1252,759,2011
TELANGANA,32,2014,Primary,921,462,1383
TELANGANA,32,2014,Middle,997,292,1289
TELANGANA,32,2014,Matriculate/Secondary,1039,294,1333
TELANGANA,32,2014,Hr. Secondary/Intermediate/Pre-University,511,192,703
TELANGANA,32,2014,Diploma,78,13,91
TELANGANA,32,2014,Graduate,262,51,313
TELANGANA,32,2014,Post Graduate and Above,50,14,64
TOTAL (ALL INDIA),37,2001,No Education,15908,12817,28725
TOTAL (ALL INDIA),37,2001,Primary,16782,11285,28067
TOTAL (ALL INDIA),37,2001,Middle,15767,9143,24910
TOTAL (ALL INDIA),37,2001,Matriculate/Secondary,10898,5486,16384
TOTAL (ALL INDIA),37,2001,Hr. Secondary/Intermediate/Pre-University,4356,2391,6747
TOTAL (ALL INDIA),37,2001,Diploma,905,294,1199
TOTAL (ALL INDIA),37,2001,Graduate,1286,584,1870
TOTAL (ALL INDIA),37,2001,Post Graduate and Above,412,192,604
TOTAL (ALL INDIA),37,2002,No Education,16069,12373,28442
TOTAL (ALL INDIA),37,2002,Primary,17203,10829,28032
TOTAL (ALL INDIA),37,2002,Middle,16876,8606,25482
TOTAL (ALL INDIA),37,2002,Matriculate/Secondary,12025,5915,17940
TOTAL (ALL INDIA),37,2002,Hr. Secondary/Intermediate/Pre-University,4852,2379,7231
TOTAL (ALL INDIA),37,2002,Diploma,768,328,1096
TOTAL (ALL INDIA),37,2002,Graduate,1230,546,1776
TOTAL (ALL INDIA),37,2002,Post Graduate and Above,309,109,418
TOTAL (ALL INDIA),37,2003,No Education,15108,10856,25964
TOTAL (ALL INDIA),37,2003,Primary,18223,10792,29015
TOTAL (ALL INDIA),37,2003,Middle,16475,9028,25503
TOTAL (ALL INDIA),37,2003,Matriculate/Secondary,12538,6004,18542
TOTAL (ALL INDIA),37,2003,Hr. Secondary/Intermediate/Pre-University,5509,2846,8355
TOTAL (ALL INDIA),37,2003,Diploma,631,275,906
TOTAL (ALL INDIA),37,2003,Graduate,1445,659,2104
TOTAL (ALL INDIA),37,2003,Post Graduate and Above,292,170,462
TOTAL (ALL INDIA),37,2004,No Education,15690,11226,26916
TOTAL (ALL INDIA),37,2004,Primary,17996,10667,28663
TOTAL (ALL INDIA),37,2004,Middle,17491,9232,26723
TOTAL (ALL INDIA),37,2004,Matriculate/Secondary,13313,5947,19260
TOTAL (ALL INDIA),37,2004,Hr. Secondary/Intermediate/Pre-University,5678,2968,8646
TOTAL (ALL INDIA),37,2004,Diploma,601,241,842
TOTAL (ALL INDIA),37,2004,Graduate,1430,588,2018
TOTAL (ALL INDIA),37,2004,Post Graduate and Above,452,177,629
TOTAL (ALL INDIA),37,2005,No Education,15244,10990,26234
TOTAL (ALL INDIA),37,2005,Primary,17978,11356,29334
TOTAL (ALL INDIA),37,2005,Middle,18207,9111,27318
TOTAL (ALL INDIA),37,2005,Matriculate/Secondary,13369,5755,19124
TOTAL (ALL INDIA),37,2005,Hr. Secondary/Intermediate/Pre-University,5609,2792,8401
TOTAL (ALL INDIA),37,2005,Diploma,815,248,1063
TOTAL (ALL INDIA),37,2005,Graduate,1406,628,2034
TOTAL (ALL INDIA),37,2005,Post Graduate and Above,288,118,406
TOTAL (ALL INDIA),37,2006,No Education,14763,10402,25165
TOTAL (ALL INDIA),37,2006,Primary,17614,10889,28503
TOTAL (ALL INDIA),37,2006,Middle,19061,9916,28977
TOTAL (ALL INDIA),37,2006,Matriculate/Secondary,14551,6903,21454
TOTAL (ALL INDIA),37,2006,Hr. Secondary/Intermediate/Pre-University,7002,3409,10411
TOTAL (ALL INDIA),37,2006,Diploma,851,186,1037
TOTAL (ALL INDIA),37,2006,Graduate,1595,604,2199
TOTAL (ALL INDIA),37,2006,Post Graduate and Above,265,101,366
TOTAL (ALL INDIA),37,2007,No Education,15607,11165,26772
TOTAL (ALL INDIA),37,2007,Primary,19367,11484,30851
TOTAL (ALL INDIA),37,2007,Middle,19671,10023,29694
TOTAL (ALL INDIA),37,2007,Matriculate/Secondary,15030,6519,21549
TOTAL (ALL INDIA),37,2007,Hr. Secondary/Intermediate/Pre-University,6885,3105,9990
TOTAL (ALL INDIA),37,2007,Diploma,846,232,1078
TOTAL (ALL INDIA),37,2007,Graduate,1632,720,2352
TOTAL (ALL INDIA),37,2007,Post Graduate and Above,257,94,351
TOTAL (ALL INDIA),37,2008,No Education,15335,10585,25920
TOTAL (ALL INDIA),37,2008,Primary,19730,11944,31674
TOTAL (ALL INDIA),37,2008,Middle,19492,10187,29679
TOTAL (ALL INDIA),37,2008,Matriculate/Secondary,15319,7069,22388
TOTAL (ALL INDIA),37,2008,Hr. Secondary/Intermediate/Pre-University,7560,3534,11094
TOTAL (ALL INDIA),37,2008,Diploma,777,218,995
TOTAL (ALL INDIA),37,2008,Graduate,1983,794,2777
TOTAL (ALL INDIA),37,2008,Post Graduate and Above,348,142,490
TOTAL (ALL INDIA),37,2009,No Education,16157,11081,27238
TOTAL (ALL INDIA),37,2009,Primary,18831,10968,29799
TOTAL (ALL INDIA),37,2009,Middle,19695,10449,30144
TOTAL (ALL INDIA),37,2009,Matriculate/Secondary,15908,7812,23720
TOTAL (ALL INDIA),37,2009,Hr. Secondary/Intermediate/Pre-University,7425,3769,11194
TOTAL (ALL INDIA),37,2009,Diploma,817,344,1161
TOTAL (ALL INDIA),37,2009,Graduate,1938,948,2886
TOTAL (ALL INDIA),37,2009,Post Graduate and Above,700,309,1009
TOTAL (ALL INDIA),37,2010,No Education,16058,10644,26702
TOTAL (ALL INDIA),37,2010,Primary,22386,13044,35430
TOTAL (ALL INDIA),37,2010,Middle,20290,10267,30557
TOTAL (ALL INDIA),37,2010,Matriculate/Secondary,16516,8065,24581
TOTAL (ALL INDIA),37,2010,Hr. Secondary/Intermediate/Pre-University,7735,3784,11519
TOTAL (ALL INDIA),37,2010,Diploma,996,353,1349
TOTAL (ALL INDIA),37,2010,Graduate,2273,991,3264
TOTAL (ALL INDIA),37,2010,Post Graduate and Above,926,271,1197
TOTAL (ALL INDIA),37,2011,No Education,16467,10571,27038
TOTAL (ALL INDIA),37,2011,Primary,20590,11781,32371
TOTAL (ALL INDIA),37,2011,Middle,21435,11344,32779
TOTAL (ALL INDIA),37,2011,Matriculate/Secondary,17467,8190,25657
TOTAL (ALL INDIA),37,2011,Hr. Secondary/Intermediate/Pre-University,8099,4132,12231
TOTAL (ALL INDIA),37,2011,Diploma,1021,363,1384
TOTAL (ALL INDIA),37,2011,Graduate,2300,1122,3422
TOTAL (ALL INDIA),37,2011,Post Graduate and Above,460,243,703
TOTAL (ALL INDIA),37,2012,No Education,16409,10232,26641
TOTAL (ALL INDIA),37,2012,Primary,19787,11301,31088
TOTAL (ALL INDIA),37,2012,Middle,20748,10457,31205
TOTAL (ALL INDIA),37,2012,Matriculate/Secondary,17692,8275,25967
TOTAL (ALL INDIA),37,2012,Hr. Secondary/Intermediate/Pre-University,8792,4297,13089
TOTAL (ALL INDIA),37,2012,Diploma,1391,652,2043
TOTAL (ALL INDIA),37,2012,Graduate,3072,1500,4572
TOTAL (ALL INDIA),37,2012,Post Graduate and Above,562,278,840
TOTAL (ALL INDIA),37,2013,No Education,15579,9425,25004
TOTAL (ALL INDIA),37,2013,Primary,19502,10322,29824
TOTAL (ALL INDIA),37,2013,Middle,21679,10095,31774
TOTAL (ALL INDIA),37,2013,Matriculate/Secondary,19416,8180,27596
TOTAL (ALL INDIA),37,2013,Hr. Secondary/Intermediate/Pre-University,9544,4305,13849
TOTAL (ALL INDIA),37,2013,Diploma,1204,452,1656
TOTAL (ALL INDIA),37,2013,Graduate,3110,1270,4380
TOTAL (ALL INDIA),37,2013,Post Graduate and Above,509,207,716
TOTAL (ALL INDIA),37,2014,No Education,11771,7004,18775
TOTAL (ALL INDIA),37,2014,Primary,16493,8527,25020
TOTAL (ALL INDIA),37,2014,Middle,17831,8733,26564
TOTAL (ALL INDIA),37,2014,Matriculate/Secondary,19076,7925,27001
TOTAL (ALL INDIA),37,2014,Hr. Secondary/Intermediate/Pre-University,10079,4348,14427
TOTAL (ALL INDIA),37,2014,Diploma,1124,385,1509
TOTAL (ALL INDIA),37,2014,Graduate,2670,1067,3737
TOTAL (ALL INDIA),37,2014,Post Graduate and Above,289,94,383
TOTAL (STATES),,2001,No Education,15725,12669,28394
TOTAL (STATES),,2001,Primary,16531,11118,27649
TOTAL (STATES),,2001,Middle,15357,8838,24195
TOTAL (STATES),,2001,Matriculate/Secondary,10681,5382,16063
TOTAL (STATES),,2001,Hr. Secondary/Intermediate/Pre-University,4241,2315,6556
TOTAL (STATES),,2001,Diploma,895,293,1188
TOTAL (STATES),,2001,Graduate,1260,571,1831
TOTAL (STATES),,2001,Post Graduate and Above,408,191,599
TOTAL (STATES),,2002,No Education,15911,12239,28150
TOTAL (STATES),,2002,Primary,16918,10706,27624
TOTAL (STATES),,2002,Middle,16469,8408,24877
TOTAL (STATES),,2002,Matriculate/Secondary,11763,5755,17518
TOTAL (STATES),,2002,Hr. Secondary/Intermediate/Pre-University,4768,2334,7102
TOTAL (STATES),,2002,Diploma,755,328,1083
TOTAL (STATES),,2002,Graduate,1200,536,1736
TOTAL (STATES),,2002,Post Graduate and Above,304,105,409
TOTAL (STATES),,2003,No Education,14965,10748,25713
TOTAL (STATES),,2003,Primary,17916,10639,28555
TOTAL (STATES),,2003,Middle,16143,8874,25017
TOTAL (STATES),,2003,Matriculate/Secondary,12182,5778,17960
TOTAL (STATES),,2003,Hr. Secondary/Intermediate/Pre-University,5372,2803,8175
TOTAL (STATES),,2003,Diploma,624,270,894
TOTAL (STATES),,2003,Graduate,1415,635,2050
TOTAL (STATES),,2003,Post Graduate and Above,288,170,458
TOTAL (STATES),,2004,No Education,15545,11123,26668
TOTAL (STATES),,2004,Primary,17766,10548,28314
TOTAL (STATES),,2004,Middle,17059,9029,26088
TOTAL (STATES),,2004,Matriculate/Secondary,12958,5693,18651
TOTAL (STATES),,2004,Hr. Secondary/Intermediate/Pre-University,5591,2919,8510
TOTAL (STATES),,2004,Diploma,595,235,830
TOTAL (STATES),,2004,Graduate,1395,577,1972
TOTAL (STATES),,2004,Post Graduate and Above,447,173,620
TOTAL (STATES),,2005,No Education,15032,10823,25855
TOTAL (STATES),,2005,Primary,17725,11212,28937
TOTAL (STATES),,2005,Middle,17786,8903,26689
TOTAL (STATES),,2005,Matriculate/Secondary,13062,5580,18642
TOTAL (STATES),,2005,Hr. Secondary/Intermediate/Pre-University,5515,2737,8252
TOTAL (STATES),,2005,Diploma,809,244,1053
TOTAL (STATES),,2005,Graduate,1373,608,1981
TOTAL (STATES),,2005,Post Graduate and Above,282,111,393
TOTAL (STATES),,2006,No Education,14569,10251,24820
TOTAL (STATES),,2006,Primary,17377,10750,28127
TOTAL (STATES),,2006,Middle,18561,9682,28243
TOTAL (STATES),,2006,Matriculate/Secondary,14248,6738,20986
TOTAL (STATES),,2006,Hr. Secondary/Intermediate/Pre-University,6843,3338,10181
TOTAL (STATES),,2006,Diploma,800,178,978
TOTAL (STATES),,2006,Graduate,1543,576,2119
TOTAL (STATES),,2006,Post Graduate and Above,262,99,361
TOTAL (STATES),,2007,No Education,15414,11005,26419
TOTAL (STATES),,2007,Primary,19151,11377,30528
TOTAL (STATES),,2007,Middle,19145,9787,28932
TOTAL (STATES),,2007,Matriculate/Secondary,14706,6316,21022
TOTAL (STATES),,2007,Hr. Secondary/Intermediate/Pre-University,6713,3013,9726
TOTAL (STATES),,2007,Diploma,831,224,1055
TOTAL (STATES),,2007,Graduate,1583,695,2278
TOTAL (STATES),,2007,Post Graduate and Above,256,91,347
TOTAL (STATES),,2008,No Education,15205,10477,25682
TOTAL (STATES),,2008,Primary,19548,11832,31380
TOTAL (STATES),,2008,Middle,19004,9963,28967
TOTAL (STATES),,2008,Matriculate/Secondary,15014,6859,21873
TOTAL (STATES),,2008,Hr. Secondary/Intermediate/Pre-University,7407,3436,10843
TOTAL (STATES),,2008,Diploma,765,214,979
TOTAL (STATES),,2008,Graduate,1935,770,2705
TOTAL (STATES),,2008,Post Graduate and Above,335,138,473
TOTAL (STATES),,2009,No Education,16000,10957,26957
TOTAL (STATES),,2009,Primary,18652,10868,29520
TOTAL (STATES),,2009,Middle,19192,10186,29378
TOTAL (STATES),,2009,Matriculate/Secondary,15522,7597,23119
TOTAL (STATES),,2009,Hr. Secondary/Intermediate/Pre-University,7299,3665,10964
TOTAL (STATES),,2009,Diploma,803,341,1144
TOTAL (STATES),,2009,Graduate,1887,915,2802
TOTAL (STATES),,2009,Post Graduate and Above,682,304,986
TOTAL (STATES),,2010,No Education,15878,10530,26408
TOTAL (STATES),,2010,Primary,22174,12898,35072
TOTAL (STATES),,2010,Middle,20005,10077,30082
TOTAL (STATES),,2010,Matriculate/Secondary,15981,7807,23788
TOTAL (STATES),,2010,Hr. Secondary/Intermediate/Pre-University,7554,3668,11222
TOTAL (STATES),,2010,Diploma,974,342,1316
TOTAL (STATES),,2010,Graduate,2216,950,3166
TOTAL (STATES),,2010,Post Graduate and Above,905,267,1172
TOTAL (STATES),,2011,No Education,16325,10480,26805
TOTAL (STATES),,2011,Primary,20334,11660,31994
TOTAL (STATES),,2011,Middle,21021,11166,32187
TOTAL (STATES),,2011,Matriculate/Secondary,16870,7932,24802
TOTAL (STATES),,2011,Hr. Secondary/Intermediate/Pre-University,7838,3983,11821
TOTAL (STATES),,2011,Diploma,997,355,1352
TOTAL (STATES),,2011,Graduate,2228,1094,3322
TOTAL (STATES),,2011,Post Graduate and Above,452,240,692
TOTAL (STATES),,2012,No Education,16209,10132,26341
TOTAL (STATES),,2012,Primary,19565,11177,30742
TOTAL (STATES),,2012,Middle,20270,10223,30493
TOTAL (STATES),,2012,Matriculate/Secondary,17141,7977,25118
TOTAL (STATES),,2012,Hr. Secondary/Intermediate/Pre-University,8522,4172,12694
TOTAL (STATES),,2012,Diploma,1375,645,2020
TOTAL (STATES),,2012,Graduate,2982,1457,4439
TOTAL (STATES),,2012,Post Graduate and Above,549,271,820
TOTAL (STATES),,2013,No Education,15363,9328,24691
TOTAL (STATES),,2013,Primary,19233,10199,29432
TOTAL (STATES),,2013,Middle,21172,9919,31091
TOTAL (STATES),,2013,Matriculate/Secondary,18856,7935,26791
TOTAL (STATES),,2013,Hr. Secondary/Intermediate/Pre-University,9160,4100,13260
TOTAL (STATES),,2013,Diploma,1184,444,1628
TOTAL (STATES),,2013,Graduate,3014,1223,4237
TOTAL (STATES),,2013,Post Graduate and Above,497,203,700
TOTAL (STATES),,2014,No Education,11554,6866,18420
TOTAL (STATES),,2014,Primary,16129,8354,24483
TOTAL (STATES),,2014,Middle,17485,8619,26104
TOTAL (STATES),,2014,Matriculate/Secondary,18645,7752,26397
TOTAL (STATES),,2014,Hr. Secondary/Intermediate/Pre-University,9809,4241,14050
TOTAL (STATES),,2014,Diploma,1097,370,1467
TOTAL (STATES),,2014,Graduate,2576,1040,3616
TOTAL (STATES),,2014,Post Graduate and Above,277,91,368
TOTAL (UTs),,2001,No Education,183,148,331
TOTAL (UTs),,2001,Primary,251,167,418
TOTAL (UTs),,2001,Middle,410,305,715
TOTAL (UTs),,2001,Matriculate/Secondary,217,104,321
TOTAL (UTs),,2001,Hr. Secondary/Intermediate/Pre-University,115,76,191
TOTAL (UTs),,2001,Diploma,10,1,11
TOTAL (UTs),,2001,Graduate,26,13,39
TOTAL (UTs),,2001,Post Graduate and Above,4,1,5
TOTAL (UTs),,2002,No Education,158,134,292
TOTAL (UTs),,2002,Primary,285,123,408
TOTAL (UTs),,2002,Middle,407,198,605
TOTAL (UTs),,2002,Matriculate/Secondary,262,160,422
TOTAL (UTs),,2002,Hr. Secondary/Intermediate/Pre-University,84,45,129
TOTAL (UTs),,2002,Diploma,13,0,13
TOTAL (UTs),,2002,Graduate,30,10,40
TOTAL (UTs),,2002,Post Graduate and Above,5,4,9
TOTAL (UTs),,2003,No Education,143,108,251
TOTAL (UTs),,2003,Primary,307,153,460
TOTAL (UTs),,2003,Middle,332,154,486
TOTAL (UTs),,2003,Matriculate/Secondary,356,226,582
TOTAL (UTs),,2003,Hr. Secondary/Intermediate/Pre-University,137,43,180
TOTAL (UTs),,2003,Diploma,7,5,12
TOTAL (UTs),,2003,Graduate,30,24,54
TOTAL (UTs),,2003,Post Graduate and Above,4,0,4
TOTAL (UTs),,2004,No Education,145,103,248
TOTAL (UTs),,2004,Primary,230,119,349
TOTAL (UTs),,2004,Middle,432,203,635
TOTAL (UTs),,2004,Matriculate/Secondary,355,254,609
TOTAL (UTs),,2004,Hr. Secondary/Intermediate/Pre-University,87,49,136
TOTAL (UTs),,2004,Diploma,6,6,12
TOTAL (UTs),,2004,Graduate,35,11,46
TOTAL (UTs),,2004,Post Graduate and Above,5,4,9
TOTAL (UTs),,2005,No Education,212,167,379
TOTAL (UTs),,2005,Primary,253,144,397
TOTAL (UTs),,2005,Middle,421,208,629
TOTAL (UTs),,2005,Matriculate/Secondary,307,175,482
TOTAL (UTs),,2005,Hr. Secondary/Intermediate/Pre-University,94,55,149
TOTAL (UTs),,2005,Diploma,6,4,10
TOTAL (UTs),,2005,Graduate,33,20,53
TOTAL (UTs),,2005,Post Graduate and Above,6,7,13
TOTAL (UTs),,2006,No Education,194,151,345
TOTAL (UTs),,2006,Primary,237,139,376
TOTAL (UTs),,2006,Middle,500,234,734
TOTAL (UTs),,2006,Matriculate/Secondary,303,165,468
TOTAL (UTs),,2006,Hr. Secondary/Intermediate/Pre-University,159,71,230
TOTAL (UTs),,2006,Diploma,51,8,59
TOTAL (UTs),,2006,Graduate,52,28,80
TOTAL (UTs),,2006,Post Graduate and Above,3,2,5
TOTAL (UTs),,2007,No Education,193,160,353
TOTAL (UTs),,2007,Primary,216,107,323
TOTAL (UTs),,2007,Middle,526,236,762
TOTAL (UTs),,2007,Matriculate/Secondary,324,203,527
TOTAL (UTs),,2007,Hr. Secondary/Intermediate/Pre-University,172,92,264
TOTAL (UTs),,2007,Diploma,15,8,23
TOTAL (UTs),,2007,Graduate,49,25,74
TOTAL (UTs),,2007,Post Graduate and Above,1,3,4
TOTAL (UTs),,2008,No Education,130,108,238
TOTAL (UTs),,2008,Primary,182,112,294
TOTAL (UTs),,2008,Middle,488,224,712
TOTAL (UTs),,2008,Matriculate/Secondary,305,210,515
TOTAL (UTs),,2008,Hr. Secondary/Intermediate/Pre-University,153,98,251
TOTAL (UTs),,2008,Diploma,12,4,16
TOTAL (UTs),,2008,Graduate,48,24,72
TOTAL (UTs),,2008,Post Graduate and Above,13,4,17
TOTAL (UTs),,2009,No Education,157,124,281
TOTAL (UTs),,2009,Primary,179,100,279
TOTAL (UTs),,2009,Middle,503,263,766
TOTAL (UTs),,2009,Matriculate/Secondary,386,215,601
TOTAL (UTs),,2009,Hr. Secondary/Intermediate/Pre-University,126,104,230
TOTAL (UTs),,2009,Diploma,14,3,17
TOTAL (UTs),,2009,Graduate,51,33,84
TOTAL (UTs),,2009,Post Graduate and Above,18,5,23
TOTAL (UTs),,2010,No Education,180,114,294
TOTAL (UTs),,2010,Primary,212,146,358
TOTAL (UTs),,2010,Middle,285,190,475
TOTAL (UTs),,2010,Matriculate/Secondary,535,258,793
TOTAL (UTs),,2010,Hr. Secondary/Intermediate/Pre-University,181,116,297
TOTAL (UTs),,2010,Diploma,22,11,33
TOTAL (UTs),,2010,Graduate,57,41,98
TOTAL (UTs),,2010,Post Graduate and Above,21,4,25
TOTAL (UTs),,2011,No Education,142,91,233
TOTAL (UTs),,2011,Primary,256,121,377
TOTAL (UTs),,2011,Middle,414,178,592
TOTAL (UTs),,2011,Matriculate/Secondary,597,258,855
TOTAL (UTs),,2011,Hr. Secondary/Intermediate/Pre-University,261,149,410
TOTAL (UTs),,2011,Diploma,24,8,32
TOTAL (UTs),,2011,Graduate,72,28,100
TOTAL (UTs),,2011,Post Graduate and Above,8,3,11
TOTAL (UTs),,2012,No Education,200,100,300
TOTAL (UTs),,2012,Primary,222,124,346
TOTAL (UTs),,2012,Middle,478,234,712
TOTAL (UTs),,2012,Matriculate/Secondary,551,298,849
TOTAL (UTs),,2012,Hr. Secondary/Intermediate/Pre-University,270,125,395
TOTAL (UTs),,2012,Diploma,16,7,23
TOTAL (UTs),,2012,Graduate,90,43,133
TOTAL (UTs),,2012,Post Graduate and Above,13,7,20
TOTAL (UTs),,2013,No Education,216,97,313
TOTAL (UTs),,2013,Primary,269,123,392
TOTAL (UTs),,2013,Middle,507,176,683
TOTAL (UTs),,2013,Matriculate/Secondary,560,245,805
TOTAL (UTs),,2013,Hr. Secondary/Intermediate/Pre-University,384,205,589
TOTAL (UTs),,2013,Diploma,20,8,28
TOTAL (UTs),,2013,Graduate,96,47,143
TOTAL (UTs),,2013,Post Graduate and Above,12,4,16
TOTAL (UTs),,2014,No Education,217,138,355
TOTAL (UTs),,2014,Primary,364,173,537
TOTAL (UTs),,2014,Middle,346,114,460
TOTAL (UTs),,2014,Matriculate/Secondary,431,173,604
TOTAL (UTs),,2014,Hr. Secondary/Intermediate/Pre-University,270,107,377
TOTAL (UTs),,2014,Diploma,27,15,42
TOTAL (UTs),,2014,Graduate,94,27,121
TOTAL (UTs),,2014,Post Graduate and Above,12,3,15
TRIPURA,33,2001,No Education,95,74,169
TRIPURA,33,2001,Primary,231,213,444
TRIPURA,33,2001,Middle,111,88,199
TRIPURA,33,2001,Matriculate/Secondary,15,13,28
TRIPURA,33,2001,Hr. Secondary/Intermediate/Pre-University,8,3,11
TRIPURA,33,2001,Diploma,0,0,0
TRIPURA,33,2001,Graduate,0,0,0
TRIPURA,33,2001,Post Graduate and Above,3,0,3
TRIPURA,33,2002,No Education,126,110,236
TRIPURA,33,2002,Primary,168,93,261
TRIPURA,33,2002,Middle,136,64,200
TRIPURA,33,2002,Matriculate/Secondary,40,8,48
TRIPURA,33,2002,Hr. Secondary/Intermediate/Pre-University,17,7,24
TRIPURA,33,2002,Diploma,2,2,4
TRIPURA,33,2002,Graduate,4,1,5
TRIPURA,33,2002,Post Graduate and Above,0,1,1
TRIPURA,33,2003,No Education,124,89,213
TRIPURA,33,2003,Primary,113,86,199
TRIPURA,33,2003,Middle,64,43,107
TRIPURA,33,2003,Matriculate/Secondary,137,87,224
TRIPURA,33,2003,Hr. Secondary/Intermediate/Pre-University,38,41,79
TRIPURA,33,2003,Diploma,2,2,4
TRIPURA,33,2003,Graduate,10,8,18
TRIPURA,33,2003,Post Graduate and Above,0,0,0
TRIPURA,33,2004,No Education,46,52,98
TRIPURA,33,2004,Primary,138,107,245
TRIPURA,33,2004,Middle,132,99,231
TRIPURA,33,2004,Matriculate/Secondary,63,57,120
TRIPURA,33,2004,Hr. Secondary/Intermediate/Pre-University,35,15,50
TRIPURA,33,2004,Diploma,5,3,8
TRIPURA,33,2004,Graduate,5,3,8
TRIPURA,33,2004,Post Graduate and Above,9,1,10
TRIPURA,33,2005,No Education,79,59,138
TRIPURA,33,2005,Primary,108,111,219
TRIPURA,33,2005,Middle,128,95,223
TRIPURA,33,2005,Matriculate/Secondary,60,34,94
TRIPURA,33,2005,Hr. Secondary/Intermediate/Pre-University,15,10,25
TRIPURA,33,2005,Diploma,5,1,6
TRIPURA,33,2005,Graduate,6,3,9
TRIPURA,33,2005,Post Graduate and Above,0,1,1
TRIPURA,33,2006,No Education,95,79,174
TRIPURA,33,2006,Primary,125,97,222
TRIPURA,33,2006,Middle,98,97,195
TRIPURA,33,2006,Matriculate/Secondary,91,48,139
TRIPURA,33,2006,Hr. Secondary/Intermediate/Pre-University,17,16,33
TRIPURA,33,2006,Diploma,1,0,1
TRIPURA,33,2006,Graduate,1,0,1
TRIPURA,33,2006,Post Graduate and Above,0,0,0
TRIPURA,33,2007,No Education,88,63,151
TRIPURA,33,2007,Primary,102,91,193
TRIPURA,33,2007,Middle,103,86,189
TRIPURA,33,2007,Matriculate/Secondary,87,39,126
TRIPURA,33,2007,Hr. Secondary/Intermediate/Pre-University,38,7,45
TRIPURA,33,2007,Diploma,1,0,1
TRIPURA,33,2007,Graduate,0,0,0
TRIPURA,33,2007,Post Graduate and Above,0,0,0
TRIPURA,33,2008,No Education,24,19,43
TRIPURA,33,2008,Primary,125,66,191
TRIPURA,33,2008,Middle,184,116,300
TRIPURA,33,2008,Matriculate/Secondary,80,62,142
TRIPURA,33,2008,Hr. Secondary/Intermediate/Pre-University,28,24,52
TRIPURA,33,2008,Diploma,0,0,0
TRIPURA,33,2008,Graduate,0,23,23
TRIPURA,33,2008,Post Graduate and Above,1,0,1
TRIPURA,33,2009,No Education,9,13,22
TRIPURA,33,2009,Primary,73,76,149
TRIPURA,33,2009,Middle,261,113,374
TRIPURA,33,2009,Matriculate/Secondary,97,65,162
TRIPURA,33,2009,Hr. Secondary/Intermediate/Pre-University,20,4,24
TRIPURA,33,2009,Diploma,0,0,0
TRIPURA,33,2009,Graduate,7,0,7
TRIPURA,33,2009,Post Graduate and Above,0,0,0
TRIPURA,33,2010,No Education,13,19,32
TRIPURA,33,2010,Primary,87,89,176
TRIPURA,33,2010,Middle,259,111,370
TRIPURA,33,2010,Matriculate/Secondary,68,55,123
TRIPURA,33,2010,Hr. Secondary/Intermediate/Pre-University,7,2,9
TRIPURA,33,2010,Diploma,0,0,0
TRIPURA,33,2010,Graduate,7,8,15
TRIPURA,33,2010,Post Graduate and Above,0,0,0
TRIPURA,33,2011,No Education,6,5,11
TRIPURA,33,2011,Primary,105,58,163
TRIPURA,33,2011,Middle,268,138,406
TRIPURA,33,2011,Matriculate/Secondary,47,35,82
TRIPURA,33,2011,Hr. Secondary/Intermediate/Pre-University,20,20,40
TRIPURA,33,2011,Diploma,0,0,0
TRIPURA,33,2011,Graduate,1,0,1
TRIPURA,33,2011,Post Graduate and Above,0,0,0
TRIPURA,33,2012,No Education,9,6,15
TRIPURA,33,2012,Primary,172,83,255
TRIPURA,33,2012,Middle,277,125,402
TRIPURA,33,2012,Matriculate/Secondary,81,49,130
TRIPURA,33,2012,Hr. Secondary/Intermediate/Pre-University,20,21,41
TRIPURA,33,2012,Diploma,1,0,1
TRIPURA,33,2012,Graduate,0,0,0
TRIPURA,33,2012,Post Graduate and Above,0,0,0
TRIPURA,33,2014,No Education,13,18,31
TRIPURA,33,2014,Primary,173,94,267
TRIPURA,33,2014,Middle,176,92,268
TRIPURA,33,2014,Matriculate/Secondary,77,33,110
TRIPURA,33,2014,Hr. Secondary/Intermediate/Pre-University,22,13,35
TRIPURA,33,2014,Diploma,2,5,7
TRIPURA,33,2014,Graduate,9,6,15
TRIPURA,33,2014,Post Graduate and Above,2,1,3
UTTAR PRADESH,34,2001,No Education,359,347,706
UTTAR PRADESH,34,2001,Primary,310,450,760
UTTAR PRADESH,34,2001,Middle,380,449,829
UTTAR PRADESH,34,2001,Matriculate/Secondary,393,280,673
UTTAR PRADESH,34,2001,Hr. Secondary/Intermediate/Pre-University,259,144,403
UTTAR PRADESH,34,2001,Diploma,12,4,16
UTTAR PRADESH,34,2001,Graduate,75,38,113
UTTAR PRADESH,34,2001,Post Graduate and Above,13,3,16
UTTAR PRADESH,34,2002,No Education,543,581,1124
UTTAR PRADESH,34,2002,Primary,475,475,950
UTTAR PRADESH,34,2002,Middle,431,387,818
UTTAR PRADESH,34,2002,Matriculate/Secondary,533,272,805
UTTAR PRADESH,34,2002,Hr. Secondary/Intermediate/Pre-University,241,163,404
UTTAR PRADESH,34,2002,Diploma,24,4,28
UTTAR PRADESH,34,2002,Graduate,60,41,101
UTTAR PRADESH,34,2002,Post Graduate and Above,19,1,20
UTTAR PRADESH,34,2003,No Education,458,578,1036
UTTAR PRADESH,34,2003,Primary,359,328,687
UTTAR PRADESH,34,2003,Middle,364,306,670
UTTAR PRADESH,34,2003,Matriculate/Secondary,360,260,620
UTTAR PRADESH,34,2003,Hr. Secondary/Intermediate/Pre-University,325,148,473
UTTAR PRADESH,34,2003,Diploma,25,16,41
UTTAR PRADESH,34,2003,Graduate,80,36,116
UTTAR PRADESH,34,2003,Post Graduate and Above,16,4,20
UTTAR PRADESH,34,2004,No Education,374,404,778
UTTAR PRADESH,34,2004,Primary,410,354,764
UTTAR PRADESH,34,2004,Middle,297,351,648
UTTAR PRADESH,34,2004,Matriculate/Secondary,479,275,754
UTTAR PRADESH,34,2004,Hr. Secondary/Intermediate/Pre-University,281,222,503
UTTAR PRADESH,34,2004,Diploma,35,31,66
UTTAR PRADESH,34,2004,Graduate,61,37,98
UTTAR PRADESH,34,2004,Post Graduate and Above,17,9,26
UTTAR PRADESH,34,2005,No Education,384,515,899
UTTAR PRADESH,34,2005,Primary,412,517,929
UTTAR PRADESH,34,2005,Middle,312,256,568
UTTAR PRADESH,34,2005,Matriculate/Secondary,403,189,592
UTTAR PRADESH,34,2005,Hr. Secondary/Intermediate/Pre-University,180,158,338
UTTAR PRADESH,34,2005,Diploma,22,8,30
UTTAR PRADESH,34,2005,Graduate,48,26,74
UTTAR PRADESH,34,2005,Post Graduate and Above,11,8,19
UTTAR PRADESH,34,2006,No Education,418,409,827
UTTAR PRADESH,34,2006,Primary,331,282,613
UTTAR PRADESH,34,2006,Middle,432,234,666
UTTAR PRADESH,34,2006,Matriculate/Secondary,255,221,476
UTTAR PRADESH,34,2006,Hr. Secondary/Intermediate/Pre-University,199,131,330
UTTAR PRADESH,34,2006,Diploma,52,18,70
UTTAR PRADESH,34,2006,Graduate,49,33,82
UTTAR PRADESH,34,2006,Post Graduate and Above,25,10,35
UTTAR PRADESH,34,2007,No Education,405,592,997
UTTAR PRADESH,34,2007,Primary,408,364,772
UTTAR PRADESH,34,2007,Middle,435,340,775
UTTAR PRADESH,34,2007,Matriculate/Secondary,372,310,682
UTTAR PRADESH,34,2007,Hr. Secondary/Intermediate/Pre-University,320,194,514
UTTAR PRADESH,34,2007,Diploma,50,20,70
UTTAR PRADESH,34,2007,Graduate,45,44,89
UTTAR PRADESH,34,2007,Post Graduate and Above,19,9,28
UTTAR PRADESH,34,2008,No Education,530,600,1130
UTTAR PRADESH,34,2008,Primary,363,480,843
UTTAR PRADESH,34,2008,Middle,455,316,771
UTTAR PRADESH,34,2008,Matriculate/Secondary,425,250,675
UTTAR PRADESH,34,2008,Hr. Secondary/Intermediate/Pre-University,276,193,469
UTTAR PRADESH,34,2008,Diploma,36,17,53
UTTAR PRADESH,34,2008,Graduate,69,32,101
UTTAR PRADESH,34,2008,Post Graduate and Above,25,21,46
UTTAR PRADESH,34,2009,No Education,479,499,978
UTTAR PRADESH,34,2009,Primary,436,339,775
UTTAR PRADESH,34,2009,Middle,439,385,824
UTTAR PRADESH,34,2009,Matriculate/Secondary,385,350,735
UTTAR PRADESH,34,2009,Hr. Secondary/Intermediate/Pre-University,359,227,586
UTTAR PRADESH,34,2009,Diploma,36,30,66
UTTAR PRADESH,34,2009,Graduate,81,74,155
UTTAR PRADESH,34,2009,Post Graduate and Above,24,15,39
UTTAR PRADESH,34,2010,No Education,402,482,884
UTTAR PRADESH,34,2010,Primary,303,351,654
UTTAR PRADESH,34,2010,Middle,299,303,602
UTTAR PRADESH,34,2010,Matriculate/Secondary,330,361,691
UTTAR PRADESH,34,2010,Hr. Secondary/Intermediate/Pre-University,312,252,564
UTTAR PRADESH,34,2010,Diploma,35,13,48
UTTAR PRADESH,34,2010,Graduate,84,66,150
UTTAR PRADESH,34,2010,Post Graduate and Above,22,13,35
UTTAR PRADESH,34,2011,No Education,654,473,1127
UTTAR PRADESH,34,2011,Primary,455,389,844
UTTAR PRADESH,34,2011,Middle,535,426,961
UTTAR PRADESH,34,2011,Matriculate/Secondary,586,443,1029
UTTAR PRADESH,34,2011,Hr. Secondary/Intermediate/Pre-University,327,331,658
UTTAR PRADESH,34,2011,Diploma,38,14,52
UTTAR PRADESH,34,2011,Graduate,95,38,133
UTTAR PRADESH,34,2011,Post Graduate and Above,23,16,39
UTTAR PRADESH,34,2012,No Education,394,368,762
UTTAR PRADESH,34,2012,Primary,408,338,746
UTTAR PRADESH,34,2012,Middle,477,333,810
UTTAR PRADESH,34,2012,Matriculate/Secondary,504,381,885
UTTAR PRADESH,34,2012,Hr. Secondary/Intermediate/Pre-University,469,288,757
UTTAR PRADESH,34,2012,Diploma,51,50,101
UTTAR PRADESH,34,2012,Graduate,156,145,301
UTTAR PRADESH,34,2012,Post Graduate and Above,36,24,60
UTTAR PRADESH,34,2013,No Education,653,477,1130
UTTAR PRADESH,34,2013,Primary,597,397,994
UTTAR PRADESH,34,2013,Middle,526,453,979
UTTAR PRADESH,34,2013,Matriculate/Secondary,609,445,1054
UTTAR PRADESH,34,2013,Hr. Secondary/Intermediate/Pre-University,504,235,739
UTTAR PRADESH,34,2013,Diploma,52,25,77
UTTAR PRADESH,34,2013,Graduate,182,80,262
UTTAR PRADESH,34,2013,Post Graduate and Above,40,11,51
UTTAR PRADESH,34,2014,No Education,354,310,664
UTTAR PRADESH,34,2014,Primary,277,215,492
UTTAR PRADESH,34,2014,Middle,351,266,617
UTTAR PRADESH,34,2014,Matriculate/Secondary,299,228,527
UTTAR PRADESH,34,2014,Hr. Secondary/Intermediate/Pre-University,302,159,461
UTTAR PRADESH,34,2014,Diploma,16,3,19
UTTAR PRADESH,34,2014,Graduate,80,44,124
UTTAR PRADESH,34,2014,Post Graduate and Above,5,0,5
UTTARAKHAND,35,2001,No Education,18,18,36
UTTARAKHAND,35,2001,Primary,25,33,58
UTTARAKHAND,35,2001,Middle,44,26,70
UTTARAKHAND,35,2001,Matriculate/Secondary,60,44,104
UTTARAKHAND,35,2001,Hr. Secondary/Intermediate/Pre-University,19,7,26
UTTARAKHAND,35,2001,Diploma,6,0,6
UTTARAKHAND,35,2001,Graduate,8,1,9
UTTARAKHAND,35,2001,Post Graduate and Above,2,0,2
UTTARAKHAND,35,2002,No Education,33,38,71
UTTARAKHAND,35,2002,Primary,48,26,74
UTTARAKHAND,35,2002,Middle,43,30,73
UTTARAKHAND,35,2002,Matriculate/Secondary,36,22,58
UTTARAKHAND,35,2002,Hr. Secondary/Intermediate/Pre-University,30,35,65
UTTARAKHAND,35,2002,Diploma,2,1,3
UTTARAKHAND,35,2002,Graduate,13,4,17
UTTARAKHAND,35,2002,Post Graduate and Above,0,0,0
UTTARAKHAND,35,2003,No Education,23,22,45
UTTARAKHAND,35,2003,Primary,84,41,125
UTTARAKHAND,35,2003,Middle,49,23,72
UTTARAKHAND,35,2003,Matriculate/Secondary,53,21,74
UTTARAKHAND,35,2003,Hr. Secondary/Intermediate/Pre-University,45,19,64
UTTARAKHAND,35,2003,Diploma,0,0,0
UTTARAKHAND,35,2003,Graduate,5,3,8
UTTARAKHAND,35,2003,Post Graduate and Above,3,0,3
UTTARAKHAND,35,2004,No Education,29,13,42
UTTARAKHAND,35,2004,Primary,25,20,45
UTTARAKHAND,35,2004,Middle,28,18,46
UTTARAKHAND,35,2004,Matriculate/Secondary,25,22,47
UTTARAKHAND,35,2004,Hr. Secondary/Intermediate/Pre-University,29,8,37
UTTARAKHAND,35,2004,Diploma,2,0,2
UTTARAKHAND,35,2004,Graduate,8,6,14
UTTARAKHAND,35,2004,Post Graduate and Above,2,2,4
UTTARAKHAND,35,2005,No Education,17,17,34
UTTARAKHAND,35,2005,Primary,34,20,54
UTTARAKHAND,35,2005,Middle,42,20,62
UTTARAKHAND,35,2005,Matriculate/Secondary,41,17,58
UTTARAKHAND,35,2005,Hr. Secondary/Intermediate/Pre-University,33,15,48
UTTARAKHAND,35,2005,Diploma,0,0,0
UTTARAKHAND,35,2005,Graduate,12,3,15
UTTARAKHAND,35,2005,Post Graduate and Above,1,1,2
UTTARAKHAND,35,2006,No Education,38,31,69
UTTARAKHAND,35,2006,Primary,25,29,54
UTTARAKHAND,35,2006,Middle,33,32,65
UTTARAKHAND,35,2006,Matriculate/Secondary,42,28,70
UTTARAKHAND,35,2006,Hr. Secondary/Intermediate/Pre-University,23,23,46
UTTARAKHAND,35,2006,Diploma,4,3,7
UTTARAKHAND,35,2006,Graduate,5,6,11
UTTARAKHAND,35,2006,Post Graduate and Above,3,1,4
UTTARAKHAND,35,2007,No Education,20,24,44
UTTARAKHAND,35,2007,Primary,17,31,48
UTTARAKHAND,35,2007,Middle,29,22,51
UTTARAKHAND,35,2007,Matriculate/Secondary,36,25,61
UTTARAKHAND,35,2007,Hr. Secondary/Intermediate/Pre-University,18,9,27
UTTARAKHAND,35,2007,Diploma,3,0,3
UTTARAKHAND,35,2007,Graduate,6,5,11
UTTARAKHAND,35,2007,Post Graduate and Above,1,2,3
UTTARAKHAND,35,2008,No Education,23,14,37
UTTARAKHAND,35,2008,Primary,23,23,46
UTTARAKHAND,35,2008,Middle,23,13,36
UTTARAKHAND,35,2008,Matriculate/Secondary,17,20,37
UTTARAKHAND,35,2008,Hr. Secondary/Intermediate/Pre-University,9,9,18
UTTARAKHAND,35,2008,Diploma,1,3,4
UTTARAKHAND,35,2008,Graduate,7,3,10
UTTARAKHAND,35,2008,Post Graduate and Above,1,2,3
UTTARAKHAND,35,2009,No Education,34,32,66
UTTARAKHAND,35,2009,Primary,45,28,73
UTTARAKHAND,35,2009,Middle,36,27,63
UTTARAKHAND,35,2009,Matriculate/Secondary,53,20,73
UTTARAKHAND,35,2009,Hr. Secondary/Intermediate/Pre-University,23,28,51
UTTARAKHAND,35,2009,Diploma,2,0,2
UTTARAKHAND,35,2009,Graduate,9,5,14
UTTARAKHAND,35,2009,Post Graduate and Above,0,0,0
UTTARAKHAND,35,2010,No Education,16,16,32
UTTARAKHAND,35,2010,Primary,33,25,58
UTTARAKHAND,35,2010,Middle,31,22,53
UTTARAKHAND,35,2010,Matriculate/Secondary,47,34,81
UTTARAKHAND,35,2010,Hr. Secondary/Intermediate/Pre-University,21,10,31
UTTARAKHAND,35,2010,Diploma,4,4,8
UTTARAKHAND,35,2010,Graduate,9,3,12
UTTARAKHAND,35,2010,Post Graduate and Above,3,3,6
UTTARAKHAND,35,2011,No Education,17,12,29
UTTARAKHAND,35,2011,Primary,31,29,60
UTTARAKHAND,35,2011,Middle,26,25,51
UTTARAKHAND,35,2011,Matriculate/Secondary,60,28,88
UTTARAKHAND,35,2011,Hr. Secondary/Intermediate/Pre-University,39,16,55
UTTARAKHAND,35,2011,Diploma,3,3,6
UTTARAKHAND,35,2011,Graduate,12,10,22
UTTARAKHAND,35,2011,Post Graduate and Above,4,2,6
UTTARAKHAND,35,2012,No Education,24,14,38
UTTARAKHAND,35,2012,Primary,28,27,55
UTTARAKHAND,35,2012,Middle,43,30,73
UTTARAKHAND,35,2012,Matriculate/Secondary,74,57,131
UTTARAKHAND,35,2012,Hr. Secondary/Intermediate/Pre-University,59,36,95
UTTARAKHAND,35,2012,Diploma,1,2,3
UTTARAKHAND,35,2012,Graduate,20,7,27
UTTARAKHAND,35,2012,Post Graduate and Above,0,2,2
UTTARAKHAND,35,2013,No Education,34,13,47
UTTARAKHAND,35,2013,Primary,38,25,63
UTTARAKHAND,35,2013,Middle,40,32,72
UTTARAKHAND,35,2013,Matriculate/Secondary,53,26,79
UTTARAKHAND,35,2013,Hr. Secondary/Intermediate/Pre-University,55,22,77
UTTARAKHAND,35,2013,Diploma,3,1,4
UTTARAKHAND,35,2013,Graduate,18,2,20
UTTARAKHAND,35,2013,Post Graduate and Above,3,0,3
UTTARAKHAND,35,2014,No Education,13,5,18
UTTARAKHAND,35,2014,Primary,3,5,8
UTTARAKHAND,35,2014,Middle,12,7,19
UTTARAKHAND,35,2014,Matriculate/Secondary,28,7,35
UTTARAKHAND,35,2014,Hr. Secondary/Intermediate/Pre-University,29,16,45
UTTARAKHAND,35,2014,Diploma,0,0,0
UTTARAKHAND,35,2014,Graduate,1,0,1
UTTARAKHAND,35,2014,Post Graduate and Above,0,0,0
WEST BENGAL,36,2001,No Education,1925,1989,3914
WEST BENGAL,36,2001,Primary,2076,1740,3816
WEST BENGAL,36,2001,Middle,1653,1222,2875
WEST BENGAL,36,2001,Matriculate/Secondary,773,562,1335
WEST BENGAL,36,2001,Hr. Secondary/Intermediate/Pre-University,473,392,865
WEST BENGAL,36,2001,Diploma,225,116,341
WEST BENGAL,36,2001,Graduate,274,136,410
WEST BENGAL,36,2001,Post Graduate and Above,96,38,134
WEST BENGAL,36,2002,No Education,1682,1817,3499
WEST BENGAL,36,2002,Primary,1758,1652,3410
WEST BENGAL,36,2002,Middle,1799,1098,2897
WEST BENGAL,36,2002,Matriculate/Secondary,988,742,1730
WEST BENGAL,36,2002,Hr. Secondary/Intermediate/Pre-University,517,395,912
WEST BENGAL,36,2002,Diploma,151,84,235
WEST BENGAL,36,2002,Graduate,180,85,265
WEST BENGAL,36,2002,Post Graduate and Above,49,10,59
WEST BENGAL,36,2003,No Education,946,941,1887
WEST BENGAL,36,2003,Primary,1606,1528,3134
WEST BENGAL,36,2003,Middle,1958,1405,3363
WEST BENGAL,36,2003,Matriculate/Secondary,1512,999,2511
WEST BENGAL,36,2003,Hr. Secondary/Intermediate/Pre-University,995,782,1777
WEST BENGAL,36,2003,Diploma,35,40,75
WEST BENGAL,36,2003,Graduate,353,151,504
WEST BENGAL,36,2003,Post Graduate and Above,19,10,29
WEST BENGAL,36,2004,No Education,1467,1490,2957
WEST BENGAL,36,2004,Primary,2223,1670,3893
WEST BENGAL,36,2004,Middle,1689,1240,2929
WEST BENGAL,36,2004,Matriculate/Secondary,1130,598,1728
WEST BENGAL,36,2004,Hr. Secondary/Intermediate/Pre-University,873,681,1554
WEST BENGAL,36,2004,Diploma,29,14,43
WEST BENGAL,36,2004,Graduate,234,65,299
WEST BENGAL,36,2004,Post Graduate and Above,16,5,21
WEST BENGAL,36,2005,No Education,1365,1538,2903
WEST BENGAL,36,2005,Primary,2485,2122,4607
WEST BENGAL,36,2005,Middle,1988,1300,3288
WEST BENGAL,36,2005,Matriculate/Secondary,1376,743,2119
WEST BENGAL,36,2005,Hr. Secondary/Intermediate/Pre-University,911,539,1450
WEST BENGAL,36,2005,Diploma,209,57,266
WEST BENGAL,36,2005,Graduate,267,98,365
WEST BENGAL,36,2005,Post Graduate and Above,13,4,17
WEST BENGAL,36,2006,No Education,648,624,1272
WEST BENGAL,36,2006,Primary,1932,1980,3912
WEST BENGAL,36,2006,Middle,2067,1497,3564
WEST BENGAL,36,2006,Matriculate/Secondary,2238,1394,3632
WEST BENGAL,36,2006,Hr. Secondary/Intermediate/Pre-University,1632,1015,2647
WEST BENGAL,36,2006,Diploma,144,6,150
WEST BENGAL,36,2006,Graduate,420,69,489
WEST BENGAL,36,2006,Post Graduate and Above,39,20,59
WEST BENGAL,36,2007,No Education,1554,1582,3136
WEST BENGAL,36,2007,Primary,2593,2284,4877
WEST BENGAL,36,2007,Middle,2018,1227,3245
WEST BENGAL,36,2007,Matriculate/Secondary,1369,710,2079
WEST BENGAL,36,2007,Hr. Secondary/Intermediate/Pre-University,637,430,1067
WEST BENGAL,36,2007,Diploma,27,12,39
WEST BENGAL,36,2007,Graduate,274,102,376
WEST BENGAL,36,2007,Post Graduate and Above,33,8,41
WEST BENGAL,36,2008,No Education,1150,1263,2413
WEST BENGAL,36,2008,Primary,2830,2291,5121
WEST BENGAL,36,2008,Middle,2277,1577,3854
WEST BENGAL,36,2008,Matriculate/Secondary,1159,778,1937
WEST BENGAL,36,2008,Hr. Secondary/Intermediate/Pre-University,679,441,1120
WEST BENGAL,36,2008,Diploma,31,13,44
WEST BENGAL,36,2008,Graduate,212,107,319
WEST BENGAL,36,2008,Post Graduate and Above,31,13,44
WEST BENGAL,36,2009,No Education,1350,1312,2662
WEST BENGAL,36,2009,Primary,2466,2083,4549
WEST BENGAL,36,2009,Middle,2331,1472,3803
WEST BENGAL,36,2009,Matriculate/Secondary,1371,766,2137
WEST BENGAL,36,2009,Hr. Secondary/Intermediate/Pre-University,657,349,1006
WEST BENGAL,36,2009,Diploma,38,24,62
WEST BENGAL,36,2009,Graduate,258,137,395
WEST BENGAL,36,2009,Post Graduate and Above,23,11,34
WEST BENGAL,36,2010,No Education,1120,999,2119
WEST BENGAL,36,2010,Primary,3945,3040,6985
WEST BENGAL,36,2010,Middle,2218,1349,3567
WEST BENGAL,36,2010,Matriculate/Secondary,1062,805,1867
WEST BENGAL,36,2010,Hr. Secondary/Intermediate/Pre-University,644,382,1026
WEST BENGAL,36,2010,Diploma,70,27,97
WEST BENGAL,36,2010,Graduate,212,115,327
WEST BENGAL,36,2010,Post Graduate and Above,30,19,49
WEST BENGAL,36,2011,No Education,1272,1117,2389
WEST BENGAL,36,2011,Primary,3109,2331,5440
WEST BENGAL,36,2011,Middle,2708,2047,4755
WEST BENGAL,36,2011,Matriculate/Secondary,1532,911,2443
WEST BENGAL,36,2011,Hr. Secondary/Intermediate/Pre-University,763,312,1075
WEST BENGAL,36,2011,Diploma,34,19,53
WEST BENGAL,36,2011,Graduate,181,115,296
WEST BENGAL,36,2011,Post Graduate and Above,25,16,41
WEST BENGAL,36,2012,No Education,1096,1109,2205
WEST BENGAL,36,2012,Primary,2983,2184,5167
WEST BENGAL,36,2012,Middle,2467,1672,4139
WEST BENGAL,36,2012,Matriculate/Secondary,1260,734,1994
WEST BENGAL,36,2012,Hr. Secondary/Intermediate/Pre-University,538,359,897
WEST BENGAL,36,2012,Diploma,26,21,47
WEST BENGAL,36,2012,Graduate,242,171,413
WEST BENGAL,36,2012,Post Graduate and Above,68,27,95
WEST BENGAL,36,2013,No Education,798,674,1472
WEST BENGAL,36,2013,Primary,2478,1732,4210
WEST BENGAL,36,2013,Middle,2523,1550,4073
WEST BENGAL,36,2013,Matriculate/Secondary,1261,706,1967
WEST BENGAL,36,2013,Hr. Secondary/Intermediate/Pre-University,531,361,892
WEST BENGAL,36,2013,Diploma,42,27,69
WEST BENGAL,36,2013,Graduate,212,110,322
WEST BENGAL,36,2013,Post Graduate and Above,15,35,50
WEST BENGAL,36,2014,No Education,549,477,1026
WEST BENGAL,36,2014,Primary,2023,1385,3408
WEST BENGAL,36,2014,Middle,1865,1322,3187
WEST BENGAL,36,2014,Matriculate/Secondary,1807,992,2799
WEST BENGAL,36,2014,Hr. Secondary/Intermediate/Pre-University,845,359,1204
WEST BENGAL,36,2014,Diploma,32,8,40
WEST BENGAL,36,2014,Graduate,228,93,321
WEST BENGAL,36,2014,Post Graduate and Above,6,0,6