STATE.UT,Year,id,CAUSE,Male.upto.14.years,Male.15.29.years,Male.30.44.years,Male.45.59.years,Male.60.years.and.above,Total.Male,Female.upto.14.years,Female.15.29.years,Female.30.44.years,Female.45.59.years,Female.60.years.and.above,Total.Female,Total.upto.14.years,Total.15.29.years,Total.30.44.years,Total.45.59.years,Total.60.years.and.above,Total
A & N ISLANDS,2001,1,House Wife,0,0,0,0,0,0,0,21,9,5,3,38,0,21,9,5,3,38
A & N ISLANDS,2001,1,Service (Government),0,3,10,7,0,20,0,0,0,0,0,0,0,3,10,7,0,20
A & N ISLANDS,2001,1,Service (Private),0,14,7,9,2,32,0,0,0,0,0,0,0,14,7,9,2,32
A & N ISLANDS,2001,1,Public Sector Undertaking,0,2,1,1,0,4,0,0,0,0,0,0,0,2,1,1,0,4
A & N ISLANDS,2001,1,Students,1,2,0,0,0,3,2,9,0,0,0,11,3,11,0,0,0,14
A & N ISLANDS,2001,1,Unemployed,0,0,0,0,0,0,0,0,0,0,0,0,0,0,0,0,0,0
A & N ISLANDS,2001,1,Professional Activity,0,0,0,0,0,0,0,0,0,0,0,0,0,0,0,0,0,0
A & N ISLANDS,2001,1,Agriculture (Total),0,0,0,0,3,3,0,0,0,0,0,0,0,0,0,0,3,3
A & N ISLANDS,2001,1,Retired Persons,0,0,0,0,2,2,0,0,0,0,0,0,0,0,0,0,2,2
A & N ISLANDS,2002,1,House Wife,0,0,0,0,0,0,0,22,13,6,3,44,0,22,13,6,3,44
A & N ISLANDS,2002,1,Service (Government),0,2,8,8,0,18,0,0,1,0,0,1,0,2,9,8,0,19
A & N ISLANDS,2002,1,Service (Private),0,20,16,13,7,56,0,0,0,0,0,0,0,20,16,13,7,56
A & N ISLANDS,2002,1,Public Sector Undertaking,0,0,0,0,0,0,0,0,0,0,0,0,0,0,0,0,0,0
A & N ISLANDS,2002,1,Students,2,3,0,0,0,5,2,6,0,0,0,8,4,9,0,0,0,13
A & N ISLANDS,2002,1,Unemployed,0,0,0,0,0,0,0,0,0,0,0,0,0,0,0,0,0,0
A & N ISLANDS,2002,1,Professional Activity,0,0,0,0,0,0,0,0,0,0,0,0,0,0,0,0,0,0
A & N ISLANDS,2002,1,Agriculture (Total),0,1,3,0,3,7,0,0,0,0,0,0,0,1,3,0,3,7
A & N ISLANDS,2002,1,Retired Persons,0,0,0,0,3,3,0,0,0,0,0,0,0,0,0,0,3,3
A & N ISLANDS,2003,1,House Wife,0,0,0,0,0,0,0,17,8,2,1,28,0,17,8,2,1,28
A & N ISLANDS,2003,1,Service (Government),0,0,7,6,1,14,0,1,0,0,0,1,0,1,7,6,1,15
A & N ISLANDS,2003,1,Service (Private),0,17,13,10,2,42,0,0,0,0,0,0,0,17,13,10,2,42
A & N ISLANDS,2003,1,Public Sector Undertaking,0,1,2,0,0,3,0,0,0,0,0,0,0,1,2,0,0,3
A & N ISLANDS,2003,1,Students,1,1,0,0,0,2,4,4,0,0,0,8,5,5,0,0,0,10
A & N ISLANDS,2003,1,Unemployed,0,3,1,0,2,6,0,6,0,0,0,6,0,9,1,0,2,12
A & N ISLANDS,2003,1,Professional Activity,0,0,0,0,0,0,0,0,0,0,0,0,0,0,0,0,0,0
A & N ISLANDS,2003,1,Agriculture (Total),0,1,0,0,0,1,0,0,0,0,0,0,0,1,0,0,0,1
A & N ISLANDS,2003,1,Retired Persons,0,0,0,1,1,2,0,0,0,0,0,0,0,0,0,1,1,2
A & N ISLANDS,2004,1,House Wife,0,0,0,0,0,0,0,10,11,3,1,25,0,10,11,3,1,25
A & N ISLANDS,2004,1,Service (Government),0,4,7,7,0,18,0,0,2,0,0,2,0,4,9,7,0,20
A & N ISLANDS,2004,1,Service (Private),0,13,13,6,4,36,0,1,0,0,0,1,0,14,13,6,4,37
A & N ISLANDS,2004,1,Public Sector Undertaking,0,0,0,0,0,0,0,0,0,0,0,0,0,0,0,0,0,0
A & N ISLANDS,2004,1,Students,0,8,0,0,0,8,1,7,0,0,0,8,1,15,0,0,0,16
A & N ISLANDS,2004,1,Unemployed,0,0,0,0,0,0,0,1,0,0,0,1,0,1,0,0,0,1
A & N ISLANDS,2004,1,Professional Activity,0,1,0,1,0,2,0,0,0,0,0,0,0,1,0,1,0,2
A & N ISLANDS,2004,1,Agriculture (Total),0,1,0,0,2,3,0,0,0,0,0,0,0,1,0,0,2,3
A & N ISLANDS,2004,1,Retired Persons,0,0,0,0,2,2,0,0,0,0,0,0,0,0,0,0,2,2
A & N ISLANDS,2005,1,House Wife,0,0,0,0,0,0,0,11,7,10,4,32,0,11,7,10,4,32
A & N ISLANDS,2005,1,Service (Government),0,1,5,7,0,13,0,0,0,0,0,0,0,1,5,7,0,13
A & N ISLANDS,2005,1,Service (Private),0,9,12,14,12,47,0,4,0,0,0,4,0,13,12,14,12,51
A & N ISLANDS,2005,1,Public Sector Undertaking,0,0,0,0,0,0,0,0,0,0,0,0,0,0,0,0,0,0
A & N ISLANDS,2005,1,Students,2,3,0,0,0,5,3,4,0,0,0,7,5,7,0,0,0,12
A & N ISLANDS,2005,1,Unemployed,0,1,1,1,0,3,0,8,0,0,1,9,0,9,1,1,1,12
A & N ISLANDS,2005,1,Professional Activity,0,0,0,0,0,0,0,0,0,0,0,0,0,0,0,0,0,0
A & N ISLANDS,2005,1,Agriculture (Total),0,0,2,1,4,7,0,0,1,0,0,1,0,0,3,1,4,8
A & N ISLANDS,2005,1,Retired Persons,0,0,0,0,0,0,0,0,0,0,0,0,0,0,0,0,0,0
A & N ISLANDS,2006,1,House Wife,0,0,0,0,0,0,0,18,10,3,2,33,0,18,10,3,2,33
A & N ISLANDS,2006,1,Service (Government),0,3,4,4,0,11,0,0,0,0,0,0,0,3,4,4,0,11
A & N ISLANDS,2006,1,Service (Private),0,10,28,18,6,62,0,1,0,0,0,1,0,11,28,18,6,63
A & N ISLANDS,2006,1,Public Sector Undertaking,0,0,0,0,0,0,0,0,0,0,0,0,0,0,0,0,0,0
A & N ISLANDS,2006,1,Students,1,0,0,0,0,1,1,2,0,0,0,3,2,2,0,0,0,4
A & N ISLANDS,2006,1,Unemployed,0,2,0,0,0,2,0,0,0,0,0,0,0,2,0,0,0,2
A & N ISLANDS,2006,1,Professional Activity,0,0,0,0,0,0,0,0,0,0,0,0,0,0,0,0,0,0
A & N ISLANDS,2006,1,Agriculture (Total),0,2,2,1,1,6,0,0,0,0,0,0,0,2,2,1,1,6
A & N ISLANDS,2006,1,Retired Persons,0,0,0,0,0,0,0,0,0,0,0,0,0,0,0,0,0,0
A & N ISLANDS,2007,1,House Wife,0,0,0,0,0,0,0,10,10,8,2,30,0,10,10,8,2,30
A & N ISLANDS,2007,1,Service (Government),0,1,4,4,0,9,0,1,0,0,0,1,0,2,4,4,0,10
A & N ISLANDS,2007,1,Service (Private),0,17,12,8,2,39,0,1,0,0,0,1,0,18,12,8,2,40
A & N ISLANDS,2007,1,Public Sector Undertaking,0,0,0,0,0,0,0,0,0,0,0,0,0,0,0,0,0,0
A & N ISLANDS,2007,1,Students,0,4,0,0,0,4,4,9,0,0,0,13,4,13,0,0,0,17
A & N ISLANDS,2007,1,Unemployed,0,9,1,1,1,12,0,0,0,0,0,0,0,9,1,1,1,12
A & N ISLANDS,2007,1,Professional Activity,0,0,0,0,0,0,0,0,0,0,0,0,0,0,0,0,0,0
A & N ISLANDS,2007,1,Agriculture (Total),0,4,3,5,4,16,0,0,0,0,0,0,0,4,3,5,4,16
A & N ISLANDS,2007,1,Retired Persons,0,0,0,1,2,3,0,0,0,0,0,0,0,0,0,1,2,3
A & N ISLANDS,2008,1,House Wife,0,0,0,0,0,0,0,10,13,5,4,32,0,10,13,5,4,32
A & N ISLANDS,2008,1,Service (Government),0,2,2,3,0,7,0,0,0,0,0,0,0,2,2,3,0,7
A & N ISLANDS,2008,1,Service (Private),0,17,15,8,3,43,0,1,0,0,0,1,0,18,15,8,3,44
A & N ISLANDS,2008,1,Public Sector Undertaking,0,0,0,0,0,0,0,0,0,0,0,0,0,0,0,0,0,0
A & N ISLANDS,2008,1,Students,0,4,0,0,0,4,0,7,0,0,0,7,0,11,0,0,0,11
A & N ISLANDS,2008,1,Unemployed,0,2,1,0,2,5,0,0,0,0,0,0,0,2,1,0,2,5
A & N ISLANDS,2008,1,Professional Activity,0,0,0,0,0,0,0,0,0,0,0,0,0,0,0,0,0,0
A & N ISLANDS,2008,1,Agriculture (Total),0,5,8,6,4,23,0,0,0,0,0,0,0,5,8,6,4,23
A & N ISLANDS,2008,1,Retired Persons,0,0,0,1,3,4,0,0,0,0,0,0,0,0,0,1,3,4
A & N ISLANDS,2009,1,House Wife,0,0,0,0,0,0,0,14,10,4,1,29,0,14,10,4,1,29
A & N ISLANDS,2009,1,Service (Government),0,0,3,9,1,13,0,0,1,0,0,1,0,0,4,9,1,14
A & N ISLANDS,2009,1,Service (Private),0,20,10,10,2,42,0,0,2,0,0,2,0,20,12,10,2,44
A & N ISLANDS,2009,1,Public Sector Undertaking,0,0,0,0,0,0,0,0,0,0,0,0,0,0,0,0,0,0
A & N ISLANDS,2009,1,Students,1,2,0,0,0,3,7,3,0,0,0,10,8,5,0,0,0,13
A & N ISLANDS,2009,1,Unemployed,0,0,0,0,0,0,0,0,0,0,0,0,0,0,0,0,0,0
A & N ISLANDS,2009,1,Professional Activity,0,0,0,0,0,0,0,0,0,0,0,0,0,0,0,0,0,0
A & N ISLANDS,2009,1,Agriculture (Total),0,5,7,5,2,19,0,0,0,0,0,0,0,5,7,5,2,19
A & N ISLANDS,2009,1,Retired Persons,0,0,0,0,1,1,0,0,0,0,0,0,0,0,0,0,1,1
A & N ISLANDS,2010,1,House Wife,0,0,0,0,0,0,0,15,11,2,3,31,0,15,11,2,3,31
A & N ISLANDS,2010,1,Service (Government),0,3,8,7,0,18,0,1,0,0,0,1,0,4,8,7,0,19
A & N ISLANDS,2010,1,Service (Private),0,16,19,10,3,48,0,2,0,0,0,2,0,18,19,10,3,50
A & N ISLANDS,2010,1,Public Sector Undertaking,0,0,0,0,0,0,0,0,0,0,0,0,0,0,0,0,0,0
A & N ISLANDS,2010,1,Students,4,4,0,0,0,8,0,6,0,0,0,6,4,10,0,0,0,14
A & N ISLANDS,2010,1,Unemployed,0,13,0,0,0,13,0,4,0,0,0,4,0,17,0,0,0,17
A & N ISLANDS,2010,1,Professional Activity,0,0,0,0,0,0,0,0,0,0,0,0,0,0,0,0,0,0
A & N ISLANDS,2010,1,Agriculture (Total),0,1,2,0,5,8,0,0,0,0,0,0,0,1,2,0,5,8
A & N ISLANDS,2010,1,Retired Persons,0,0,0,0,8,8,0,0,0,0,0,0,0,0,0,0,8,8
A & N ISLANDS,2011,1,House Wife,0,0,0,0,0,0,0,3,4,2,1,10,0,3,4,2,1,10
A & N ISLANDS,2011,1,Service (Government),0,7,6,4,1,18,0,2,1,1,0,4,0,9,7,5,1,22
A & N ISLANDS,2011,1,Service (Private),0,7,17,8,1,33,0,4,4,1,1,10,0,11,21,9,2,43
A & N ISLANDS,2011,1,Public Sector Undertaking,0,0,0,0,0,0,0,0,0,0,0,0,0,0,0,0,0,0
A & N ISLANDS,2011,1,Students,1,9,0,0,0,10,4,8,0,1,0,13,5,17,0,1,0,23
A & N ISLANDS,2011,1,Unemployed,0,3,5,2,0,10,0,0,0,1,0,1,0,3,5,3,0,11
A & N ISLANDS,2011,1,Professional Activity,0,0,0,0,0,0,0,0,0,0,0,0,0,0,0,0,0,0
A & N ISLANDS,2011,1,Agriculture (Total),0,0,0,0,0,0,0,0,0,0,0,0,0,0,0,0,0,0
A & N ISLANDS,2011,1,Retired Persons,0,0,0,0,5,5,0,0,1,0,0,1,0,0,1,0,5,6
A & N ISLANDS,2012,1,House Wife,0,0,0,0,0,0,0,11,11,2,4,28,0,11,11,2,4,28
A & N ISLANDS,2012,1,Service (Government),0,1,5,11,1,18,0,1,1,1,0,3,0,2,6,12,1,21
A & N ISLANDS,2012,1,Service (Private),0,12,21,9,7,49,0,1,0,0,0,1,0,13,21,9,7,50
A & N ISLANDS,2012,1,Public Sector Undertaking,0,0,0,0,0,0,0,0,0,0,0,0,0,0,0,0,0,0
A & N ISLANDS,2012,1,Students,2,2,0,0,0,4,1,4,0,0,0,5,3,6,0,0,0,9
A & N ISLANDS,2012,1,Unemployed,0,4,0,0,0,4,0,1,0,0,0,1,0,5,0,0,0,5
A & N ISLANDS,2012,1,Professional Activity,0,0,0,0,0,0,0,0,0,0,0,0,0,0,0,0,0,0
A & N ISLANDS,2012,1,Agriculture (Total),0,0,0,0,0,0,0,0,0,0,0,0,0,0,0,0,0,0
A & N ISLANDS,2012,1,Retired Persons,0,0,0,0,1,1,0,0,0,0,0,0,0,0,0,0,1,1
A & N ISLANDS,2013,1,House Wife,0,0,0,0,0,0,0,10,7,3,1,21,0,10,7,3,1,21
A & N ISLANDS,2013,1,Service (Government),0,2,8,9,0,19,0,0,1,1,0,2,0,2,9,10,0,21
A & N ISLANDS,2013,1,Service (Private),0,25,18,16,5,64,0,0,1,0,0,1,0,25,19,16,5,65
A & N ISLANDS,2013,1,Public Sector Undertaking,0,0,0,0,1,1,0,0,0,0,0,0,0,0,0,0,1,1
A & N ISLANDS,2013,1,Students,4,8,0,0,0,12,2,8,0,0,0,10,6,16,0,0,0,22
A & N ISLANDS,2013,1,Unemployed,0,0,2,0,1,3,0,4,2,0,0,6,0,4,4,0,1,9
A & N ISLANDS,2013,1,Professional Activity,0,0,0,0,0,0,0,0,0,0,0,0,0,0,0,0,0,0
A & N ISLANDS,2013,1,Agriculture (Total),0,0,0,1,4,5,0,0,0,0,0,0,0,0,0,1,4,5
A & N ISLANDS,2013,1,Retired Persons,0,0,0,0,4,4,0,0,0,0,0,0,0,0,0,0,4,4
A & N ISLANDS,2014,1,House Wife,0,0,0,0,0,0,0,7,1,2,4,14,0,7,1,2,4,14
A & N ISLANDS,2014,1,Service (Government),0,1,3,5,0,9,0,0,0,0,0,0,0,1,3,5,0,9
A & N ISLANDS,2014,1,Service (Private),0,27,25,19,7,78,0,2,2,0,0,4,0,29,27,19,7,82
A & N ISLANDS,2014,1,Public Sector Undertaking,0,0,0,0,0,0,0,1,0,0,0,1,0,1,0,0,0,1
A & N ISLANDS,2014,1,Students,0,4,0,0,0,4,2,11,0,0,0,13,2,15,0,0,0,17
A & N ISLANDS,2014,1,Unemployed,1,1,3,0,3,8,0,2,1,0,1,4,1,3,4,0,4,12
A & N ISLANDS,2014,1,Agriculture (Total),0,1,3,0,3,7,0,1,0,0,0,1,0,2,3,0,3,8
A & N ISLANDS,2014,1,Retired Persons,0,0,0,0,3,3,0,0,0,0,0,0,0,0,0,0,3,3
ANDHRA PRADESH,2001,2,House Wife,0,0,0,0,0,0,0,1132,811,397,104,2444,0,1132,811,397,104,2444
ANDHRA PRADESH,2001,2,Service (Government),0,34,57,44,0,135,0,23,22,9,7,61,0,57,79,53,7,196
ANDHRA PRADESH,2001,2,Service (Private),1,250,275,138,10,674,5,43,24,28,6,106,6,293,299,166,16,780
ANDHRA PRADESH,2001,2,Public Sector Undertaking,0,32,36,29,13,110,0,4,5,1,0,10,0,36,41,30,13,120
ANDHRA PRADESH,2001,2,Students,56,202,19,18,0,295,46,115,5,9,0,175,102,317,24,27,0,470
ANDHRA PRADESH,2001,2,Unemployed,1,230,206,94,12,543,1,57,12,8,0,78,2,287,218,102,12,621
ANDHRA PRADESH,2001,2,Professional Activity,13,118,157,80,22,390,5,22,4,10,0,41,18,140,161,90,22,431
ANDHRA PRADESH,2001,2,Agriculture (Total),16,382,480,374,79,1331,12,65,46,45,10,178,28,447,526,419,89,1509
ANDHRA PRADESH,2001,2,Retired Persons,0,0,1,4,16,21,0,0,2,0,3,5,0,0,3,4,19,26
ANDHRA PRADESH,2002,2,House Wife,0,0,0,0,0,0,0,1009,773,319,91,2192,0,1009,773,319,91,2192
ANDHRA PRADESH,2002,2,Service (Government),0,19,56,25,0,100,0,6,10,5,0,21,0,25,66,30,0,121
ANDHRA PRADESH,2002,2,Service (Private),0,248,248,126,7,629,0,44,24,15,4,87,0,292,272,141,11,716
ANDHRA PRADESH,2002,2,Public Sector Undertaking,0,32,47,45,3,127,0,14,13,3,4,34,0,46,60,48,7,161
ANDHRA PRADESH,2002,2,Students,48,238,15,2,0,303,72,134,2,0,0,208,120,372,17,2,0,511
ANDHRA PRADESH,2002,2,Unemployed,0,276,283,115,0,674,0,114,37,18,0,169,0,390,320,133,0,843
ANDHRA PRADESH,2002,2,Professional Activity,0,74,129,124,45,372,0,7,18,24,5,54,0,81,147,148,50,426
ANDHRA PRADESH,2002,2,Agriculture (Total),2,448,609,443,127,1629,2,85,119,53,8,267,4,533,728,496,135,1896
ANDHRA PRADESH,2002,2,Retired Persons,0,0,3,16,17,36,0,0,0,0,0,0,0,0,3,16,17,36
ANDHRA PRADESH,2003,2,House Wife,0,0,0,0,0,0,4,955,622,256,92,1929,4,955,622,256,92,1929
ANDHRA PRADESH,2003,2,Service (Government),0,76,84,79,11,250,0,11,21,4,0,36,0,87,105,83,11,286
ANDHRA PRADESH,2003,2,Service (Private),2,90,166,103,8,369,2,32,43,21,5,103,4,122,209,124,13,472
ANDHRA PRADESH,2003,2,Public Sector Undertaking,0,20,48,37,16,121,0,20,21,11,3,55,0,40,69,48,19,176
ANDHRA PRADESH,2003,2,Students,69,240,39,0,0,348,71,148,2,0,0,221,140,388,41,0,0,569
ANDHRA PRADESH,2003,2,Unemployed,1,224,307,116,0,648,9,52,14,3,0,78,10,276,321,119,0,726
ANDHRA PRADESH,2003,2,Professional Activity,0,104,180,90,16,390,1,6,18,2,0,27,1,110,198,92,16,417
ANDHRA PRADESH,2003,2,Agriculture (Total),7,325,585,376,149,1442,6,81,163,96,12,358,13,406,748,472,161,1800
ANDHRA PRADESH,2003,2,Retired Persons,0,0,15,25,37,77,0,0,3,33,16,52,0,0,18,58,53,129
ANDHRA PRADESH,2004,2,House Wife,0,0,0,0,0,0,0,1163,795,264,93,2315,0,1163,795,264,93,2315
ANDHRA PRADESH,2004,2,Service (Government),0,81,163,51,5,300,0,5,8,1,0,14,0,86,171,52,5,314
ANDHRA PRADESH,2004,2,Service (Private),4,174,248,171,22,619,0,34,35,11,0,80,4,208,283,182,22,699
ANDHRA PRADESH,2004,2,Public Sector Undertaking,0,20,30,10,3,63,0,5,17,1,0,23,0,25,47,11,3,86
ANDHRA PRADESH,2004,2,Students,37,230,48,0,0,315,43,127,7,0,0,177,80,357,55,0,0,492
ANDHRA PRADESH,2004,2,Unemployed,1,175,239,147,0,562,2,46,18,14,0,80,3,221,257,161,0,642
ANDHRA PRADESH,2004,2,Professional Activity,1,87,154,60,27,329,1,24,21,23,12,81,2,111,175,83,39,410
ANDHRA PRADESH,2004,2,Agriculture (Total),2,455,857,687,217,2218,14,154,150,84,46,448,16,609,1007,771,263,2666
ANDHRA PRADESH,2004,2,Retired Persons,0,0,6,33,23,62,0,0,0,17,6,23,0,0,6,50,29,85
ANDHRA PRADESH,2005,2,House Wife,0,0,0,0,0,0,0,932,693,382,172,2179,0,932,693,382,172,2179
ANDHRA PRADESH,2005,2,Service (Government),0,10,43,57,0,110,0,6,24,0,0,30,0,16,67,57,0,140
ANDHRA PRADESH,2005,2,Service (Private),2,213,286,161,37,699,0,69,39,18,5,131,2,282,325,179,42,830
ANDHRA PRADESH,2005,2,Public Sector Undertaking,0,42,109,80,2,233,0,5,36,3,0,44,0,47,145,83,2,277
ANDHRA PRADESH,2005,2,Students,53,197,24,0,0,274,65,155,6,0,0,226,118,352,30,0,0,500
ANDHRA PRADESH,2005,2,Unemployed,1,169,160,52,48,430,0,70,10,0,0,80,1,239,170,52,48,510
ANDHRA PRADESH,2005,2,Professional Activity,0,37,61,43,41,182,1,26,8,3,0,38,1,63,69,46,41,220
ANDHRA PRADESH,2005,2,Agriculture (Total),6,481,729,578,223,2017,22,127,174,85,65,473,28,608,903,663,288,2490
ANDHRA PRADESH,2005,2,Retired Persons,0,2,0,35,20,57,0,1,0,1,1,3,0,3,0,36,21,60
ANDHRA PRADESH,2006,2,House Wife,0,0,0,0,0,0,2,994,750,303,107,2156,2,994,750,303,107,2156
ANDHRA PRADESH,2006,2,Service (Government),4,51,84,44,0,183,0,19,26,3,0,48,4,70,110,47,0,231
ANDHRA PRADESH,2006,2,Service (Private),0,157,240,159,20,576,0,30,35,6,0,71,0,187,275,165,20,647
ANDHRA PRADESH,2006,2,Public Sector Undertaking,0,67,69,48,6,190,0,1,10,3,0,14,0,68,79,51,6,204
ANDHRA PRADESH,2006,2,Students,55,216,12,4,0,287,53,168,4,0,0,225,108,384,16,4,0,512
ANDHRA PRADESH,2006,2,Unemployed,0,169,132,70,0,371,0,34,24,0,0,58,0,203,156,70,0,429
ANDHRA PRADESH,2006,2,Professional Activity,0,66,240,197,49,552,1,12,8,0,1,22,1,78,248,197,50,574
ANDHRA PRADESH,2006,2,Agriculture (Total),15,505,777,489,214,2000,14,241,210,115,27,607,29,746,987,604,241,2607
ANDHRA PRADESH,2006,2,Retired Persons,0,1,3,9,38,51,0,0,5,0,1,6,0,1,8,9,39,57
ANDHRA PRADESH,2007,2,House Wife,0,0,0,0,0,0,0,1105,811,405,159,2480,0,1105,811,405,159,2480
ANDHRA PRADESH,2007,2,Service (Government),0,71,86,63,0,220,1,26,19,9,0,55,1,97,105,72,0,275
ANDHRA PRADESH,2007,2,Service (Private),6,239,490,266,102,1103,3,41,105,72,49,270,9,280,595,338,151,1373
ANDHRA PRADESH,2007,2,Public Sector Undertaking,0,46,99,62,3,210,4,8,13,4,0,29,4,54,112,66,3,239
ANDHRA PRADESH,2007,2,Students,63,327,27,3,0,420,80,193,6,0,0,279,143,520,33,3,0,699
ANDHRA PRADESH,2007,2,Unemployed,0,120,146,74,0,340,7,43,10,3,0,63,7,163,156,77,0,403
ANDHRA PRADESH,2007,2,Professional Activity,2,110,151,109,49,421,7,31,17,3,0,58,9,141,168,112,49,479
ANDHRA PRADESH,2007,2,Agriculture (Total),5,325,620,421,137,1508,20,113,90,53,13,289,25,438,710,474,150,1797
ANDHRA PRADESH,2007,2,Retired Persons,0,1,7,4,55,67,0,0,0,6,5,11,0,1,7,10,60,78
ANDHRA PRADESH,2008,2,House Wife,0,0,0,0,0,0,0,984,1012,381,139,2516,0,984,1012,381,139,2516
ANDHRA PRADESH,2008,2,Service (Government),0,17,108,121,0,246,0,7,37,15,0,59,0,24,145,136,0,305
ANDHRA PRADESH,2008,2,Service (Private),0,239,420,217,92,968,0,68,75,31,15,189,0,307,495,248,107,1157
ANDHRA PRADESH,2008,2,Public Sector Undertaking,4,123,155,181,68,531,0,34,33,21,22,110,4,157,188,202,90,641
ANDHRA PRADESH,2008,2,Students,37,233,19,5,0,294,44,133,9,1,0,187,81,366,28,6,0,481
ANDHRA PRADESH,2008,2,Unemployed,0,185,164,170,0,519,0,7,20,25,0,52,0,192,184,195,0,571
ANDHRA PRADESH,2008,2,Professional Activity,2,60,202,157,38,459,0,25,4,0,4,33,2,85,206,157,42,492
ANDHRA PRADESH,2008,2,Agriculture (Total),2,436,628,505,176,1747,6,142,91,84,35,358,8,578,719,589,211,2105
ANDHRA PRADESH,2008,2,Retired Persons,0,0,21,7,24,52,0,0,5,2,8,15,0,0,26,9,32,67
ANDHRA PRADESH,2009,2,House Wife,0,0,0,0,0,0,0,1033,779,428,151,2391,0,1033,779,428,151,2391
ANDHRA PRADESH,2009,2,Service (Government),0,54,100,57,2,213,0,13,6,2,0,21,0,67,106,59,2,234
ANDHRA PRADESH,2009,2,Service (Private),0,277,468,222,79,1046,0,65,44,33,19,161,0,342,512,255,98,1207
ANDHRA PRADESH,2009,2,Public Sector Undertaking,0,154,203,152,78,587,0,36,20,8,14,78,0,190,223,160,92,665
ANDHRA PRADESH,2009,2,Students,38,293,33,0,0,364,65,164,4,0,0,233,103,457,37,0,0,597
ANDHRA PRADESH,2009,2,Unemployed,0,263,252,129,0,644,0,41,15,14,0,70,0,304,267,143,0,714
ANDHRA PRADESH,2009,2,Professional Activity,0,74,132,249,11,466,0,18,1,3,1,23,0,92,133,252,12,489
ANDHRA PRADESH,2009,2,Agriculture (Total),5,392,885,562,172,2016,5,132,141,100,20,398,10,524,1026,662,192,2414
ANDHRA PRADESH,2009,2,Retired Persons,0,0,0,8,61,69,0,0,25,1,3,29,0,0,25,9,64,98
ANDHRA PRADESH,2010,2,House Wife,0,0,0,0,0,0,0,1067,879,409,246,2601,0,1067,879,409,246,2601
ANDHRA PRADESH,2010,2,Service (Government),0,39,96,52,0,187,0,41,31,0,0,72,0,80,127,52,0,259
ANDHRA PRADESH,2010,2,Service (Private),0,352,361,198,18,929,0,58,36,11,9,114,0,410,397,209,27,1043
ANDHRA PRADESH,2010,2,Public Sector Undertaking,0,156,184,96,49,485,0,9,29,9,0,47,0,165,213,105,49,532
ANDHRA PRADESH,2010,2,Students,41,333,0,0,0,374,62,220,0,0,0,282,103,553,0,0,0,656
ANDHRA PRADESH,2010,2,Unemployed,0,266,208,87,0,561,0,27,48,0,0,75,0,293,256,87,0,636
ANDHRA PRADESH,2010,2,Professional Activity,0,86,75,37,20,218,0,6,1,2,1,10,0,92,76,39,21,228
ANDHRA PRADESH,2010,2,Agriculture (Total),4,563,824,573,166,2130,12,165,137,40,41,395,16,728,961,613,207,2525
ANDHRA PRADESH,2010,2,Retired Persons,0,0,0,9,57,66,0,0,0,11,7,18,0,0,0,20,64,84
ANDHRA PRADESH,2011,2,House Wife,0,0,0,0,0,0,1,1007,832,332,116,2288,1,1007,832,332,116,2288
ANDHRA PRADESH,2011,2,Service (Government),0,12,41,36,0,89,0,10,8,2,0,20,0,22,49,38,0,109
ANDHRA PRADESH,2011,2,Service (Private),0,311,543,419,114,1387,0,91,104,36,12,243,0,402,647,455,126,1630
ANDHRA PRADESH,2011,2,Public Sector Undertaking,0,99,83,81,25,288,0,22,51,3,3,79,0,121,134,84,28,367
ANDHRA PRADESH,2011,2,Students,45,235,7,0,0,287,59,216,1,0,0,276,104,451,8,0,0,563
ANDHRA PRADESH,2011,2,Unemployed,0,181,248,98,8,535,0,59,30,14,4,107,0,240,278,112,12,642
ANDHRA PRADESH,2011,2,Professional Activity,0,116,123,76,25,340,0,21,11,9,11,52,0,137,134,85,36,392
ANDHRA PRADESH,2011,2,Agriculture (Total),5,463,670,541,143,1822,3,202,102,67,10,384,8,665,772,608,153,2206
ANDHRA PRADESH,2011,2,Retired Persons,0,0,0,5,30,35,0,0,0,1,5,6,0,0,0,6,35,41
ANDHRA PRADESH,2012,2,House Wife,0,0,0,0,0,0,1,946,669,401,126,2143,1,946,669,401,126,2143
ANDHRA PRADESH,2012,2,Service (Government),0,18,42,45,3,108,0,7,16,6,0,29,0,25,58,51,3,137
ANDHRA PRADESH,2012,2,Service (Private),0,411,563,244,50,1268,0,84,67,24,10,185,0,495,630,268,60,1453
ANDHRA PRADESH,2012,2,Public Sector Undertaking,0,70,124,60,26,280,0,9,38,2,2,51,0,79,162,62,28,331
ANDHRA PRADESH,2012,2,Students,35,222,19,0,0,276,54,225,4,0,0,283,89,447,23,0,0,559
ANDHRA PRADESH,2012,2,Unemployed,0,195,266,133,46,640,0,81,33,11,2,127,0,276,299,144,48,767
ANDHRA PRADESH,2012,2,Professional Activity,0,85,142,98,9,334,1,15,14,1,0,31,1,100,156,99,9,365
ANDHRA PRADESH,2012,2,Agriculture (Total),0,474,753,624,249,2100,7,132,207,70,56,472,7,606,960,694,305,2572
ANDHRA PRADESH,2012,2,Retired Persons,0,0,1,31,52,84,0,0,0,0,0,0,0,0,1,31,52,84
ANDHRA PRADESH,2013,2,House Wife,0,0,0,0,0,0,1,803,600,347,161,1912,1,803,600,347,161,1912
ANDHRA PRADESH,2013,2,Service (Government),0,41,56,49,3,149,0,11,8,1,0,20,0,52,64,50,3,169
ANDHRA PRADESH,2013,2,Service (Private),0,384,551,280,84,1299,3,156,88,29,19,295,3,540,639,309,103,1594
ANDHRA PRADESH,2013,2,Public Sector Undertaking,0,67,108,68,20,263,0,11,36,3,0,50,0,78,144,71,20,313
ANDHRA PRADESH,2013,2,Students,45,324,34,0,0,403,43,257,16,0,0,316,88,581,50,0,0,719
ANDHRA PRADESH,2013,2,Unemployed,0,170,226,125,42,563,0,33,39,3,1,76,0,203,265,128,43,639
ANDHRA PRADESH,2013,2,Professional Activity,0,150,222,103,22,497,0,7,9,5,7,28,0,157,231,108,29,525
ANDHRA PRADESH,2013,2,Agriculture (Total),0,345,598,467,144,1554,1,138,175,94,52,460,1,483,773,561,196,2014
ANDHRA PRADESH,2013,2,Retired Persons,0,0,3,26,51,80,0,0,0,22,13,35,0,0,3,48,64,115
ANDHRA PRADESH,2014,2,House Wife,0,0,0,0,0,0,1,490,353,154,71,1069,1,490,353,154,71,1069
ANDHRA PRADESH,2014,2,Service (Government),0,21,34,23,1,79,0,7,0,2,0,9,0,28,34,25,1,88
ANDHRA PRADESH,2014,2,Service (Private),0,41,47,7,2,97,0,3,2,2,0,7,0,44,49,9,2,104
ANDHRA PRADESH,2014,2,Public Sector Undertaking,0,3,6,2,0,11,0,0,0,0,0,0,0,3,6,2,0,11
ANDHRA PRADESH,2014,2,Students,12,143,4,0,0,159,29,141,4,0,0,174,41,284,8,0,0,333
ANDHRA PRADESH,2014,2,Unemployed,0,105,69,32,3,209,0,14,5,4,1,24,0,119,74,36,4,233
ANDHRA PRADESH,2014,2,Agriculture (Total),0,148,223,153,49,573,0,36,14,6,3,59,0,184,237,159,52,632
ANDHRA PRADESH,2014,2,Retired Persons,0,0,1,4,14,19,0,1,0,0,0,1,0,1,1,4,14,20
ARUNACHAL PRADESH,2001,3,House Wife,0,0,0,0,0,0,0,9,5,1,0,15,0,9,5,1,0,15
ARUNACHAL PRADESH,2001,3,Service (Government),0,5,7,2,0,14,0,0,0,0,0,0,0,5,7,2,0,14
ARUNACHAL PRADESH,2001,3,Service (Private),0,12,19,1,0,32,0,5,4,0,0,9,0,17,23,1,0,41
ARUNACHAL PRADESH,2001,3,Public Sector Undertaking,0,0,0,0,0,0,0,0,0,0,0,0,0,0,0,0,0,0
ARUNACHAL PRADESH,2001,3,Students,0,2,0,0,0,2,2,4,0,0,0,6,2,6,0,0,0,8
ARUNACHAL PRADESH,2001,3,Unemployed,0,2,1,0,0,3,0,0,0,0,0,0,0,2,1,0,0,3
ARUNACHAL PRADESH,2001,3,Professional Activity,0,0,0,0,0,0,0,0,0,0,0,0,0,0,0,0,0,0
ARUNACHAL PRADESH,2001,3,Agriculture (Total),2,1,5,4,0,12,0,5,0,0,0,5,2,6,5,4,0,17
ARUNACHAL PRADESH,2001,3,Retired Persons,0,0,0,1,0,1,0,0,0,0,0,0,0,0,0,1,0,1
ARUNACHAL PRADESH,2002,3,House Wife,0,0,0,0,0,0,0,14,11,1,1,27,0,14,11,1,1,27
ARUNACHAL PRADESH,2002,3,Service (Government),0,5,9,1,0,15,0,0,0,0,0,0,0,5,9,1,0,15
ARUNACHAL PRADESH,2002,3,Service (Private),0,2,9,2,0,13,0,0,0,0,0,0,0,2,9,2,0,13
ARUNACHAL PRADESH,2002,3,Public Sector Undertaking,0,0,0,0,0,0,0,0,0,0,0,0,0,0,0,0,0,0
ARUNACHAL PRADESH,2002,3,Students,1,3,0,0,0,4,1,4,0,0,0,5,2,7,0,0,0,9
ARUNACHAL PRADESH,2002,3,Unemployed,0,1,0,1,0,2,0,4,0,0,0,4,0,5,0,1,0,6
ARUNACHAL PRADESH,2002,3,Professional Activity,0,0,1,0,0,1,0,0,0,0,0,0,0,0,1,0,0,1
ARUNACHAL PRADESH,2002,3,Agriculture (Total),0,5,12,1,3,21,1,5,0,0,0,6,1,10,12,1,3,27
ARUNACHAL PRADESH,2002,3,Retired Persons,0,0,0,1,0,1,0,0,0,0,0,0,0,0,0,1,0,1
ARUNACHAL PRADESH,2003,3,House Wife,0,0,0,0,0,0,0,8,8,2,0,18,0,8,8,2,0,18
ARUNACHAL PRADESH,2003,3,Service (Government),0,1,7,4,0,12,0,0,2,0,0,2,0,1,9,4,0,14
ARUNACHAL PRADESH,2003,3,Service (Private),0,2,1,0,0,3,0,0,0,0,0,0,0,2,1,0,0,3
ARUNACHAL PRADESH,2003,3,Public Sector Undertaking,0,1,0,0,0,1,0,0,0,0,0,0,0,1,0,0,0,1
ARUNACHAL PRADESH,2003,3,Students,1,0,0,0,0,1,1,3,0,0,0,4,2,3,0,0,0,5
ARUNACHAL PRADESH,2003,3,Unemployed,1,2,0,0,0,3,0,0,0,0,0,0,1,2,0,0,0,3
ARUNACHAL PRADESH,2003,3,Professional Activity,0,0,0,0,0,0,0,0,0,0,0,0,0,0,0,0,0,0
ARUNACHAL PRADESH,2003,3,Agriculture (Total),1,0,6,1,2,10,0,1,0,0,0,1,1,1,6,1,2,11
ARUNACHAL PRADESH,2003,3,Retired Persons,0,0,0,0,0,0,0,0,0,0,0,0,0,0,0,0,0,0
ARUNACHAL PRADESH,2004,3,House Wife,0,0,0,0,0,0,0,7,10,0,0,17,0,7,10,0,0,17
ARUNACHAL PRADESH,2004,3,Service (Government),0,2,7,1,0,10,0,1,0,0,0,1,0,3,7,1,0,11
ARUNACHAL PRADESH,2004,3,Service (Private),0,1,1,0,0,2,0,0,0,0,0,0,0,1,1,0,0,2
ARUNACHAL PRADESH,2004,3,Public Sector Undertaking,0,0,0,0,0,0,0,0,0,0,0,0,0,0,0,0,0,0
ARUNACHAL PRADESH,2004,3,Students,1,4,0,0,0,5,2,3,0,0,0,5,3,7,0,0,0,10
ARUNACHAL PRADESH,2004,3,Unemployed,0,1,1,0,0,2,1,0,2,0,0,3,1,1,3,0,0,5
ARUNACHAL PRADESH,2004,3,Professional Activity,0,0,0,0,0,0,0,0,0,0,0,0,0,0,0,0,0,0
ARUNACHAL PRADESH,2004,3,Agriculture (Total),0,5,9,2,0,16,1,2,1,0,0,4,1,7,10,2,0,20
ARUNACHAL PRADESH,2004,3,Retired Persons,0,0,0,0,0,0,0,0,0,0,0,0,0,0,0,0,0,0
ARUNACHAL PRADESH,2005,3,House Wife,0,0,0,0,0,0,0,1,6,1,1,9,0,1,6,1,1,9
ARUNACHAL PRADESH,2005,3,Service (Government),0,0,3,0,0,3,0,1,0,0,0,1,0,1,3,0,0,4
ARUNACHAL PRADESH,2005,3,Service (Private),0,0,4,0,0,4,0,0,1,0,0,1,0,0,5,0,0,5
ARUNACHAL PRADESH,2005,3,Public Sector Undertaking,0,0,0,0,0,0,0,0,0,0,0,0,0,0,0,0,0,0
ARUNACHAL PRADESH,2005,3,Students,0,1,0,0,0,1,0,1,0,0,0,1,0,2,0,0,0,2
ARUNACHAL PRADESH,2005,3,Unemployed,0,1,2,1,0,4,0,1,0,0,0,1,0,2,2,1,0,5
ARUNACHAL PRADESH,2005,3,Professional Activity,0,1,0,0,0,1,0,0,0,0,0,0,0,1,0,0,0,1
ARUNACHAL PRADESH,2005,3,Agriculture (Total),0,5,8,2,3,18,0,5,2,0,0,7,0,10,10,2,3,25
ARUNACHAL PRADESH,2005,3,Retired Persons,0,0,0,0,0,0,0,0,0,0,0,0,0,0,0,0,0,0
ARUNACHAL PRADESH,2006,3,House Wife,0,0,0,0,0,0,0,7,11,3,0,21,0,7,11,3,0,21
ARUNACHAL PRADESH,2006,3,Service (Government),0,2,9,7,0,18,0,0,1,0,0,1,0,2,10,7,0,19
ARUNACHAL PRADESH,2006,3,Service (Private),0,11,12,4,1,28,0,0,0,0,0,0,0,11,12,4,1,28
ARUNACHAL PRADESH,2006,3,Public Sector Undertaking,0,0,0,0,0,0,0,0,0,0,0,0,0,0,0,0,0,0
ARUNACHAL PRADESH,2006,3,Students,1,1,0,0,0,2,2,6,0,0,0,8,3,7,0,0,0,10
ARUNACHAL PRADESH,2006,3,Unemployed,0,3,5,1,0,9,0,0,0,0,0,0,0,3,5,1,0,9
ARUNACHAL PRADESH,2006,3,Professional Activity,0,0,0,0,0,0,0,0,0,0,0,0,0,0,0,0,0,0
ARUNACHAL PRADESH,2006,3,Agriculture (Total),0,1,2,1,0,4,0,0,0,0,0,0,0,1,2,1,0,4
ARUNACHAL PRADESH,2006,3,Retired Persons,0,0,0,0,0,0,0,0,0,0,0,0,0,0,0,0,0,0
ARUNACHAL PRADESH,2007,3,House Wife,0,0,0,0,0,0,0,2,8,0,0,10,0,2,8,0,0,10
ARUNACHAL PRADESH,2007,3,Service (Government),0,0,5,4,0,9,0,0,0,0,0,0,0,0,5,4,0,9
ARUNACHAL PRADESH,2007,3,Service (Private),0,10,5,2,1,18,0,1,0,0,0,1,0,11,5,2,1,19
ARUNACHAL PRADESH,2007,3,Public Sector Undertaking,0,0,0,0,0,0,0,0,0,0,0,0,0,0,0,0,0,0
ARUNACHAL PRADESH,2007,3,Students,1,2,0,0,0,3,2,6,0,0,0,8,3,8,0,0,0,11
ARUNACHAL PRADESH,2007,3,Unemployed,1,11,12,1,0,25,0,1,1,0,0,2,1,12,13,1,0,27
ARUNACHAL PRADESH,2007,3,Professional Activity,0,1,0,0,0,1,0,0,0,0,0,0,0,1,0,0,0,1
ARUNACHAL PRADESH,2007,3,Agriculture (Total),0,4,9,1,0,14,0,1,0,0,0,1,0,5,9,1,0,15
ARUNACHAL PRADESH,2007,3,Retired Persons,0,0,0,0,2,2,0,0,0,0,0,0,0,0,0,0,2,2
ARUNACHAL PRADESH,2008,3,House Wife,0,0,0,0,0,0,0,6,7,1,0,14,0,6,7,1,0,14
ARUNACHAL PRADESH,2008,3,Service (Government),0,10,14,1,0,25,0,0,1,0,0,1,0,10,15,1,0,26
ARUNACHAL PRADESH,2008,3,Service (Private),0,3,2,0,0,5,0,0,3,0,0,3,0,3,5,0,0,8
ARUNACHAL PRADESH,2008,3,Public Sector Undertaking,0,0,0,0,0,0,0,0,0,0,0,0,0,0,0,0,0,0
ARUNACHAL PRADESH,2008,3,Students,1,1,0,0,0,2,0,3,0,0,0,3,1,4,0,0,0,5
ARUNACHAL PRADESH,2008,3,Unemployed,0,4,6,1,0,11,0,0,1,0,0,1,0,4,7,1,0,12
ARUNACHAL PRADESH,2008,3,Professional Activity,0,0,0,0,0,0,0,0,0,0,0,0,0,0,0,0,0,0
ARUNACHAL PRADESH,2008,3,Agriculture (Total),0,6,1,5,0,12,0,0,0,0,0,0,0,6,1,5,0,12
ARUNACHAL PRADESH,2008,3,Retired Persons,0,0,0,0,0,0,0,0,0,0,0,0,0,0,0,0,0,0
ARUNACHAL PRADESH,2009,3,House Wife,0,0,0,0,0,0,0,6,7,1,0,14,0,6,7,1,0,14
ARUNACHAL PRADESH,2009,3,Service (Government),0,10,14,1,0,25,0,0,1,0,0,1,0,10,15,1,0,26
ARUNACHAL PRADESH,2009,3,Service (Private),0,3,2,0,0,5,0,0,3,0,0,3,0,3,5,0,0,8
ARUNACHAL PRADESH,2009,3,Public Sector Undertaking,0,0,0,0,0,0,0,0,0,0,0,0,0,0,0,0,0,0
ARUNACHAL PRADESH,2009,3,Students,1,1,0,0,0,2,0,3,0,0,0,3,1,4,0,0,0,5
ARUNACHAL PRADESH,2009,3,Unemployed,0,4,6,1,0,11,0,0,1,0,0,1,0,4,7,1,0,12
ARUNACHAL PRADESH,2009,3,Professional Activity,0,0,0,0,0,0,0,0,0,0,0,0,0,0,0,0,0,0
ARUNACHAL PRADESH,2009,3,Agriculture (Total),0,6,1,5,0,12,0,0,0,0,0,0,0,6,1,5,0,12
ARUNACHAL PRADESH,2009,3,Retired Persons,0,0,0,0,0,0,0,0,0,0,0,0,0,0,0,0,0,0
ARUNACHAL PRADESH,2010,3,House Wife,0,0,0,0,0,0,0,9,7,1,0,17,0,9,7,1,0,17
ARUNACHAL PRADESH,2010,3,Service (Government),0,6,4,1,0,11,0,0,0,0,0,0,0,6,4,1,0,11
ARUNACHAL PRADESH,2010,3,Service (Private),0,3,5,1,0,9,0,0,1,0,0,1,0,3,6,1,0,10
ARUNACHAL PRADESH,2010,3,Public Sector Undertaking,0,0,0,0,0,0,0,0,0,0,0,0,0,0,0,0,0,0
ARUNACHAL PRADESH,2010,3,Students,4,4,0,0,0,8,4,4,0,0,0,8,8,8,0,0,0,16
ARUNACHAL PRADESH,2010,3,Unemployed,0,2,4,0,0,6,0,1,0,0,0,1,0,3,4,0,0,7
ARUNACHAL PRADESH,2010,3,Professional Activity,0,0,0,0,0,0,0,0,0,0,0,0,0,0,0,0,0,0
ARUNACHAL PRADESH,2010,3,Agriculture (Total),0,7,9,1,1,18,0,0,0,0,0,0,0,7,9,1,1,18
ARUNACHAL PRADESH,2010,3,Retired Persons,0,0,0,0,0,0,0,0,0,0,0,0,0,0,0,0,0,0
ARUNACHAL PRADESH,2011,3,House Wife,0,0,0,0,0,0,0,11,8,1,1,21,0,11,8,1,1,21
ARUNACHAL PRADESH,2011,3,Service (Government),0,2,9,5,0,16,0,0,0,0,0,0,0,2,9,5,0,16
ARUNACHAL PRADESH,2011,3,Service (Private),0,9,4,1,1,15,0,0,0,0,0,0,0,9,4,1,1,15
ARUNACHAL PRADESH,2011,3,Public Sector Undertaking,0,2,3,4,0,9,0,0,0,0,0,0,0,2,3,4,0,9
ARUNACHAL PRADESH,2011,3,Students,3,7,0,0,0,10,1,4,0,0,0,5,4,11,0,0,0,15
ARUNACHAL PRADESH,2011,3,Unemployed,0,5,2,0,0,7,1,2,0,0,0,3,1,7,2,0,0,10
ARUNACHAL PRADESH,2011,3,Professional Activity,0,0,0,0,0,0,0,0,0,0,0,0,0,0,0,0,0,0
ARUNACHAL PRADESH,2011,3,Agriculture (Total),0,4,4,3,1,12,0,1,0,0,0,1,0,5,4,3,1,13
ARUNACHAL PRADESH,2011,3,Retired Persons,0,0,0,0,1,1,0,0,0,0,0,0,0,0,0,0,1,1
ARUNACHAL PRADESH,2012,3,House Wife,0,0,0,0,0,0,0,9,9,1,0,19,0,9,9,1,0,19
ARUNACHAL PRADESH,2012,3,Service (Government),0,1,1,2,0,4,0,5,0,0,0,5,0,6,1,2,0,9
ARUNACHAL PRADESH,2012,3,Service (Private),0,4,13,12,0,29,0,1,0,0,0,1,0,5,13,12,0,30
ARUNACHAL PRADESH,2012,3,Public Sector Undertaking,0,2,0,0,0,2,0,0,0,0,0,0,0,2,0,0,0,2
ARUNACHAL PRADESH,2012,3,Students,1,9,0,0,0,10,0,3,0,0,0,3,1,12,0,0,0,13
ARUNACHAL PRADESH,2012,3,Unemployed,0,3,8,5,0,16,0,0,0,0,0,0,0,3,8,5,0,16
ARUNACHAL PRADESH,2012,3,Professional Activity,0,0,0,0,0,0,0,0,0,0,0,0,0,0,0,0,0,0
ARUNACHAL PRADESH,2012,3,Agriculture (Total),0,1,7,3,0,11,0,0,0,0,0,0,0,1,7,3,0,11
ARUNACHAL PRADESH,2012,3,Retired Persons,0,0,0,0,0,0,0,0,0,0,0,0,0,0,0,0,0,0
ARUNACHAL PRADESH,2013,3,House Wife,0,0,0,0,0,0,0,9,8,2,1,20,0,9,8,2,1,20
ARUNACHAL PRADESH,2013,3,Service (Government),0,8,14,6,0,28,0,2,1,0,0,3,0,10,15,6,0,31
ARUNACHAL PRADESH,2013,3,Service (Private),0,7,3,6,0,16,0,0,1,0,0,1,0,7,4,6,0,17
ARUNACHAL PRADESH,2013,3,Public Sector Undertaking,0,0,1,1,0,2,0,0,0,0,0,0,0,0,1,1,0,2
ARUNACHAL PRADESH,2013,3,Students,3,13,1,0,0,17,2,8,1,0,0,11,5,21,2,0,0,28
ARUNACHAL PRADESH,2013,3,Unemployed,0,6,16,4,1,27,0,4,2,0,0,6,0,10,18,4,1,33
ARUNACHAL PRADESH,2013,3,Professional Activity,0,1,0,0,0,1,0,0,0,0,0,0,0,1,0,0,0,1
ARUNACHAL PRADESH,2013,3,Agriculture (Total),0,5,8,13,6,32,0,3,2,0,0,5,0,8,10,13,6,37
ARUNACHAL PRADESH,2013,3,Retired Persons,0,0,0,0,0,0,0,0,0,0,0,0,0,0,0,0,0,0
ARUNACHAL PRADESH,2014,3,House Wife,0,0,0,0,0,0,0,8,6,0,0,14,0,8,6,0,0,14
ARUNACHAL PRADESH,2014,3,Service (Government),0,4,9,4,0,17,0,2,0,0,0,2,0,6,9,4,0,19
ARUNACHAL PRADESH,2014,3,Service (Private),0,5,3,0,0,8,0,1,0,0,0,1,0,6,3,0,0,9
ARUNACHAL PRADESH,2014,3,Public Sector Undertaking,0,1,0,0,0,1,0,0,0,0,0,0,0,1,0,0,0,1
ARUNACHAL PRADESH,2014,3,Students,2,11,0,0,0,13,1,11,0,0,0,12,3,22,0,0,0,25
ARUNACHAL PRADESH,2014,3,Unemployed,1,3,3,6,1,14,0,6,1,0,0,7,1,9,4,6,1,21
ARUNACHAL PRADESH,2014,3,Agriculture (Total),0,3,0,0,0,3,0,0,0,0,0,0,0,3,0,0,0,3
ARUNACHAL PRADESH,2014,3,Retired Persons,0,0,0,0,0,0,0,0,0,0,0,0,0,0,0,0,0,0
ASSAM,2001,4,House Wife,0,0,0,0,0,0,0,158,161,68,7,394,0,158,161,68,7,394
ASSAM,2001,4,Service (Government),0,7,25,13,0,45,0,0,2,0,0,2,0,7,27,13,0,47
ASSAM,2001,4,Service (Private),0,46,49,32,4,131,0,13,12,3,0,28,0,59,61,35,4,159
ASSAM,2001,4,Public Sector Undertaking,0,39,28,17,0,84,0,0,2,0,0,2,0,39,30,17,0,86
ASSAM,2001,4,Students,29,86,6,0,0,121,9,55,6,0,0,70,38,141,12,0,0,191
ASSAM,2001,4,Unemployed,0,108,124,59,5,296,0,21,14,3,0,38,0,129,138,62,5,334
ASSAM,2001,4,Professional Activity,0,16,36,15,0,67,0,1,0,0,0,1,0,17,36,15,0,68
ASSAM,2001,4,Agriculture (Total),0,30,62,43,9,144,0,7,6,9,1,23,0,37,68,52,10,167
ASSAM,2001,4,Retired Persons,0,0,0,2,4,6,0,0,0,0,0,0,0,0,0,2,4,6
ASSAM,2002,4,House Wife,0,0,0,0,0,0,0,221,178,67,19,485,0,221,178,67,19,485
ASSAM,2002,4,Service (Government),0,4,4,6,0,14,0,1,3,0,0,4,0,5,7,6,0,18
ASSAM,2002,4,Service (Private),0,26,36,15,2,79,0,4,4,4,0,12,0,30,40,19,2,91
ASSAM,2002,4,Public Sector Undertaking,0,25,20,17,2,64,0,5,2,1,0,8,0,30,22,18,2,72
ASSAM,2002,4,Students,7,77,3,1,0,88,10,19,0,0,0,29,17,96,3,1,0,117
ASSAM,2002,4,Unemployed,0,69,127,28,7,231,0,20,6,5,0,31,0,89,133,33,7,262
ASSAM,2002,4,Professional Activity,0,13,17,12,0,42,0,0,0,0,0,0,0,13,17,12,0,42
ASSAM,2002,4,Agriculture (Total),0,62,112,69,5,248,0,13,7,3,0,23,0,75,119,72,5,271
ASSAM,2002,4,Retired Persons,0,0,0,0,6,6,0,0,0,0,0,0,0,0,0,0,6,6
ASSAM,2003,4,House Wife,0,0,0,0,0,0,2,183,126,57,13,381,2,183,126,57,13,381
ASSAM,2003,4,Service (Government),0,2,9,4,0,15,0,0,0,0,0,0,0,2,9,4,0,15
ASSAM,2003,4,Service (Private),0,27,26,33,2,88,0,5,1,2,0,8,0,32,27,35,2,96
ASSAM,2003,4,Public Sector Undertaking,0,35,22,15,1,73,0,16,5,1,0,22,0,51,27,16,1,95
ASSAM,2003,4,Students,24,101,4,0,0,129,19,72,0,0,0,91,43,173,4,0,0,220
ASSAM,2003,4,Unemployed,0,40,111,52,2,205,0,28,28,10,1,67,0,68,139,62,3,272
ASSAM,2003,4,Professional Activity,2,8,17,3,4,34,0,0,0,0,0,0,2,8,17,3,4,34
ASSAM,2003,4,Agriculture (Total),2,53,56,27,18,156,0,30,1,0,0,31,2,83,57,27,18,187
ASSAM,2003,4,Retired Persons,0,0,0,0,1,1,0,0,0,0,0,0,0,0,0,0,1,1
ASSAM,2004,4,House Wife,0,0,0,0,0,0,0,212,159,70,5,446,0,212,159,70,5,446
ASSAM,2004,4,Service (Government),0,0,4,6,0,10,0,0,1,1,0,2,0,0,5,7,0,12
ASSAM,2004,4,Service (Private),0,31,26,12,0,69,0,2,6,7,0,15,0,33,32,19,0,84
ASSAM,2004,4,Public Sector Undertaking,0,24,16,9,1,50,0,6,7,2,0,15,0,30,23,11,1,65
ASSAM,2004,4,Students,20,89,4,0,0,113,10,50,2,0,0,62,30,139,6,0,0,175
ASSAM,2004,4,Unemployed,0,50,90,86,11,237,0,33,18,10,1,62,0,83,108,96,12,299
ASSAM,2004,4,Professional Activity,2,47,64,10,1,124,0,0,0,0,0,0,2,47,64,10,1,124
ASSAM,2004,4,Agriculture (Total),0,83,155,67,11,316,2,8,3,2,0,15,2,91,158,69,11,331
ASSAM,2004,4,Retired Persons,0,0,0,0,4,4,0,0,0,0,0,0,0,0,0,0,4,4
ASSAM,2005,4,House Wife,0,0,0,0,0,0,0,281,206,76,3,566,0,281,206,76,3,566
ASSAM,2005,4,Service (Government),0,2,6,6,0,14,0,0,0,0,0,0,0,2,6,6,0,14
ASSAM,2005,4,Service (Private),0,17,17,9,0,43,0,8,2,0,0,10,0,25,19,9,0,53
ASSAM,2005,4,Public Sector Undertaking,0,20,17,19,0,56,0,4,0,0,0,4,0,24,17,19,0,60
ASSAM,2005,4,Students,16,87,0,0,0,103,18,33,0,0,0,51,34,120,0,0,0,154
ASSAM,2005,4,Unemployed,0,5,40,33,9,87,0,0,8,1,0,9,0,5,48,34,9,96
ASSAM,2005,4,Professional Activity,0,15,32,19,0,66,0,0,0,0,3,3,0,15,32,19,3,69
ASSAM,2005,4,Agriculture (Total),0,60,117,65,14,256,2,16,16,9,0,43,2,76,133,74,14,299
ASSAM,2005,4,Retired Persons,0,0,0,3,6,9,0,0,0,0,2,2,0,0,0,3,8,11
ASSAM,2006,4,House Wife,0,0,0,0,0,0,0,258,247,68,6,579,0,258,247,68,6,579
ASSAM,2006,4,Service (Government),0,6,6,5,0,17,0,0,0,0,0,0,0,6,6,5,0,17
ASSAM,2006,4,Service (Private),0,14,19,5,0,38,0,4,3,1,0,8,0,18,22,6,0,46
ASSAM,2006,4,Public Sector Undertaking,0,18,10,11,0,39,0,9,5,0,0,14,0,27,15,11,0,53
ASSAM,2006,4,Students,27,127,3,0,0,157,19,32,2,0,0,53,46,159,5,0,0,210
ASSAM,2006,4,Unemployed,0,0,15,24,2,41,0,0,0,0,0,0,0,0,15,24,2,41
ASSAM,2006,4,Professional Activity,1,26,82,29,0,138,0,0,0,0,0,0,1,26,82,29,0,138
ASSAM,2006,4,Agriculture (Total),0,82,139,54,20,295,2,2,13,10,0,27,2,84,152,64,20,322
ASSAM,2006,4,Retired Persons,0,2,1,2,5,10,0,0,0,0,0,0,0,2,1,2,5,10
ASSAM,2007,4,House Wife,0,0,0,0,0,0,0,188,214,95,19,516,0,188,214,95,19,516
ASSAM,2007,4,Service (Government),0,6,7,2,0,15,0,0,2,0,0,2,0,6,9,2,0,17
ASSAM,2007,4,Service (Private),0,9,11,10,0,30,0,7,3,2,0,12,0,16,14,12,0,42
ASSAM,2007,4,Public Sector Undertaking,0,13,52,8,1,74,0,9,8,2,0,19,0,22,60,10,1,93
ASSAM,2007,4,Students,29,90,0,0,0,119,23,62,3,1,1,90,52,152,3,1,1,209
ASSAM,2007,4,Unemployed,0,7,2,15,6,30,0,5,1,0,0,6,0,12,3,15,6,36
ASSAM,2007,4,Professional Activity,0,30,86,34,0,150,0,0,0,0,0,0,0,30,86,34,0,150
ASSAM,2007,4,Agriculture (Total),0,90,111,67,8,276,0,0,2,0,0,2,0,90,113,67,8,278
ASSAM,2007,4,Retired Persons,0,0,0,0,7,7,0,0,0,0,0,0,0,0,0,0,7,7
ASSAM,2008,4,House Wife,0,0,0,0,0,0,0,226,247,89,11,573,0,226,247,89,11,573
ASSAM,2008,4,Service (Government),0,2,13,4,0,19,0,2,0,0,0,2,0,4,13,4,0,21
ASSAM,2008,4,Service (Private),0,16,26,10,0,52,0,12,6,3,0,21,0,28,32,13,0,73
ASSAM,2008,4,Public Sector Undertaking,0,5,28,13,0,46,0,5,1,1,0,7,0,10,29,14,0,53
ASSAM,2008,4,Students,21,108,0,0,0,129,12,65,0,0,0,77,33,173,0,0,0,206
ASSAM,2008,4,Unemployed,0,15,3,19,0,37,0,7,0,0,0,7,0,22,3,19,0,44
ASSAM,2008,4,Professional Activity,0,33,66,32,2,133,0,0,4,0,0,4,0,33,70,32,2,137
ASSAM,2008,4,Agriculture (Total),0,70,61,55,6,192,0,5,0,0,0,5,0,75,61,55,6,197
ASSAM,2008,4,Retired Persons,0,0,0,0,4,4,0,0,0,0,1,1,0,0,0,0,5,5
ASSAM,2009,4,House Wife,0,0,0,0,0,0,0,222,213,94,12,541,0,222,213,94,12,541
ASSAM,2009,4,Service (Government),0,1,1,3,0,5,0,0,0,0,0,0,0,1,1,3,0,5
ASSAM,2009,4,Service (Private),0,27,13,15,1,56,0,4,2,1,0,7,0,31,15,16,1,63
ASSAM,2009,4,Public Sector Undertaking,0,13,23,14,0,50,0,3,3,8,0,14,0,16,26,22,0,64
ASSAM,2009,4,Students,11,118,0,0,0,129,8,83,0,0,0,91,19,201,0,0,0,220
ASSAM,2009,4,Unemployed,0,3,24,31,0,58,0,3,6,6,0,15,0,6,30,37,0,73
ASSAM,2009,4,Professional Activity,0,37,69,23,2,131,0,4,5,3,0,12,0,41,74,26,2,143
ASSAM,2009,4,Agriculture (Total),0,95,137,80,5,317,0,8,7,9,0,24,0,103,144,89,5,341
ASSAM,2009,4,Retired Persons,0,0,0,3,10,13,0,0,0,0,0,0,0,0,0,3,10,13
ASSAM,2010,4,House Wife,0,0,0,0,0,0,0,205,146,55,9,415,0,205,146,55,9,415
ASSAM,2010,4,Service (Government),0,2,7,9,0,18,0,1,0,0,0,1,0,3,7,9,0,19
ASSAM,2010,4,Service (Private),0,19,28,10,0,57,0,11,5,0,0,16,0,30,33,10,0,73
ASSAM,2010,4,Public Sector Undertaking,0,19,51,26,2,98,0,2,12,6,0,20,0,21,63,32,2,118
ASSAM,2010,4,Students,20,128,0,0,0,148,14,85,0,0,0,99,34,213,0,0,0,247
ASSAM,2010,4,Unemployed,0,3,28,34,1,66,0,12,2,2,0,16,0,15,30,36,1,82
ASSAM,2010,4,Professional Activity,0,59,45,29,3,136,0,7,3,0,0,10,0,66,48,29,3,146
ASSAM,2010,4,Agriculture (Total),0,132,126,82,12,352,0,6,9,1,1,17,0,138,135,83,13,369
ASSAM,2010,4,Retired Persons,0,0,2,2,6,10,0,0,0,0,0,0,0,0,2,2,6,10
ASSAM,2011,4,House Wife,0,0,0,0,0,0,0,175,214,92,9,490,0,175,214,92,9,490
ASSAM,2011,4,Service (Government),0,5,13,9,0,27,0,0,1,0,0,1,0,5,14,9,0,28
ASSAM,2011,4,Service (Private),0,26,44,16,0,86,0,0,8,4,0,12,0,26,52,20,0,98
ASSAM,2011,4,Public Sector Undertaking,0,17,52,22,0,91,1,4,2,1,0,8,1,21,54,23,0,99
ASSAM,2011,4,Students,8,152,0,0,0,160,3,81,8,0,0,92,11,233,8,0,0,252
ASSAM,2011,4,Unemployed,0,7,15,21,5,48,0,6,5,0,0,11,0,13,20,21,5,59
ASSAM,2011,4,Professional Activity,0,28,33,24,0,85,0,0,0,0,0,0,0,28,33,24,0,85
ASSAM,2011,4,Agriculture (Total),0,97,125,70,8,300,0,6,5,0,1,12,0,103,130,70,9,312
ASSAM,2011,4,Retired Persons,0,0,0,0,3,3,0,0,0,0,0,0,0,0,0,0,3,3
ASSAM,2012,4,House Wife,0,0,0,0,0,0,0,133,175,91,4,403,0,133,175,91,4,403
ASSAM,2012,4,Service (Government),0,1,10,17,1,29,0,12,9,4,0,25,0,13,19,21,1,54
ASSAM,2012,4,Service (Private),0,44,50,28,0,122,0,3,6,2,0,11,0,47,56,30,0,133
ASSAM,2012,4,Public Sector Undertaking,0,25,51,30,1,107,0,4,4,1,0,9,0,29,55,31,1,116
ASSAM,2012,4,Students,6,116,2,0,0,124,7,88,2,0,0,97,13,204,4,0,0,221
ASSAM,2012,4,Unemployed,0,12,12,33,7,64,0,2,1,1,0,4,0,14,13,34,7,68
ASSAM,2012,4,Professional Activity,0,30,55,24,1,110,0,4,8,3,0,15,0,34,63,27,1,125
ASSAM,2012,4,Agriculture (Total),2,103,143,80,12,340,0,0,4,0,0,4,2,103,147,80,12,344
ASSAM,2012,4,Retired Persons,0,0,0,0,4,4,0,0,0,0,0,0,0,0,0,0,4,4
ASSAM,2013,4,House Wife,0,0,0,0,0,0,0,155,284,129,9,577,0,155,284,129,9,577
ASSAM,2013,4,Service (Government),0,0,6,1,0,7,0,3,1,0,0,4,0,3,7,1,0,11
ASSAM,2013,4,Service (Private),0,9,33,11,0,53,0,5,8,1,0,14,0,14,41,12,0,67
ASSAM,2013,4,Public Sector Undertaking,0,53,93,61,0,207,0,2,7,0,0,9,0,55,100,61,0,216
ASSAM,2013,4,Students,5,234,0,0,0,239,1,124,0,0,0,125,6,358,0,0,0,364
ASSAM,2013,4,Unemployed,0,4,59,133,3,199,0,5,3,4,0,12,0,9,62,137,3,211
ASSAM,2013,4,Professional Activity,0,38,68,39,3,148,0,3,2,2,0,7,0,41,70,41,3,155
ASSAM,2013,4,Agriculture (Total),0,74,124,77,3,278,0,11,9,7,0,27,0,85,133,84,3,305
ASSAM,2013,4,Retired Persons,0,0,0,0,4,4,0,0,0,0,0,0,0,0,0,0,4,4
ASSAM,2014,4,House Wife,0,0,0,0,0,0,0,195,238,86,3,522,0,195,238,86,3,522
ASSAM,2014,4,Service (Government),0,2,7,4,0,13,0,0,1,0,0,1,0,2,8,4,0,14
ASSAM,2014,4,Service (Private),0,27,16,8,0,51,0,0,0,0,0,0,0,27,16,8,0,51
ASSAM,2014,4,Public Sector Undertaking,0,17,37,9,0,63,0,0,0,0,0,0,0,17,37,9,0,63
ASSAM,2014,4,Students,2,220,2,0,0,224,1,172,0,0,0,173,3,392,2,0,0,397
ASSAM,2014,4,Unemployed,0,29,58,23,4,114,0,17,3,0,0,20,0,46,61,23,4,134
ASSAM,2014,4,Agriculture (Total),0,16,19,15,0,50,0,4,5,0,0,9,0,20,24,15,0,59
ASSAM,2014,4,Retired Persons,0,0,0,7,1,8,0,0,0,0,0,0,0,0,0,7,1,8
BIHAR,2001,5,House Wife,0,0,0,0,0,0,0,62,62,13,3,140,0,62,62,13,3,140
BIHAR,2001,5,Service (Government),0,1,4,0,0,5,0,1,0,0,0,1,0,2,4,0,0,6
BIHAR,2001,5,Service (Private),0,11,3,0,1,15,0,3,0,0,0,3,0,14,3,0,1,18
BIHAR,2001,5,Public Sector Undertaking,0,0,1,0,0,1,0,0,0,0,0,0,0,0,1,0,0,1
BIHAR,2001,5,Students,3,34,2,0,0,39,6,17,2,0,0,25,9,51,4,0,0,64
BIHAR,2001,5,Unemployed,1,13,6,1,1,22,2,10,2,2,0,16,3,23,8,3,1,38
BIHAR,2001,5,Professional Activity,0,2,1,0,0,3,0,0,0,0,0,0,0,2,1,0,0,3
BIHAR,2001,5,Agriculture (Total),0,19,23,12,1,55,0,4,1,1,0,6,0,23,24,13,1,61
BIHAR,2001,5,Retired Persons,0,0,0,0,2,2,0,0,0,0,0,0,0,0,0,0,2,2
BIHAR,2002,5,House Wife,0,0,0,0,0,0,0,70,52,22,4,148,0,70,52,22,4,148
BIHAR,2002,5,Service (Government),0,0,3,3,0,6,0,0,0,0,0,0,0,0,3,3,0,6
BIHAR,2002,5,Service (Private),0,4,3,0,1,8,0,5,3,0,0,8,0,9,6,0,1,16
BIHAR,2002,5,Public Sector Undertaking,0,0,0,1,0,1,0,0,0,0,0,0,0,0,0,1,0,1
BIHAR,2002,5,Students,5,25,10,0,0,40,6,3,5,0,0,14,11,28,15,0,0,54
BIHAR,2002,5,Unemployed,0,21,31,5,0,57,1,6,4,0,0,11,1,27,35,5,0,68
BIHAR,2002,5,Professional Activity,0,2,3,0,0,5,0,0,0,0,0,0,0,2,3,0,0,5
BIHAR,2002,5,Agriculture (Total),0,18,40,8,2,68,0,10,1,1,0,12,0,28,41,9,2,80
BIHAR,2002,5,Retired Persons,0,0,0,0,1,1,0,0,0,0,0,0,0,0,0,0,1,1
BIHAR,2003,5,House Wife,0,0,0,0,0,0,0,75,61,2,0,138,0,75,61,2,0,138
BIHAR,2003,5,Service (Government),0,0,2,1,0,3,0,1,1,0,0,2,0,1,3,1,0,5
BIHAR,2003,5,Service (Private),0,10,9,2,0,21,0,3,3,0,0,6,0,13,12,2,0,27
BIHAR,2003,5,Public Sector Undertaking,0,0,2,1,0,3,0,0,0,0,0,0,0,0,2,1,0,3
BIHAR,2003,5,Students,15,26,0,0,0,41,9,9,0,0,0,18,24,35,0,0,0,59
BIHAR,2003,5,Unemployed,12,20,27,3,0,62,1,5,5,2,0,13,13,25,32,5,0,75
BIHAR,2003,5,Professional Activity,1,8,7,3,0,19,0,1,5,0,0,6,1,9,12,3,0,25
BIHAR,2003,5,Agriculture (Total),5,11,15,12,2,45,0,0,1,0,0,1,5,11,16,12,2,46
BIHAR,2003,5,Retired Persons,0,0,0,1,5,6,0,0,0,0,0,0,0,0,0,1,5,6
BIHAR,2004,5,House Wife,0,0,0,0,0,0,0,39,40,9,2,90,0,39,40,9,2,90
BIHAR,2004,5,Service (Government),0,0,4,4,0,8,0,0,0,0,0,0,0,0,4,4,0,8
BIHAR,2004,5,Service (Private),0,4,7,4,0,15,0,0,0,1,0,1,0,4,7,5,0,16
BIHAR,2004,5,Public Sector Undertaking,0,1,6,1,0,8,0,0,0,0,0,0,0,1,6,1,0,8
BIHAR,2004,5,Students,7,14,1,0,0,22,5,5,0,0,0,10,12,19,1,0,0,32
BIHAR,2004,5,Unemployed,5,24,11,3,0,43,1,1,4,1,0,7,6,25,15,4,0,50
BIHAR,2004,5,Professional Activity,0,2,2,2,0,6,0,0,0,0,0,0,0,2,2,2,0,6
BIHAR,2004,5,Agriculture (Total),0,4,10,6,3,23,0,0,0,0,0,0,0,4,10,6,3,23
BIHAR,2004,5,Retired Persons,0,0,11,3,3,17,0,0,0,0,0,0,0,0,11,3,3,17
BIHAR,2005,5,House Wife,0,0,0,0,0,0,0,55,38,11,5,109,0,55,38,11,5,109
BIHAR,2005,5,Service (Government),0,0,3,2,0,5,0,1,0,0,0,1,0,1,3,2,0,6
BIHAR,2005,5,Service (Private),0,12,15,7,0,34,0,0,2,0,0,2,0,12,17,7,0,36
BIHAR,2005,5,Public Sector Undertaking,0,1,3,5,0,9,0,0,0,0,0,0,0,1,3,5,0,9
BIHAR,2005,5,Students,7,24,2,0,0,33,3,5,6,0,0,14,10,29,8,0,0,47
BIHAR,2005,5,Unemployed,0,11,5,4,3,23,0,5,0,0,0,5,0,16,5,4,3,28
BIHAR,2005,5,Professional Activity,0,8,7,4,0,19,0,0,0,0,0,0,0,8,7,4,0,19
BIHAR,2005,5,Agriculture (Total),1,5,17,8,1,32,0,3,2,2,0,7,1,8,19,10,1,39
BIHAR,2005,5,Retired Persons,0,0,0,1,1,2,0,1,1,0,0,2,0,1,1,1,1,4
BIHAR,2006,5,House Wife,0,0,0,0,0,0,0,56,68,12,1,137,0,56,68,12,1,137
BIHAR,2006,5,Service (Government),0,1,3,2,0,6,0,1,3,0,0,4,0,2,6,2,0,10
BIHAR,2006,5,Service (Private),0,5,9,1,0,15,0,0,0,1,0,1,0,5,9,2,0,16
BIHAR,2006,5,Public Sector Undertaking,0,1,1,0,0,2,0,0,5,0,0,5,0,1,6,0,0,7
BIHAR,2006,5,Students,10,30,3,0,0,43,8,14,5,0,0,27,18,44,8,0,0,70
BIHAR,2006,5,Unemployed,0,8,9,0,1,18,1,4,2,1,0,8,1,12,11,1,1,26
BIHAR,2006,5,Professional Activity,0,1,2,0,0,3,0,0,0,1,0,1,0,1,2,1,0,4
BIHAR,2006,5,Agriculture (Total),0,13,21,2,2,38,0,4,4,0,0,8,0,17,25,2,2,46
BIHAR,2006,5,Retired Persons,0,0,0,0,1,1,0,0,0,0,1,1,0,0,0,0,2,2
BIHAR,2007,5,House Wife,0,0,0,0,0,0,0,63,73,29,6,171,0,63,73,29,6,171
BIHAR,2007,5,Service (Government),0,2,2,4,0,8,0,0,0,0,0,0,0,2,2,4,0,8
BIHAR,2007,5,Service (Private),0,12,9,15,0,36,0,0,0,0,0,0,0,12,9,15,0,36
BIHAR,2007,5,Public Sector Undertaking,0,4,5,8,2,19,0,0,0,0,0,0,0,4,5,8,2,19
BIHAR,2007,5,Students,14,34,7,1,0,56,26,32,1,0,0,59,40,66,8,1,0,115
BIHAR,2007,5,Unemployed,0,36,12,14,3,65,0,9,10,0,0,19,0,45,22,14,3,84
BIHAR,2007,5,Professional Activity,1,1,0,1,0,3,0,0,0,0,0,0,1,1,0,1,0,3
BIHAR,2007,5,Agriculture (Total),1,29,27,19,2,78,0,0,8,0,0,8,1,29,35,19,2,86
BIHAR,2007,5,Retired Persons,0,0,0,1,2,3,0,0,0,0,0,0,0,0,0,1,2,3
BIHAR,2008,5,House Wife,0,0,0,0,0,0,0,66,88,18,2,174,0,66,88,18,2,174
BIHAR,2008,5,Service (Government),0,3,2,2,1,8,0,0,0,0,0,0,0,3,2,2,1,8
BIHAR,2008,5,Service (Private),0,7,8,15,1,31,0,1,2,1,0,4,0,8,10,16,1,35
BIHAR,2008,5,Public Sector Undertaking,0,10,2,1,0,13,0,9,1,0,0,10,0,19,3,1,0,23
BIHAR,2008,5,Students,9,26,7,0,0,42,3,13,0,0,0,16,12,39,7,0,0,58
BIHAR,2008,5,Unemployed,2,24,17,6,0,49,1,3,0,0,0,4,3,27,17,6,0,53
BIHAR,2008,5,Professional Activity,0,1,3,1,0,5,0,0,0,0,0,0,0,1,3,1,0,5
BIHAR,2008,5,Agriculture (Total),0,15,21,21,5,62,0,4,1,0,0,5,0,19,22,21,5,67
BIHAR,2008,5,Retired Persons,0,0,0,0,9,9,0,0,0,0,6,6,0,0,0,0,15,15
BIHAR,2009,5,House Wife,0,0,0,0,0,0,0,124,154,29,7,314,0,124,154,29,7,314
BIHAR,2009,5,Service (Government),0,2,1,0,0,3,0,0,0,0,0,0,0,2,1,0,0,3
BIHAR,2009,5,Service (Private),0,17,35,3,0,55,0,2,0,0,0,2,0,19,35,3,0,57
BIHAR,2009,5,Public Sector Undertaking,0,1,7,0,0,8,0,0,0,0,0,0,0,1,7,0,0,8
BIHAR,2009,5,Students,7,31,4,0,0,42,5,19,2,0,0,26,12,50,6,0,0,68
BIHAR,2009,5,Unemployed,0,24,19,0,0,43,1,1,6,0,0,8,1,25,25,0,0,51
BIHAR,2009,5,Professional Activity,0,2,0,1,0,3,0,0,22,0,0,22,0,2,22,1,0,25
BIHAR,2009,5,Agriculture (Total),0,20,40,23,2,85,0,10,17,0,0,27,0,30,57,23,2,112
BIHAR,2009,5,Retired Persons,0,0,0,0,0,0,0,0,0,0,0,0,0,0,0,0,0,0
BIHAR,2010,5,House Wife,0,0,0,0,0,0,0,80,89,26,9,204,0,80,89,26,9,204
BIHAR,2010,5,Service (Government),0,6,5,2,0,13,0,2,6,0,0,8,0,8,11,2,0,21
BIHAR,2010,5,Service (Private),0,23,12,5,1,41,2,2,3,1,0,8,2,25,15,6,1,49
BIHAR,2010,5,Public Sector Undertaking,0,2,0,0,0,2,0,0,0,0,0,0,0,2,0,0,0,2
BIHAR,2010,5,Students,12,21,6,0,0,39,14,13,8,0,0,35,26,34,14,0,0,74
BIHAR,2010,5,Unemployed,0,36,28,9,0,73,3,3,6,3,0,15,3,39,34,12,0,88
BIHAR,2010,5,Professional Activity,0,2,2,1,0,5,0,0,0,0,0,0,0,2,2,1,0,5
BIHAR,2010,5,Agriculture (Total),0,27,39,20,5,91,0,3,1,0,0,4,0,30,40,20,5,95
BIHAR,2010,5,Retired Persons,0,0,0,0,1,1,0,0,0,0,2,2,0,0,0,0,3,3
BIHAR,2011,5,House Wife,0,0,0,0,0,0,0,71,55,9,3,138,0,71,55,9,3,138
BIHAR,2011,5,Service (Government),0,3,5,1,0,9,0,10,9,1,0,20,0,13,14,2,0,29
BIHAR,2011,5,Service (Private),0,2,3,3,1,9,0,0,0,0,0,0,0,2,3,3,1,9
BIHAR,2011,5,Public Sector Undertaking,0,1,1,1,0,3,0,0,0,0,0,0,0,1,1,1,0,3
BIHAR,2011,5,Students,5,27,4,0,0,36,5,28,2,0,0,35,10,55,6,0,0,71
BIHAR,2011,5,Unemployed,0,14,22,12,1,49,0,5,2,0,0,7,0,19,24,12,1,56
BIHAR,2011,5,Professional Activity,0,2,2,3,0,7,0,0,0,0,0,0,0,2,2,3,0,7
BIHAR,2011,5,Agriculture (Total),0,11,27,19,6,63,0,0,20,0,0,20,0,11,47,19,6,83
BIHAR,2011,5,Retired Persons,0,0,0,1,3,4,0,0,0,0,0,0,0,0,0,1,3,4
BIHAR,2012,5,House Wife,0,0,0,0,0,0,0,59,55,11,5,130,0,59,55,11,5,130
BIHAR,2012,5,Service (Government),0,0,2,10,0,12,0,1,2,0,0,3,0,1,4,10,0,15
BIHAR,2012,5,Service (Private),0,12,5,4,1,22,0,2,0,0,0,2,0,14,5,4,1,24
BIHAR,2012,5,Public Sector Undertaking,0,0,0,0,0,0,0,0,0,0,0,0,0,0,0,0,0,0
BIHAR,2012,5,Students,1,29,6,0,0,36,1,22,5,0,0,28,2,51,11,0,0,64
BIHAR,2012,5,Unemployed,0,3,9,1,0,13,0,0,0,1,0,1,0,3,9,2,0,14
BIHAR,2012,5,Professional Activity,0,1,0,0,0,1,0,0,0,0,0,0,0,1,0,0,0,1
BIHAR,2012,5,Agriculture (Total),0,20,30,9,5,64,0,4,0,0,0,4,0,24,30,9,5,68
BIHAR,2012,5,Retired Persons,0,0,0,0,1,1,0,0,0,0,0,0,0,0,0,0,1,1
BIHAR,2013,5,House Wife,0,0,0,0,0,0,0,55,93,18,2,168,0,55,93,18,2,168
BIHAR,2013,5,Service (Government),0,3,4,0,0,7,0,4,3,0,0,7,0,7,7,0,0,14
BIHAR,2013,5,Service (Private),0,18,20,14,0,52,0,11,8,3,0,22,0,29,28,17,0,74
BIHAR,2013,5,Public Sector Undertaking,0,0,0,0,0,0,0,0,0,0,0,0,0,0,0,0,0,0
BIHAR,2013,5,Students,18,22,6,0,0,46,12,20,4,0,0,36,30,42,10,0,0,82
BIHAR,2013,5,Unemployed,0,30,43,14,7,94,0,10,5,0,0,15,0,40,48,14,7,109
BIHAR,2013,5,Professional Activity,0,1,3,1,1,6,0,0,0,0,0,0,0,1,3,1,1,6
BIHAR,2013,5,Agriculture (Total),0,29,60,16,14,119,0,3,4,1,0,8,0,32,64,17,14,127
BIHAR,2013,5,Retired Persons,0,0,0,0,0,0,0,0,0,0,0,0,0,0,0,0,0,0
BIHAR,2014,5,House Wife,0,0,0,0,0,0,0,58,36,7,0,101,0,58,36,7,0,101
BIHAR,2014,5,Service (Government),0,4,1,3,0,8,0,4,0,1,0,5,0,8,1,4,0,13
BIHAR,2014,5,Service (Private),0,12,6,2,0,20,0,11,3,0,2,16,0,23,9,2,2,36
BIHAR,2014,5,Public Sector Undertaking,0,5,2,0,0,7,0,0,0,0,0,0,0,5,2,0,0,7
BIHAR,2014,5,Students,9,26,5,0,0,40,3,36,0,0,0,39,12,62,5,0,0,79
BIHAR,2014,5,Unemployed,0,25,22,4,2,53,0,6,3,0,0,9,0,31,25,4,2,62
BIHAR,2014,5,Agriculture (Total),0,5,2,3,0,10,0,0,0,0,0,0,0,5,2,3,0,10
BIHAR,2014,5,Retired Persons,0,0,0,1,0,1,0,0,0,0,0,0,0,0,0,1,0,1
CHANDIGARH,2001,6,House Wife,0,0,0,0,0,0,0,11,6,2,0,19,0,11,6,2,0,19
CHANDIGARH,2001,6,Service (Government),0,1,1,1,0,3,0,0,0,0,0,0,0,1,1,1,0,3
CHANDIGARH,2001,6,Service (Private),0,4,4,0,0,8,0,0,0,0,0,0,0,4,4,0,0,8
CHANDIGARH,2001,6,Public Sector Undertaking,0,0,0,0,0,0,0,0,0,0,0,0,0,0,0,0,0,0
CHANDIGARH,2001,6,Students,0,4,0,0,0,4,0,2,0,0,0,2,0,6,0,0,0,6
CHANDIGARH,2001,6,Unemployed,0,1,0,0,0,1,0,0,0,0,0,0,0,1,0,0,0,1
CHANDIGARH,2001,6,Professional Activity,0,0,0,0,0,0,0,0,0,0,0,0,0,0,0,0,0,0
CHANDIGARH,2001,6,Agriculture (Total),0,0,0,0,0,0,0,0,0,0,0,0,0,0,0,0,0,0
CHANDIGARH,2001,6,Retired Persons,0,0,0,0,1,1,0,0,0,0,0,0,0,0,0,0,1,1
CHANDIGARH,2002,6,House Wife,0,0,0,0,0,0,0,13,5,1,2,21,0,13,5,1,2,21
CHANDIGARH,2002,6,Service (Government),0,0,3,0,0,3,0,0,0,0,0,0,0,0,3,0,0,3
CHANDIGARH,2002,6,Service (Private),0,0,10,2,0,12,0,0,1,0,0,1,0,0,11,2,0,13
CHANDIGARH,2002,6,Public Sector Undertaking,0,0,0,0,0,0,0,0,0,0,0,0,0,0,0,0,0,0
CHANDIGARH,2002,6,Students,0,5,0,0,0,5,0,4,0,0,0,4,0,9,0,0,0,9
CHANDIGARH,2002,6,Unemployed,1,2,0,0,0,3,1,3,0,0,0,4,2,5,0,0,0,7
CHANDIGARH,2002,6,Professional Activity,0,0,0,0,0,0,0,0,0,0,0,0,0,0,0,0,0,0
CHANDIGARH,2002,6,Agriculture (Total),0,0,0,0,0,0,0,0,0,0,0,0,0,0,0,0,0,0
CHANDIGARH,2002,6,Retired Persons,0,0,0,0,0,0,0,0,0,0,0,0,0,0,0,0,0,0
CHANDIGARH,2003,6,House Wife,0,0,0,0,0,0,0,11,7,2,2,22,0,11,7,2,2,22
CHANDIGARH,2003,6,Service (Government),0,2,6,1,0,9,0,0,0,0,0,0,0,2,6,1,0,9
CHANDIGARH,2003,6,Service (Private),0,9,11,3,1,24,0,1,0,0,0,1,0,10,11,3,1,25
CHANDIGARH,2003,6,Public Sector Undertaking,0,0,0,0,0,0,0,0,0,0,0,0,0,0,0,0,0,0
CHANDIGARH,2003,6,Students,0,4,0,0,0,4,1,7,0,0,0,8,1,11,0,0,0,12
CHANDIGARH,2003,6,Unemployed,0,9,3,0,0,12,0,2,1,0,0,3,0,11,4,0,0,15
CHANDIGARH,2003,6,Professional Activity,0,1,1,0,0,2,0,0,0,0,0,0,0,1,1,0,0,2
CHANDIGARH,2003,6,Agriculture (Total),0,1,0,1,0,2,0,0,0,0,0,0,0,1,0,1,0,2
CHANDIGARH,2003,6,Retired Persons,0,0,0,1,1,2,0,0,0,0,0,0,0,0,0,1,1,2
CHANDIGARH,2004,6,House Wife,0,0,0,0,0,0,0,10,2,0,0,12,0,10,2,0,0,12
CHANDIGARH,2004,6,Service (Government),0,0,3,0,0,3,0,0,0,1,0,1,0,0,3,1,0,4
CHANDIGARH,2004,6,Service (Private),0,6,4,1,0,11,0,0,0,0,0,0,0,6,4,1,0,11
CHANDIGARH,2004,6,Public Sector Undertaking,0,0,0,0,0,0,0,0,0,0,0,0,0,0,0,0,0,0
CHANDIGARH,2004,6,Students,0,5,0,0,0,5,0,8,0,0,0,8,0,13,0,0,0,13
CHANDIGARH,2004,6,Unemployed,0,8,3,1,0,12,0,1,0,0,0,1,0,9,3,1,0,13
CHANDIGARH,2004,6,Professional Activity,0,0,0,1,0,1,0,0,0,0,0,0,0,0,0,1,0,1
CHANDIGARH,2004,6,Agriculture (Total),0,0,0,0,0,0,0,0,0,0,0,0,0,0,0,0,0,0
CHANDIGARH,2004,6,Retired Persons,0,0,0,0,0,0,0,0,0,0,0,0,0,0,0,0,0,0
CHANDIGARH,2005,6,House Wife,0,0,0,0,0,0,0,6,5,3,0,14,0,6,5,3,0,14
CHANDIGARH,2005,6,Service (Government),0,1,0,1,0,2,0,0,0,1,0,1,0,1,0,2,0,3
CHANDIGARH,2005,6,Service (Private),0,5,6,6,0,17,0,1,0,0,0,1,0,6,6,6,0,18
CHANDIGARH,2005,6,Public Sector Undertaking,0,0,5,0,0,5,0,0,0,0,0,0,0,0,5,0,0,5
CHANDIGARH,2005,6,Students,1,2,0,0,0,3,0,3,0,0,0,3,1,5,0,0,0,6
CHANDIGARH,2005,6,Unemployed,0,12,3,0,0,15,0,2,0,0,0,2,0,14,3,0,0,17
CHANDIGARH,2005,6,Professional Activity,0,0,0,0,0,0,0,0,0,0,0,0,0,0,0,0,0,0
CHANDIGARH,2005,6,Agriculture (Total),0,0,0,0,0,0,0,0,0,0,0,0,0,0,0,0,0,0
CHANDIGARH,2005,6,Retired Persons,0,0,0,0,0,0,0,0,0,0,0,0,0,0,0,0,0,0
CHANDIGARH,2006,6,House Wife,0,0,0,0,0,0,0,3,6,1,1,11,0,3,6,1,1,11
CHANDIGARH,2006,6,Service (Government),0,2,3,2,0,7,0,0,0,0,0,0,0,2,3,2,0,7
CHANDIGARH,2006,6,Service (Private),0,5,8,0,0,13,0,2,0,0,0,2,0,7,8,0,0,15
CHANDIGARH,2006,6,Public Sector Undertaking,0,0,0,0,0,0,0,0,0,0,0,0,0,0,0,0,0,0
CHANDIGARH,2006,6,Students,0,11,0,0,0,11,2,7,0,0,0,9,2,18,0,0,0,20
CHANDIGARH,2006,6,Unemployed,0,7,15,1,0,23,0,2,0,0,0,2,0,9,15,1,0,25
CHANDIGARH,2006,6,Professional Activity,0,0,0,0,0,0,0,0,0,0,0,0,0,0,0,0,0,0
CHANDIGARH,2006,6,Agriculture (Total),0,1,0,0,0,1,0,0,0,0,0,0,0,1,0,0,0,1
CHANDIGARH,2006,6,Retired Persons,0,0,0,0,0,0,0,0,0,0,0,0,0,0,0,0,0,0
CHANDIGARH,2007,6,House Wife,0,0,0,0,0,0,0,10,8,1,2,21,0,10,8,1,2,21
CHANDIGARH,2007,6,Service (Government),0,0,3,1,0,4,0,1,0,0,0,1,0,1,3,1,0,5
CHANDIGARH,2007,6,Service (Private),0,3,10,4,0,17,0,0,0,0,0,0,0,3,10,4,0,17
CHANDIGARH,2007,6,Public Sector Undertaking,0,0,0,0,0,0,0,0,0,0,0,0,0,0,0,0,0,0
CHANDIGARH,2007,6,Students,2,13,0,0,0,15,0,0,0,0,0,0,2,13,0,0,0,15
CHANDIGARH,2007,6,Unemployed,0,6,2,2,0,10,0,0,0,0,0,0,0,6,2,2,0,10
CHANDIGARH,2007,6,Professional Activity,0,0,0,0,0,0,0,0,0,0,0,0,0,0,0,0,0,0
CHANDIGARH,2007,6,Agriculture (Total),0,0,0,0,0,0,0,0,0,0,0,0,0,0,0,0,0,0
CHANDIGARH,2007,6,Retired Persons,0,0,0,0,2,2,0,0,0,0,0,0,0,0,0,0,2,2
CHANDIGARH,2008,6,House Wife,0,0,0,0,0,0,0,8,7,2,0,17,0,8,7,2,0,17
CHANDIGARH,2008,6,Service (Government),0,0,2,1,0,3,0,0,0,0,0,0,0,0,2,1,0,3
CHANDIGARH,2008,6,Service (Private),0,4,7,4,0,15,0,3,0,0,0,3,0,7,7,4,0,18
CHANDIGARH,2008,6,Public Sector Undertaking,0,0,0,0,0,0,0,0,0,0,0,0,0,0,0,0,0,0
CHANDIGARH,2008,6,Students,0,6,0,0,0,6,0,5,0,0,0,5,0,11,0,0,0,11
CHANDIGARH,2008,6,Unemployed,0,10,7,6,0,23,0,0,0,0,0,0,0,10,7,6,0,23
CHANDIGARH,2008,6,Professional Activity,0,0,0,1,0,1,0,0,0,0,0,0,0,0,0,1,0,1
CHANDIGARH,2008,6,Agriculture (Total),0,0,0,0,0,0,0,0,0,0,0,0,0,0,0,0,0,0
CHANDIGARH,2008,6,Retired Persons,0,0,0,1,1,2,0,0,0,0,0,0,0,0,0,1,1,2
CHANDIGARH,2009,6,House Wife,0,0,0,0,0,0,0,6,8,1,2,17,0,6,8,1,2,17
CHANDIGARH,2009,6,Service (Government),0,0,4,3,0,7,0,0,0,0,0,0,0,0,4,3,0,7
CHANDIGARH,2009,6,Service (Private),0,0,3,2,0,5,0,0,1,0,0,1,0,0,4,2,0,6
CHANDIGARH,2009,6,Public Sector Undertaking,0,5,6,1,0,12,0,0,0,0,0,0,0,5,6,1,0,12
CHANDIGARH,2009,6,Students,0,6,0,0,0,6,1,11,0,0,0,12,1,17,0,0,0,18
CHANDIGARH,2009,6,Unemployed,0,3,3,1,0,7,0,0,0,0,0,0,0,3,3,1,0,7
CHANDIGARH,2009,6,Professional Activity,0,0,1,0,0,1,0,0,0,0,0,0,0,0,1,0,0,1
CHANDIGARH,2009,6,Agriculture (Total),0,0,0,0,0,0,0,0,0,0,0,0,0,0,0,0,0,0
CHANDIGARH,2009,6,Retired Persons,0,0,0,0,1,1,0,0,0,0,0,0,0,0,0,0,1,1
CHANDIGARH,2010,6,House Wife,0,0,0,0,0,0,0,6,10,2,1,19,0,6,10,2,1,19
CHANDIGARH,2010,6,Service (Government),0,1,2,0,0,3,0,1,0,0,0,1,0,2,2,0,0,4
CHANDIGARH,2010,6,Service (Private),0,4,4,2,0,10,0,0,0,0,0,0,0,4,4,2,0,10
CHANDIGARH,2010,6,Public Sector Undertaking,0,1,0,1,0,2,0,0,0,0,0,0,0,1,0,1,0,2
CHANDIGARH,2010,6,Students,0,4,0,0,0,4,1,9,0,0,0,10,1,13,0,0,0,14
CHANDIGARH,2010,6,Unemployed,0,4,1,0,0,5,0,3,0,0,0,3,0,7,1,0,0,8
CHANDIGARH,2010,6,Professional Activity,0,0,0,0,0,0,0,0,0,0,0,0,0,0,0,0,0,0
CHANDIGARH,2010,6,Agriculture (Total),0,0,0,0,0,0,0,0,0,0,0,0,0,0,0,0,0,0
CHANDIGARH,2010,6,Retired Persons,0,0,0,0,1,1,0,0,0,0,0,0,0,0,0,0,1,1
CHANDIGARH,2011,6,House Wife,0,0,0,0,0,0,0,13,13,2,0,28,0,13,13,2,0,28
CHANDIGARH,2011,6,Service (Government),0,0,1,2,0,3,0,0,0,0,0,0,0,0,1,2,0,3
CHANDIGARH,2011,6,Service (Private),0,2,8,7,0,17,0,2,0,1,0,3,0,4,8,8,0,20
CHANDIGARH,2011,6,Public Sector Undertaking,0,0,0,0,0,0,0,0,0,0,0,0,0,0,0,0,0,0
CHANDIGARH,2011,6,Students,0,4,0,0,0,4,0,10,0,0,0,10,0,14,0,0,0,14
CHANDIGARH,2011,6,Unemployed,0,8,1,1,0,10,0,2,0,0,0,2,0,10,1,1,0,12
CHANDIGARH,2011,6,Professional Activity,0,0,0,0,0,0,0,0,0,0,0,0,0,0,0,0,0,0
CHANDIGARH,2011,6,Agriculture (Total),0,0,0,0,0,0,0,0,0,0,0,0,0,0,0,0,0,0
CHANDIGARH,2011,6,Retired Persons,0,0,0,0,0,0,0,0,0,0,0,0,0,0,0,0,0,0
CHANDIGARH,2012,6,House Wife,0,0,0,0,0,0,0,9,8,0,1,18,0,9,8,0,1,18
CHANDIGARH,2012,6,Service (Government),0,1,5,2,0,8,0,0,0,0,0,0,0,1,5,2,0,8
CHANDIGARH,2012,6,Service (Private),0,12,13,3,0,28,0,1,0,0,0,1,0,13,13,3,0,29
CHANDIGARH,2012,6,Public Sector Undertaking,0,1,2,1,0,4,0,1,0,0,0,1,0,2,2,1,0,5
CHANDIGARH,2012,6,Students,2,3,0,0,0,5,1,11,0,0,0,12,3,14,0,0,0,17
CHANDIGARH,2012,6,Unemployed,0,9,3,0,0,12,0,1,0,0,0,1,0,10,3,0,0,13
CHANDIGARH,2012,6,Professional Activity,0,0,0,0,0,0,0,0,0,0,0,0,0,0,0,0,0,0
CHANDIGARH,2012,6,Agriculture (Total),0,0,0,0,0,0,0,0,0,0,0,0,0,0,0,0,0,0
CHANDIGARH,2012,6,Retired Persons,0,0,0,0,0,0,0,0,0,0,0,0,0,0,0,0,0,0
CHANDIGARH,2013,6,House Wife,0,0,0,0,0,0,0,10,9,2,0,21,0,10,9,2,0,21
CHANDIGARH,2013,6,Service (Government),0,0,0,3,0,3,0,0,0,0,0,0,0,0,0,3,0,3
CHANDIGARH,2013,6,Service (Private),0,10,11,6,2,29,0,0,0,0,0,0,0,10,11,6,2,29
CHANDIGARH,2013,6,Public Sector Undertaking,0,0,3,0,0,3,0,0,0,0,0,0,0,0,3,0,0,3
CHANDIGARH,2013,6,Students,0,8,0,0,0,8,1,14,0,0,0,15,1,22,0,0,0,23
CHANDIGARH,2013,6,Unemployed,0,2,0,0,0,2,0,0,0,0,0,0,0,2,0,0,0,2
CHANDIGARH,2013,6,Professional Activity,0,0,0,0,0,0,0,0,0,0,0,0,0,0,0,0,0,0
CHANDIGARH,2013,6,Agriculture (Total),0,0,0,0,0,0,0,0,0,0,0,0,0,0,0,0,0,0
CHANDIGARH,2013,6,Retired Persons,0,0,0,0,0,0,0,0,0,0,0,0,0,0,0,0,0,0
CHANDIGARH,2014,6,House Wife,0,0,0,0,0,0,0,5,6,3,0,14,0,5,6,3,0,14
CHANDIGARH,2014,6,Service (Government),0,0,0,2,0,2,0,0,0,0,0,0,0,0,0,2,0,2
CHANDIGARH,2014,6,Service (Private),0,0,12,6,0,18,0,11,0,0,0,11,0,11,12,6,0,29
CHANDIGARH,2014,6,Public Sector Undertaking,0,0,0,0,0,0,0,0,0,0,0,0,0,0,0,0,0,0
CHANDIGARH,2014,6,Students,0,17,0,0,0,17,0,10,0,0,0,10,0,27,0,0,0,27
CHANDIGARH,2014,6,Unemployed,0,7,8,0,0,15,0,2,2,0,0,4,0,9,10,0,0,19
CHANDIGARH,2014,6,Agriculture (Total),0,0,0,0,0,0,0,0,0,0,0,0,0,0,0,0,0,0
CHANDIGARH,2014,6,Retired Persons,0,0,0,3,1,4,0,0,0,0,0,0,0,0,0,3,1,4
CHHATTISGARH,2001,7,House Wife,0,0,0,0,0,0,3,301,202,74,26,606,3,301,202,74,26,606
CHHATTISGARH,2001,7,Service (Government),0,11,36,15,1,63,0,4,2,1,0,7,0,15,38,16,1,70
CHHATTISGARH,2001,7,Service (Private),0,47,81,33,6,167,1,6,2,1,0,10,1,53,83,34,6,177
CHHATTISGARH,2001,7,Public Sector Undertaking,0,9,31,16,3,59,0,2,3,1,0,6,0,11,34,17,3,65
CHHATTISGARH,2001,7,Students,17,100,17,0,0,134,23,69,3,0,0,95,40,169,20,0,0,229
CHHATTISGARH,2001,7,Unemployed,0,100,69,17,7,193,0,19,6,0,0,25,0,119,75,17,7,218
CHHATTISGARH,2001,7,Professional Activity,0,12,14,4,2,32,0,2,2,0,0,4,0,14,16,4,2,36
CHHATTISGARH,2001,7,Agriculture (Total),8,286,429,302,173,1198,5,81,92,51,25,254,13,367,521,353,198,1452
CHHATTISGARH,2001,7,Retired Persons,0,8,3,0,2,13,0,0,0,0,0,0,0,8,3,0,2,13
CHHATTISGARH,2002,7,House Wife,0,0,0,0,0,0,2,271,210,76,26,585,2,271,210,76,26,585
CHHATTISGARH,2002,7,Service (Government),0,6,34,12,0,52,0,5,7,0,0,12,0,11,41,12,0,64
CHHATTISGARH,2002,7,Service (Private),1,29,56,23,1,110,0,6,5,0,3,14,1,35,61,23,4,124
CHHATTISGARH,2002,7,Public Sector Undertaking,0,17,33,22,9,81,0,3,5,2,0,10,0,20,38,24,9,91
CHHATTISGARH,2002,7,Students,29,87,4,2,0,122,18,51,0,0,0,69,47,138,4,2,0,191
CHHATTISGARH,2002,7,Unemployed,1,97,59,18,4,179,0,25,8,0,0,33,1,122,67,18,4,212
CHHATTISGARH,2002,7,Professional Activity,0,17,13,9,2,41,0,9,2,0,0,11,0,26,15,9,2,52
CHHATTISGARH,2002,7,Agriculture (Total),8,311,357,296,82,1054,0,74,61,40,9,184,8,385,418,336,91,1238
CHHATTISGARH,2002,7,Retired Persons,0,0,0,0,7,7,0,0,0,0,0,0,0,0,0,0,7,7
CHHATTISGARH,2003,7,House Wife,0,0,0,0,0,0,3,248,187,80,33,551,3,248,187,80,33,551
CHHATTISGARH,2003,7,Service (Government),0,10,27,17,0,54,0,1,2,0,0,3,0,11,29,17,0,57
CHHATTISGARH,2003,7,Service (Private),0,36,39,27,3,105,0,7,5,3,0,15,0,43,44,30,3,120
CHHATTISGARH,2003,7,Public Sector Undertaking,0,6,14,6,0,26,0,0,0,0,0,0,0,6,14,6,0,26
CHHATTISGARH,2003,7,Students,31,88,6,0,0,125,19,61,0,0,0,80,50,149,6,0,0,205
CHHATTISGARH,2003,7,Unemployed,7,85,56,12,0,160,1,12,7,4,0,24,8,97,63,16,0,184
CHHATTISGARH,2003,7,Professional Activity,1,32,43,19,2,97,0,13,14,3,1,31,1,45,57,22,3,128
CHHATTISGARH,2003,7,Agriculture (Total),11,230,309,220,89,859,28,104,55,17,3,207,39,334,364,237,92,1066
CHHATTISGARH,2003,7,Retired Persons,0,0,1,1,2,4,0,0,0,0,0,0,0,0,1,1,2,4
CHHATTISGARH,2004,7,House Wife,0,0,0,0,0,0,1,358,264,114,40,777,1,358,264,114,40,777
CHHATTISGARH,2004,7,Service (Government),0,7,17,10,1,35,0,1,1,0,0,2,0,8,18,10,1,37
CHHATTISGARH,2004,7,Service (Private),0,25,31,22,2,80,0,0,0,2,0,2,0,25,31,24,2,82
CHHATTISGARH,2004,7,Public Sector Undertaking,0,3,7,5,0,15,0,1,0,0,0,1,0,4,7,5,0,16
CHHATTISGARH,2004,7,Students,20,112,6,0,0,138,27,61,0,0,0,88,47,173,6,0,0,226
CHHATTISGARH,2004,7,Unemployed,5,97,55,4,0,161,0,2,1,0,0,3,5,99,56,4,0,164
CHHATTISGARH,2004,7,Professional Activity,0,9,20,14,4,47,0,4,1,0,1,6,0,13,21,14,5,53
CHHATTISGARH,2004,7,Agriculture (Total),3,312,475,303,120,1213,0,64,56,44,18,182,3,376,531,347,138,1395
CHHATTISGARH,2004,7,Retired Persons,0,0,0,0,0,0,0,0,0,0,0,0,0,0,0,0,0,0
CHHATTISGARH,2005,7,House Wife,0,0,0,0,0,0,8,433,283,115,52,891,8,433,283,115,52,891
CHHATTISGARH,2005,7,Service (Government),0,27,18,12,1,58,0,3,1,1,1,6,0,30,19,13,2,64
CHHATTISGARH,2005,7,Service (Private),14,48,64,44,8,178,2,6,7,2,0,17,16,54,71,46,8,195
CHHATTISGARH,2005,7,Public Sector Undertaking,0,20,11,2,0,33,0,9,3,3,0,15,0,29,14,5,0,48
CHHATTISGARH,2005,7,Students,19,91,6,0,0,116,21,46,5,0,0,72,40,137,11,0,0,188
CHHATTISGARH,2005,7,Unemployed,17,139,50,17,5,228,3,10,7,4,1,25,20,149,57,21,6,253
CHHATTISGARH,2005,7,Professional Activity,13,33,50,27,8,131,1,4,2,2,0,9,14,37,52,29,8,140
CHHATTISGARH,2005,7,Agriculture (Total),6,301,490,309,94,1200,0,81,76,44,11,212,6,382,566,353,105,1412
CHHATTISGARH,2005,7,Retired Persons,0,7,1,0,3,11,0,0,0,0,1,1,0,7,1,0,4,12
CHHATTISGARH,2006,7,House Wife,0,0,0,0,0,0,3,393,248,83,45,772,3,393,248,83,45,772
CHHATTISGARH,2006,7,Service (Government),0,6,13,11,1,31,0,1,2,1,0,4,0,7,15,12,1,35
CHHATTISGARH,2006,7,Service (Private),0,24,60,43,0,127,0,4,5,0,0,9,0,28,65,43,0,136
CHHATTISGARH,2006,7,Public Sector Undertaking,0,0,14,2,0,16,0,0,1,0,0,1,0,0,15,2,0,17
CHHATTISGARH,2006,7,Students,23,84,0,0,0,107,16,69,0,0,0,85,39,153,0,0,0,192
CHHATTISGARH,2006,7,Unemployed,0,93,41,10,0,144,1,5,1,1,0,8,1,98,42,11,0,152
CHHATTISGARH,2006,7,Professional Activity,1,25,38,13,6,83,0,0,0,0,0,0,1,25,38,13,6,83
CHHATTISGARH,2006,7,Agriculture (Total),6,377,481,245,103,1212,20,115,83,41,12,271,26,492,564,286,115,1483
CHHATTISGARH,2006,7,Retired Persons,0,0,0,0,1,1,0,0,0,0,0,0,0,0,0,0,1,1
CHHATTISGARH,2007,7,House Wife,0,0,0,0,0,0,3,423,270,106,46,848,3,423,270,106,46,848
CHHATTISGARH,2007,7,Service (Government),0,9,12,13,0,34,0,1,3,0,0,4,0,10,15,13,0,38
CHHATTISGARH,2007,7,Service (Private),0,74,83,51,5,213,0,9,9,2,0,20,0,83,92,53,5,233
CHHATTISGARH,2007,7,Public Sector Undertaking,0,8,11,3,0,22,0,1,1,0,0,2,0,9,12,3,0,24
CHHATTISGARH,2007,7,Students,32,94,46,0,0,172,26,78,3,0,0,107,58,172,49,0,0,279
CHHATTISGARH,2007,7,Unemployed,0,119,43,11,4,177,1,9,4,0,0,14,1,128,47,11,4,191
CHHATTISGARH,2007,7,Professional Activity,0,31,43,18,11,103,0,2,2,1,1,6,0,33,45,19,12,109
CHHATTISGARH,2007,7,Agriculture (Total),2,359,458,310,135,1264,5,136,96,78,14,329,7,495,554,388,149,1593
CHHATTISGARH,2007,7,Retired Persons,0,0,0,1,1,2,0,0,0,0,0,0,0,0,0,1,1,2
CHHATTISGARH,2008,7,House Wife,0,0,0,0,0,0,2,499,275,125,36,937,2,499,275,125,36,937
CHHATTISGARH,2008,7,Service (Government),0,9,17,13,0,39,0,6,0,0,0,6,0,15,17,13,0,45
CHHATTISGARH,2008,7,Service (Private),0,71,77,29,6,183,0,9,6,3,0,18,0,80,83,32,6,201
CHHATTISGARH,2008,7,Public Sector Undertaking,0,1,6,3,0,10,0,0,0,0,0,0,0,1,6,3,0,10
CHHATTISGARH,2008,7,Students,37,162,2,1,0,202,35,130,3,0,0,168,72,292,5,1,0,370
CHHATTISGARH,2008,7,Unemployed,0,86,65,16,0,167,0,6,2,2,0,10,0,92,67,18,0,177
CHHATTISGARH,2008,7,Professional Activity,0,27,26,19,8,80,0,0,11,2,0,13,0,27,37,21,8,93
CHHATTISGARH,2008,7,Agriculture (Total),9,436,576,346,124,1491,20,101,107,46,8,282,29,537,683,392,132,1773
CHHATTISGARH,2008,7,Retired Persons,0,0,0,2,0,2,0,0,0,0,0,0,0,0,0,2,0,2
CHHATTISGARH,2009,7,House Wife,0,0,0,0,0,0,4,466,299,99,34,902,4,466,299,99,34,902
CHHATTISGARH,2009,7,Service (Government),0,19,14,9,0,42,0,5,1,0,0,6,0,24,15,9,0,48
CHHATTISGARH,2009,7,Service (Private),0,89,101,54,5,249,0,31,11,3,0,45,0,120,112,57,5,294
CHHATTISGARH,2009,7,Public Sector Undertaking,0,5,7,5,0,17,0,0,0,0,0,0,0,5,7,5,0,17
CHHATTISGARH,2009,7,Students,59,228,11,0,0,298,33,99,5,0,0,137,92,327,16,0,0,435
CHHATTISGARH,2009,7,Unemployed,4,159,204,87,7,461,4,5,18,1,0,28,8,164,222,88,7,489
CHHATTISGARH,2009,7,Professional Activity,0,33,56,39,3,131,0,3,2,1,0,6,0,36,58,40,3,137
CHHATTISGARH,2009,7,Agriculture (Total),9,364,496,412,136,1417,3,144,115,97,26,385,12,508,611,509,162,1802
CHHATTISGARH,2009,7,Retired Persons,0,0,0,0,6,6,0,0,0,0,3,3,0,0,0,0,9,9
CHHATTISGARH,2010,7,House Wife,0,0,0,0,0,0,2,453,286,91,30,862,2,453,286,91,30,862
CHHATTISGARH,2010,7,Service (Government),0,8,16,14,0,38,0,1,0,1,0,2,0,9,16,15,0,40
CHHATTISGARH,2010,7,Service (Private),0,127,103,55,2,287,0,22,18,2,2,44,0,149,121,57,4,331
CHHATTISGARH,2010,7,Public Sector Undertaking,0,16,13,15,0,44,0,0,0,0,0,0,0,16,13,15,0,44
CHHATTISGARH,2010,7,Students,47,166,9,1,0,223,24,125,5,0,0,154,71,291,14,1,0,377
CHHATTISGARH,2010,7,Unemployed,4,177,306,104,2,593,2,13,4,0,0,19,6,190,310,104,2,612
CHHATTISGARH,2010,7,Professional Activity,0,86,95,40,10,231,0,2,1,1,0,4,0,88,96,41,10,235
CHHATTISGARH,2010,7,Agriculture (Total),3,196,274,219,86,778,2,65,137,103,41,348,5,261,411,322,127,1126
CHHATTISGARH,2010,7,Retired Persons,0,0,0,0,1,1,0,0,0,0,0,0,0,0,0,0,1,1
CHHATTISGARH,2011,7,House Wife,0,0,0,0,0,0,3,384,239,121,28,775,3,384,239,121,28,775
CHHATTISGARH,2011,7,Service (Government),0,19,21,5,1,46,1,4,3,0,0,8,1,23,24,5,1,54
CHHATTISGARH,2011,7,Service (Private),2,135,120,59,5,321,2,42,31,8,6,89,4,177,151,67,11,410
CHHATTISGARH,2011,7,Public Sector Undertaking,0,12,20,29,0,61,0,3,6,2,0,11,0,15,26,31,0,72
CHHATTISGARH,2011,7,Students,40,152,9,0,0,201,31,130,0,0,0,161,71,282,9,0,0,362
CHHATTISGARH,2011,7,Unemployed,3,182,246,146,15,592,0,18,11,3,2,34,3,200,257,149,17,626
CHHATTISGARH,2011,7,Professional Activity,0,64,51,32,7,154,0,34,16,6,0,56,0,98,67,38,7,210
CHHATTISGARH,2011,7,Agriculture (Total),0,0,0,0,0,0,0,0,0,0,0,0,0,0,0,0,0,0
CHHATTISGARH,2011,7,Retired Persons,0,5,3,4,7,19,0,0,0,0,0,0,0,5,3,4,7,19
CHHATTISGARH,2012,7,House Wife,0,0,0,0,0,0,0,353,262,125,39,779,0,353,262,125,39,779
CHHATTISGARH,2012,7,Service (Government),0,6,22,34,0,62,0,3,1,0,0,4,0,9,23,34,0,66
CHHATTISGARH,2012,7,Service (Private),4,133,109,85,20,351,2,25,18,9,1,55,6,158,127,94,21,406
CHHATTISGARH,2012,7,Public Sector Undertaking,0,0,4,6,0,10,0,0,0,0,0,0,0,0,4,6,0,10
CHHATTISGARH,2012,7,Students,13,145,3,0,0,161,25,103,1,0,0,129,38,248,4,0,0,290
CHHATTISGARH,2012,7,Unemployed,0,108,131,94,8,341,0,11,3,2,2,18,0,119,134,96,10,359
CHHATTISGARH,2012,7,Professional Activity,0,72,75,63,19,229,0,0,0,0,0,0,0,72,75,63,19,229
CHHATTISGARH,2012,7,Agriculture (Total),0,1,2,1,0,4,0,0,0,0,0,0,0,1,2,1,0,4
CHHATTISGARH,2012,7,Retired Persons,0,0,0,6,11,17,0,0,0,0,0,0,0,0,0,6,11,17
CHHATTISGARH,2013,7,House Wife,0,0,0,0,0,0,2,458,275,118,44,897,2,458,275,118,44,897
CHHATTISGARH,2013,7,Service (Government),0,3,9,6,0,18,0,3,0,0,0,3,0,6,9,6,0,21
CHHATTISGARH,2013,7,Service (Private),1,69,88,30,8,196,1,9,11,9,4,34,2,78,99,39,12,230
CHHATTISGARH,2013,7,Public Sector Undertaking,0,14,14,13,0,41,0,0,0,0,0,0,0,14,14,13,0,41
CHHATTISGARH,2013,7,Students,35,130,3,0,0,168,42,149,0,0,0,191,77,279,3,0,0,359
CHHATTISGARH,2013,7,Unemployed,1,100,85,22,0,208,0,4,1,1,0,6,1,104,86,23,0,214
CHHATTISGARH,2013,7,Professional Activity,0,58,79,33,3,173,0,2,2,0,0,4,0,60,81,33,3,177
CHHATTISGARH,2013,7,Agriculture (Total),0,0,0,0,0,0,0,0,0,0,0,0,0,0,0,0,0,0
CHHATTISGARH,2013,7,Retired Persons,0,0,32,32,19,83,0,0,11,8,2,21,0,0,43,40,21,104
CHHATTISGARH,2014,7,House Wife,0,0,0,0,0,0,0,474,320,140,48,982,0,474,320,140,48,982
CHHATTISGARH,2014,7,Service (Government),1,33,33,31,6,104,0,4,4,0,0,8,1,37,37,31,6,112
CHHATTISGARH,2014,7,Service (Private),0,43,52,34,2,131,0,9,7,0,0,16,0,52,59,34,2,147
CHHATTISGARH,2014,7,Public Sector Undertaking,0,3,10,8,0,21,0,0,0,0,0,0,0,3,10,8,0,21
CHHATTISGARH,2014,7,Students,35,180,6,1,0,222,25,168,0,0,1,194,60,348,6,1,1,416
CHHATTISGARH,2014,7,Unemployed,0,189,93,21,3,306,0,14,1,1,1,17,0,203,94,22,4,323
CHHATTISGARH,2014,7,Agriculture (Total),1,185,230,195,37,648,0,52,35,12,8,107,1,237,265,207,45,755
CHHATTISGARH,2014,7,Retired Persons,0,0,0,2,6,8,0,0,0,0,0,0,0,0,0,2,6,8
D & N HAVELI,2001,8,House Wife,0,0,0,0,0,0,1,9,3,0,0,13,1,9,3,0,0,13
D & N HAVELI,2001,8,Service (Government),0,0,0,0,0,0,0,0,0,0,0,0,0,0,0,0,0,0
D & N HAVELI,2001,8,Service (Private),0,1,3,1,0,5,0,0,0,0,0,0,0,1,3,1,0,5
D & N HAVELI,2001,8,Public Sector Undertaking,0,0,0,0,0,0,0,0,0,0,0,0,0,0,0,0,0,0
D & N HAVELI,2001,8,Students,0,0,0,0,0,0,0,0,0,0,0,0,0,0,0,0,0,0
D & N HAVELI,2001,8,Unemployed,0,5,3,0,0,8,0,0,0,0,0,0,0,5,3,0,0,8
D & N HAVELI,2001,8,Professional Activity,0,0,0,0,0,0,0,0,0,0,0,0,0,0,0,0,0,0
D & N HAVELI,2001,8,Agriculture (Total),0,4,4,3,8,19,0,0,0,0,0,0,0,4,4,3,8,19
D & N HAVELI,2001,8,Retired Persons,0,0,0,0,0,0,0,0,0,0,0,0,0,0,0,0,0,0
D & N HAVELI,2002,8,House Wife,0,0,0,0,0,0,0,9,2,2,2,15,0,9,2,2,2,15
D & N HAVELI,2002,8,Service (Government),0,1,0,0,0,1,0,0,0,0,0,0,0,1,0,0,0,1
D & N HAVELI,2002,8,Service (Private),0,2,0,2,0,4,0,0,0,0,0,0,0,2,0,2,0,4
D & N HAVELI,2002,8,Public Sector Undertaking,0,0,0,0,0,0,0,0,0,0,0,0,0,0,0,0,0,0
D & N HAVELI,2002,8,Students,1,0,0,0,0,1,0,2,1,0,0,3,1,2,1,0,0,4
D & N HAVELI,2002,8,Unemployed,0,0,0,0,0,0,0,0,0,0,0,0,0,0,0,0,0,0
D & N HAVELI,2002,8,Professional Activity,0,0,0,0,0,0,0,0,0,0,0,0,0,0,0,0,0,0
D & N HAVELI,2002,8,Agriculture (Total),0,4,5,7,5,21,0,0,0,0,0,0,0,4,5,7,5,21
D & N HAVELI,2002,8,Retired Persons,0,0,0,0,0,0,0,0,0,0,0,0,0,0,0,0,0,0
D & N HAVELI,2003,8,House Wife,0,0,0,0,0,0,0,5,7,9,0,21,0,5,7,9,0,21
D & N HAVELI,2003,8,Service (Government),0,0,1,0,0,1,0,0,0,0,0,0,0,0,1,0,0,1
D & N HAVELI,2003,8,Service (Private),0,0,4,0,0,4,0,0,0,0,0,0,0,0,4,0,0,4
D & N HAVELI,2003,8,Public Sector Undertaking,0,0,0,0,0,0,0,0,0,0,0,0,0,0,0,0,0,0
D & N HAVELI,2003,8,Students,1,0,0,0,0,1,0,1,0,0,0,1,1,1,0,0,0,2
D & N HAVELI,2003,8,Unemployed,0,0,0,0,0,0,0,0,0,0,0,0,0,0,0,0,0,0
D & N HAVELI,2003,8,Professional Activity,0,0,0,0,0,0,0,0,0,0,0,0,0,0,0,0,0,0
D & N HAVELI,2003,8,Agriculture (Total),0,8,3,7,5,23,0,0,0,0,0,0,0,8,3,7,5,23
D & N HAVELI,2003,8,Retired Persons,0,0,0,0,0,0,0,0,0,0,0,0,0,0,0,0,0,0
D & N HAVELI,2004,8,House Wife,0,0,0,0,0,0,0,9,5,1,1,16,0,9,5,1,1,16
D & N HAVELI,2004,8,Service (Government),0,0,0,0,0,0,0,0,0,0,0,0,0,0,0,0,0,0
D & N HAVELI,2004,8,Service (Private),0,2,1,1,0,4,0,1,0,0,0,1,0,3,1,1,0,5
D & N HAVELI,2004,8,Public Sector Undertaking,0,0,0,0,0,0,0,0,0,0,0,0,0,0,0,0,0,0
D & N HAVELI,2004,8,Students,0,0,0,0,0,0,0,2,0,0,0,2,0,2,0,0,0,2
D & N HAVELI,2004,8,Unemployed,0,2,1,0,0,3,0,0,0,0,0,0,0,2,1,0,0,3
D & N HAVELI,2004,8,Professional Activity,0,0,0,0,0,0,0,0,0,0,0,0,0,0,0,0,0,0
D & N HAVELI,2004,8,Agriculture (Total),0,2,2,2,1,7,0,0,0,0,0,0,0,2,2,2,1,7
D & N HAVELI,2004,8,Retired Persons,0,0,0,0,0,0,0,0,0,0,0,0,0,0,0,0,0,0
D & N HAVELI,2005,8,House Wife,0,0,0,0,0,0,0,7,7,7,1,22,0,7,7,7,1,22
D & N HAVELI,2005,8,Service (Government),0,0,0,0,0,0,0,2,1,0,0,3,0,2,1,0,0,3
D & N HAVELI,2005,8,Service (Private),0,3,1,0,0,4,0,0,0,0,0,0,0,3,1,0,0,4
D & N HAVELI,2005,8,Public Sector Undertaking,0,0,0,0,0,0,0,0,0,0,0,0,0,0,0,0,0,0
D & N HAVELI,2005,8,Students,0,0,0,0,0,0,0,0,0,0,0,0,0,0,0,0,0,0
D & N HAVELI,2005,8,Unemployed,0,1,1,0,0,2,0,0,0,0,0,0,0,1,1,0,0,2
D & N HAVELI,2005,8,Professional Activity,0,0,0,0,0,0,0,0,0,0,0,0,0,0,0,0,0,0
D & N HAVELI,2005,8,Agriculture (Total),0,3,6,4,0,13,0,0,0,0,0,0,0,3,6,4,0,13
D & N HAVELI,2005,8,Retired Persons,0,0,0,0,0,0,0,0,0,0,0,0,0,0,0,0,0,0
D & N HAVELI,2006,8,House Wife,0,0,0,0,0,0,0,7,6,2,2,17,0,7,6,2,2,17
D & N HAVELI,2006,8,Service (Government),0,0,0,0,0,0,0,0,0,0,0,0,0,0,0,0,0,0
D & N HAVELI,2006,8,Service (Private),0,2,0,0,1,3,0,0,0,0,0,0,0,2,0,0,1,3
D & N HAVELI,2006,8,Public Sector Undertaking,0,0,0,0,0,0,0,0,0,0,0,0,0,0,0,0,0,0
D & N HAVELI,2006,8,Students,0,2,0,0,0,2,0,0,0,0,0,0,0,2,0,0,0,2
D & N HAVELI,2006,8,Unemployed,0,3,2,0,0,5,1,1,0,0,0,2,1,4,2,0,0,7
D & N HAVELI,2006,8,Professional Activity,0,0,0,0,0,0,0,0,0,0,0,0,0,0,0,0,0,0
D & N HAVELI,2006,8,Agriculture (Total),0,1,2,3,6,12,0,0,0,0,0,0,0,1,2,3,6,12
D & N HAVELI,2006,8,Retired Persons,0,0,0,0,0,0,0,0,0,0,0,0,0,0,0,0,0,0
D & N HAVELI,2007,8,House Wife,0,0,0,0,0,0,0,15,8,4,1,28,0,15,8,4,1,28
D & N HAVELI,2007,8,Service (Government),0,0,0,0,0,0,0,0,0,0,0,0,0,0,0,0,0,0
D & N HAVELI,2007,8,Service (Private),0,4,4,0,0,8,0,0,0,0,0,0,0,4,4,0,0,8
D & N HAVELI,2007,8,Public Sector Undertaking,0,0,0,0,0,0,0,0,0,0,0,0,0,0,0,0,0,0
D & N HAVELI,2007,8,Students,0,3,0,0,0,3,0,4,0,0,0,4,0,7,0,0,0,7
D & N HAVELI,2007,8,Unemployed,0,2,3,2,0,7,0,0,0,0,0,0,0,2,3,2,0,7
D & N HAVELI,2007,8,Professional Activity,0,0,0,0,0,0,0,0,0,0,0,0,0,0,0,0,0,0
D & N HAVELI,2007,8,Agriculture (Total),0,4,6,4,3,17,0,0,0,0,0,0,0,4,6,4,3,17
D & N HAVELI,2007,8,Retired Persons,0,0,0,0,5,5,0,0,0,0,0,0,0,0,0,0,5,5
D & N HAVELI,2008,8,House Wife,0,0,0,0,0,0,0,10,6,6,1,23,0,10,6,6,1,23
D & N HAVELI,2008,8,Service (Government),0,0,0,1,0,1,0,0,0,0,0,0,0,0,0,1,0,1
D & N HAVELI,2008,8,Service (Private),0,8,4,1,0,13,0,4,0,0,0,4,0,12,4,1,0,17
D & N HAVELI,2008,8,Public Sector Undertaking,0,0,0,0,0,0,0,0,0,0,0,0,0,0,0,0,0,0
D & N HAVELI,2008,8,Students,0,0,0,0,0,0,0,1,0,0,0,1,0,1,0,0,0,1
D & N HAVELI,2008,8,Unemployed,0,0,0,0,0,0,0,0,0,0,0,0,0,0,0,0,0,0
D & N HAVELI,2008,8,Professional Activity,0,0,0,0,0,0,0,0,0,0,0,0,0,0,0,0,0,0
D & N HAVELI,2008,8,Agriculture (Total),0,1,6,4,1,12,0,0,0,0,0,0,0,1,6,4,1,12
D & N HAVELI,2008,8,Retired Persons,0,0,0,0,0,0,0,0,0,0,0,0,0,0,0,0,0,0
D & N HAVELI,2009,8,House Wife,0,0,0,0,0,0,0,10,2,1,6,19,0,10,2,1,6,19
D & N HAVELI,2009,8,Service (Government),0,0,1,0,0,1,0,0,0,0,0,0,0,0,1,0,0,1
D & N HAVELI,2009,8,Service (Private),0,6,3,1,0,10,0,0,2,0,0,2,0,6,5,1,0,12
D & N HAVELI,2009,8,Public Sector Undertaking,0,0,0,0,0,0,0,0,0,0,0,0,0,0,0,0,0,0
D & N HAVELI,2009,8,Students,0,2,0,0,0,2,0,4,0,0,0,4,0,6,0,0,0,6
D & N HAVELI,2009,8,Unemployed,0,0,0,0,0,0,0,0,0,0,0,0,0,0,0,0,0,0
D & N HAVELI,2009,8,Professional Activity,0,0,0,0,0,0,0,0,0,0,0,0,0,0,0,0,0,0
D & N HAVELI,2009,8,Agriculture (Total),0,2,5,6,2,15,0,0,0,0,0,0,0,2,5,6,2,15
D & N HAVELI,2009,8,Retired Persons,0,0,0,0,0,0,0,0,0,0,0,0,0,0,0,0,0,0
D & N HAVELI,2010,8,House Wife,0,0,0,0,0,0,0,15,4,4,0,23,0,15,4,4,0,23
D & N HAVELI,2010,8,Service (Government),0,1,0,0,0,1,0,0,0,0,0,0,0,1,0,0,0,1
D & N HAVELI,2010,8,Service (Private),0,6,5,1,0,12,0,0,0,0,0,0,0,6,5,1,0,12
D & N HAVELI,2010,8,Public Sector Undertaking,0,0,0,0,0,0,0,0,0,0,0,0,0,0,0,0,0,0
D & N HAVELI,2010,8,Students,0,0,0,0,0,0,0,3,0,0,0,3,0,3,0,0,0,3
D & N HAVELI,2010,8,Unemployed,0,0,0,0,0,0,0,0,0,0,0,0,0,0,0,0,0,0
D & N HAVELI,2010,8,Professional Activity,0,0,0,0,0,0,0,0,0,0,0,0,0,0,0,0,0,0
D & N HAVELI,2010,8,Agriculture (Total),0,2,5,3,0,10,0,0,0,0,0,0,0,2,5,3,0,10
D & N HAVELI,2010,8,Retired Persons,0,0,0,0,0,0,0,0,0,0,0,0,0,0,0,0,0,0
D & N HAVELI,2011,8,House Wife,0,0,0,0,0,0,0,5,5,2,0,12,0,5,5,2,0,12
D & N HAVELI,2011,8,Service (Government),0,0,0,0,0,0,0,0,0,0,0,0,0,0,0,0,0,0
D & N HAVELI,2011,8,Service (Private),0,15,3,2,0,20,0,5,0,0,0,5,0,20,3,2,0,25
D & N HAVELI,2011,8,Public Sector Undertaking,0,0,0,0,0,0,0,0,0,0,0,0,0,0,0,0,0,0
D & N HAVELI,2011,8,Students,0,3,0,0,0,3,0,3,0,0,0,3,0,6,0,0,0,6
D & N HAVELI,2011,8,Unemployed,0,0,0,0,0,0,0,0,0,0,0,0,0,0,0,0,0,0
D & N HAVELI,2011,8,Professional Activity,0,0,0,0,0,0,0,0,0,0,0,0,0,0,0,0,0,0
D & N HAVELI,2011,8,Agriculture (Total),0,4,3,5,1,13,0,0,0,0,0,0,0,4,3,5,1,13
D & N HAVELI,2011,8,Retired Persons,0,0,0,0,0,0,0,0,0,0,0,0,0,0,0,0,0,0
D & N HAVELI,2012,8,House Wife,0,0,0,0,0,0,0,6,2,2,3,13,0,6,2,2,3,13
D & N HAVELI,2012,8,Service (Government),0,0,0,0,0,0,0,0,0,0,0,0,0,0,0,0,0,0
D & N HAVELI,2012,8,Service (Private),0,11,13,2,0,26,0,2,0,0,0,2,0,13,13,2,0,28
D & N HAVELI,2012,8,Public Sector Undertaking,0,0,0,0,0,0,0,0,0,0,0,0,0,0,0,0,0,0
D & N HAVELI,2012,8,Students,0,0,0,0,0,0,0,6,0,0,0,6,0,6,0,0,0,6
D & N HAVELI,2012,8,Unemployed,0,1,0,0,1,2,0,2,0,0,0,2,0,3,0,0,1,4
D & N HAVELI,2012,8,Professional Activity,0,0,0,0,0,0,0,0,0,0,0,0,0,0,0,0,0,0
D & N HAVELI,2012,8,Agriculture (Total),0,0,3,2,1,6,0,0,0,0,0,0,0,0,3,2,1,6
D & N HAVELI,2012,8,Retired Persons,0,0,0,0,0,0,0,0,0,0,0,0,0,0,0,0,0,0
D & N HAVELI,2013,8,House Wife,0,0,0,0,0,0,0,7,4,4,3,18,0,7,4,4,3,18
D & N HAVELI,2013,8,Service (Government),0,0,0,0,0,0,0,1,1,0,0,2,0,1,1,0,0,2
D & N HAVELI,2013,8,Service (Private),0,0,0,0,0,0,0,0,0,0,0,0,0,0,0,0,0,0
D & N HAVELI,2013,8,Public Sector Undertaking,0,11,4,2,0,17,0,0,0,1,0,1,0,11,4,3,0,18
D & N HAVELI,2013,8,Students,0,4,0,0,0,4,0,5,0,0,0,5,0,9,0,0,0,9
D & N HAVELI,2013,8,Unemployed,0,8,0,0,0,8,0,0,0,0,0,0,0,8,0,0,0,8
D & N HAVELI,2013,8,Professional Activity,0,0,0,0,0,0,0,0,0,0,0,0,0,0,0,0,0,0
D & N HAVELI,2013,8,Agriculture (Total),0,0,4,9,2,15,0,0,0,0,0,0,0,0,4,9,2,15
D & N HAVELI,2013,8,Retired Persons,0,0,0,0,0,0,0,0,0,0,0,0,0,0,0,0,0,0
D & N HAVELI,2014,8,House Wife,0,0,0,0,0,0,0,7,2,0,0,9,0,7,2,0,0,9
D & N HAVELI,2014,8,Service (Government),0,0,1,0,0,1,0,0,0,0,0,0,0,0,1,0,0,1
D & N HAVELI,2014,8,Service (Private),0,7,8,2,0,17,0,0,0,0,0,0,0,7,8,2,0,17
D & N HAVELI,2014,8,Public Sector Undertaking,0,0,0,0,0,0,0,0,0,0,0,0,0,0,0,0,0,0
D & N HAVELI,2014,8,Students,1,2,0,0,0,3,0,3,0,0,0,3,1,5,0,0,0,6
D & N HAVELI,2014,8,Unemployed,0,0,1,0,0,1,0,0,0,0,0,0,0,0,1,0,0,1
D & N HAVELI,2014,8,Agriculture (Total),0,0,0,0,0,0,0,0,0,0,0,0,0,0,0,0,0,0
D & N HAVELI,2014,8,Retired Persons,0,0,0,1,0,1,0,0,0,0,1,1,0,0,0,1,1,2
DAMAN & DIU,2001,9,House Wife,0,0,0,0,0,0,0,3,0,0,0,3,0,3,0,0,0,3
DAMAN & DIU,2001,9,Service (Government),0,0,0,0,0,0,0,0,0,0,0,0,0,0,0,0,0,0
DAMAN & DIU,2001,9,Service (Private),0,2,3,0,0,5,0,1,0,0,0,1,0,3,3,0,0,6
DAMAN & DIU,2001,9,Public Sector Undertaking,0,0,0,0,0,0,0,0,0,0,0,0,0,0,0,0,0,0
DAMAN & DIU,2001,9,Students,0,0,0,0,0,0,0,0,0,0,0,0,0,0,0,0,0,0
DAMAN & DIU,2001,9,Unemployed,0,0,0,0,0,0,0,0,0,0,0,0,0,0,0,0,0,0
DAMAN & DIU,2001,9,Professional Activity,0,0,1,0,0,1,0,0,0,0,0,0,0,0,1,0,0,1
DAMAN & DIU,2001,9,Agriculture (Total),0,0,0,0,0,0,0,0,0,0,0,0,0,0,0,0,0,0
DAMAN & DIU,2001,9,Retired Persons,0,0,0,0,0,0,0,0,0,0,0,0,0,0,0,0,0,0
DAMAN & DIU,2002,9,House Wife,0,0,0,0,0,0,0,1,1,0,0,2,0,1,1,0,0,2
DAMAN & DIU,2002,9,Service (Government),0,0,0,0,0,0,0,0,0,0,0,0,0,0,0,0,0,0
DAMAN & DIU,2002,9,Service (Private),0,3,6,0,0,9,0,0,0,0,0,0,0,3,6,0,0,9
DAMAN & DIU,2002,9,Public Sector Undertaking,0,0,0,0,0,0,0,0,0,0,0,0,0,0,0,0,0,0
DAMAN & DIU,2002,9,Students,0,0,0,0,0,0,0,0,0,0,0,0,0,0,0,0,0,0
DAMAN & DIU,2002,9,Unemployed,0,0,1,0,0,1,0,0,0,0,0,0,0,0,1,0,0,1
DAMAN & DIU,2002,9,Professional Activity,0,0,0,0,0,0,0,0,0,0,0,0,0,0,0,0,0,0
DAMAN & DIU,2002,9,Agriculture (Total),0,1,1,0,0,2,0,0,0,0,0,0,0,1,1,0,0,2
DAMAN & DIU,2002,9,Retired Persons,0,0,0,0,0,0,0,0,0,0,0,0,0,0,0,0,0,0
DAMAN & DIU,2003,9,House Wife,0,0,0,0,0,0,0,2,2,1,0,5,0,2,2,1,0,5
DAMAN & DIU,2003,9,Service (Government),0,0,0,0,0,0,0,0,0,0,0,0,0,0,0,0,0,0
DAMAN & DIU,2003,9,Service (Private),0,1,3,0,0,4,0,0,0,0,0,0,0,1,3,0,0,4
DAMAN & DIU,2003,9,Public Sector Undertaking,0,0,0,0,0,0,0,0,0,0,0,0,0,0,0,0,0,0
DAMAN & DIU,2003,9,Students,0,0,0,0,0,0,0,0,0,0,0,0,0,0,0,0,0,0
DAMAN & DIU,2003,9,Unemployed,0,1,2,0,0,3,0,0,0,0,0,0,0,1,2,0,0,3
DAMAN & DIU,2003,9,Professional Activity,0,0,1,0,0,1,0,0,0,0,0,0,0,0,1,0,0,1
DAMAN & DIU,2003,9,Agriculture (Total),0,0,0,0,0,0,0,0,0,0,0,0,0,0,0,0,0,0
DAMAN & DIU,2003,9,Retired Persons,0,0,0,0,0,0,0,0,0,0,0,0,0,0,0,0,0,0
DAMAN & DIU,2004,9,House Wife,0,0,0,0,0,0,0,5,0,0,0,5,0,5,0,0,0,5
DAMAN & DIU,2004,9,Service (Government),0,0,0,0,0,0,0,0,0,0,0,0,0,0,0,0,0,0
DAMAN & DIU,2004,9,Service (Private),0,1,0,0,0,1,0,2,0,0,0,2,0,3,0,0,0,3
DAMAN & DIU,2004,9,Public Sector Undertaking,0,0,0,0,0,0,0,0,0,0,0,0,0,0,0,0,0,0
DAMAN & DIU,2004,9,Students,0,0,0,0,0,0,0,0,0,0,0,0,0,0,0,0,0,0
DAMAN & DIU,2004,9,Unemployed,0,0,0,0,0,0,0,0,0,0,0,0,0,0,0,0,0,0
DAMAN & DIU,2004,9,Professional Activity,0,0,0,0,0,0,0,0,0,0,0,0,0,0,0,0,0,0
DAMAN & DIU,2004,9,Agriculture (Total),0,0,1,1,0,2,0,0,0,0,0,0,0,0,1,1,0,2
DAMAN & DIU,2004,9,Retired Persons,0,0,0,0,0,0,0,0,0,0,0,0,0,0,0,0,0,0
DAMAN & DIU,2005,9,House Wife,0,0,0,0,0,0,0,2,2,0,0,4,0,2,2,0,0,4
DAMAN & DIU,2005,9,Service (Government),0,0,0,0,0,0,0,0,0,0,0,0,0,0,0,0,0,0
DAMAN & DIU,2005,9,Service (Private),0,6,1,1,0,8,0,0,0,0,0,0,0,6,1,1,0,8
DAMAN & DIU,2005,9,Public Sector Undertaking,0,0,0,1,0,1,0,0,0,0,0,0,0,0,0,1,0,1
DAMAN & DIU,2005,9,Students,1,0,0,0,0,1,0,0,0,0,0,0,1,0,0,0,0,1
DAMAN & DIU,2005,9,Unemployed,0,0,0,4,0,4,0,0,0,0,0,0,0,0,0,4,0,4
DAMAN & DIU,2005,9,Professional Activity,0,0,0,0,0,0,0,0,0,0,0,0,0,0,0,0,0,0
DAMAN & DIU,2005,9,Agriculture (Total),0,0,0,0,0,0,0,0,0,0,0,0,0,0,0,0,0,0
DAMAN & DIU,2005,9,Retired Persons,0,0,0,0,0,0,0,0,0,0,0,0,0,0,0,0,0,0
DAMAN & DIU,2006,9,House Wife,0,0,0,0,0,0,0,3,0,0,0,3,0,3,0,0,0,3
DAMAN & DIU,2006,9,Service (Government),0,0,0,0,0,0,0,0,0,0,0,0,0,0,0,0,0,0
DAMAN & DIU,2006,9,Service (Private),0,6,2,0,0,8,0,0,0,0,0,0,0,6,2,0,0,8
DAMAN & DIU,2006,9,Public Sector Undertaking,0,0,0,0,0,0,0,0,0,0,0,0,0,0,0,0,0,0
DAMAN & DIU,2006,9,Students,0,1,0,0,0,1,1,1,0,0,0,2,1,2,0,0,0,3
DAMAN & DIU,2006,9,Unemployed,0,0,0,0,0,0,0,0,0,0,0,0,0,0,0,0,0,0
DAMAN & DIU,2006,9,Professional Activity,0,0,0,0,0,0,0,0,0,0,0,0,0,0,0,0,0,0
DAMAN & DIU,2006,9,Agriculture (Total),0,0,0,0,0,0,0,0,0,0,0,0,0,0,0,0,0,0
DAMAN & DIU,2006,9,Retired Persons,0,0,0,0,0,0,0,0,0,0,0,0,0,0,0,0,0,0
DAMAN & DIU,2007,9,House Wife,0,0,0,0,0,0,0,3,2,0,0,5,0,3,2,0,0,5
DAMAN & DIU,2007,9,Service (Government),0,0,0,2,0,2,0,0,0,0,0,0,0,0,0,2,0,2
DAMAN & DIU,2007,9,Service (Private),0,3,1,0,0,4,0,1,0,0,0,1,0,4,1,0,0,5
DAMAN & DIU,2007,9,Public Sector Undertaking,0,0,0,0,0,0,0,0,0,0,0,0,0,0,0,0,0,0
DAMAN & DIU,2007,9,Students,0,0,0,0,0,0,0,0,0,0,0,0,0,0,0,0,0,0
DAMAN & DIU,2007,9,Unemployed,0,0,0,0,0,0,0,0,0,0,0,0,0,0,0,0,0,0
DAMAN & DIU,2007,9,Professional Activity,0,0,0,0,0,0,0,0,0,0,0,0,0,0,0,0,0,0
DAMAN & DIU,2007,9,Agriculture (Total),0,0,0,0,0,0,0,0,0,0,0,0,0,0,0,0,0,0
DAMAN & DIU,2007,9,Retired Persons,0,0,0,0,0,0,0,0,0,0,0,0,0,0,0,0,0,0
DAMAN & DIU,2008,9,House Wife,0,0,0,0,0,0,0,0,0,0,0,0,0,0,0,0,0,0
DAMAN & DIU,2008,9,Service (Government),0,0,0,1,0,1,0,0,0,0,0,0,0,0,0,1,0,1
DAMAN & DIU,2008,9,Service (Private),0,3,3,2,0,8,0,0,0,0,0,0,0,3,3,2,0,8
DAMAN & DIU,2008,9,Public Sector Undertaking,0,0,0,0,0,0,0,0,0,0,0,0,0,0,0,0,0,0
DAMAN & DIU,2008,9,Students,0,0,0,0,0,0,0,0,0,0,0,0,0,0,0,0,0,0
DAMAN & DIU,2008,9,Unemployed,0,0,0,2,0,2,0,1,0,0,0,1,0,1,0,2,0,3
DAMAN & DIU,2008,9,Professional Activity,0,0,0,0,0,0,0,0,0,0,0,0,0,0,0,0,0,0
DAMAN & DIU,2008,9,Agriculture (Total),0,0,0,0,0,0,0,0,0,0,0,0,0,0,0,0,0,0
DAMAN & DIU,2008,9,Retired Persons,0,0,0,0,0,0,0,0,0,0,0,0,0,0,0,0,0,0
DAMAN & DIU,2009,9,House Wife,0,0,0,0,0,0,0,0,3,1,0,4,0,0,3,1,0,4
DAMAN & DIU,2009,9,Service (Government),0,0,0,0,0,0,0,0,0,0,0,0,0,0,0,0,0,0
DAMAN & DIU,2009,9,Service (Private),0,6,0,0,0,6,0,0,1,0,0,1,0,6,1,0,0,7
DAMAN & DIU,2009,9,Public Sector Undertaking,0,0,0,0,0,0,0,1,0,0,0,1,0,1,0,0,0,1
DAMAN & DIU,2009,9,Students,0,1,0,1,0,2,1,0,0,0,0,1,1,1,0,1,0,3
DAMAN & DIU,2009,9,Unemployed,0,0,0,1,0,1,0,0,0,0,0,0,0,0,0,1,0,1
DAMAN & DIU,2009,9,Professional Activity,0,0,0,0,0,0,0,0,0,0,0,0,0,0,0,0,0,0
DAMAN & DIU,2009,9,Agriculture (Total),0,0,0,0,0,0,0,0,0,0,0,0,0,0,0,0,0,0
DAMAN & DIU,2009,9,Retired Persons,0,0,0,0,0,0,0,0,0,0,0,0,0,0,0,0,0,0
DAMAN & DIU,2010,9,House Wife,0,0,0,0,0,0,0,6,2,0,0,8,0,6,2,0,0,8
DAMAN & DIU,2010,9,Service (Government),0,0,1,0,0,1,0,0,0,0,0,0,0,0,1,0,0,1
DAMAN & DIU,2010,9,Service (Private),0,4,5,1,0,10,0,1,0,0,0,1,0,5,5,1,0,11
DAMAN & DIU,2010,9,Public Sector Undertaking,0,0,0,0,0,0,0,0,0,0,0,0,0,0,0,0,0,0
DAMAN & DIU,2010,9,Students,3,2,0,0,0,5,0,1,0,0,0,1,3,3,0,0,0,6
DAMAN & DIU,2010,9,Unemployed,0,0,0,0,0,0,0,0,0,0,0,0,0,0,0,0,0,0
DAMAN & DIU,2010,9,Professional Activity,0,0,0,0,0,0,0,0,0,0,0,0,0,0,0,0,0,0
DAMAN & DIU,2010,9,Agriculture (Total),0,0,0,0,0,0,0,0,0,0,0,0,0,0,0,0,0,0
DAMAN & DIU,2010,9,Retired Persons,0,0,0,0,0,0,0,0,0,0,0,0,0,0,0,0,0,0
DAMAN & DIU,2011,9,House Wife,0,0,0,0,0,0,0,5,1,1,0,7,0,5,1,1,0,7
DAMAN & DIU,2011,9,Service (Government),0,0,0,0,0,0,0,0,0,0,0,0,0,0,0,0,0,0
DAMAN & DIU,2011,9,Service (Private),0,6,4,3,0,13,0,3,0,0,0,3,0,9,4,3,0,16
DAMAN & DIU,2011,9,Public Sector Undertaking,0,0,0,0,0,0,0,0,0,0,0,0,0,0,0,0,0,0
DAMAN & DIU,2011,9,Students,1,0,0,0,0,1,0,4,0,0,0,4,1,4,0,0,0,5
DAMAN & DIU,2011,9,Unemployed,0,0,0,0,0,0,0,0,0,0,0,0,0,0,0,0,0,0
DAMAN & DIU,2011,9,Professional Activity,0,0,0,0,0,0,0,0,0,0,0,0,0,0,0,0,0,0
DAMAN & DIU,2011,9,Agriculture (Total),0,0,0,0,0,0,0,0,0,0,0,0,0,0,0,0,0,0
DAMAN & DIU,2011,9,Retired Persons,0,0,0,0,0,0,0,0,0,0,0,0,0,0,0,0,0,0
DAMAN & DIU,2012,9,House Wife,0,0,0,0,0,0,0,3,5,0,0,8,0,3,5,0,0,8
DAMAN & DIU,2012,9,Service (Government),0,0,0,0,0,0,0,0,0,0,0,0,0,0,0,0,0,0
DAMAN & DIU,2012,9,Service (Private),0,1,5,2,0,8,0,0,0,0,0,0,0,1,5,2,0,8
DAMAN & DIU,2012,9,Public Sector Undertaking,0,0,0,0,0,0,0,0,0,0,0,0,0,0,0,0,0,0
DAMAN & DIU,2012,9,Students,0,1,0,0,0,1,1,0,0,0,0,1,1,1,0,0,0,2
DAMAN & DIU,2012,9,Unemployed,0,0,1,0,0,1,0,0,0,0,0,0,0,0,1,0,0,1
DAMAN & DIU,2012,9,Professional Activity,0,0,0,0,0,0,0,0,0,0,0,0,0,0,0,0,0,0
DAMAN & DIU,2012,9,Agriculture (Total),0,0,0,0,0,0,0,0,0,0,0,0,0,0,0,0,0,0
DAMAN & DIU,2012,9,Retired Persons,0,0,0,0,0,0,0,0,0,0,0,0,0,0,0,0,0,0
DAMAN & DIU,2013,9,House Wife,0,0,0,0,0,0,0,4,4,2,0,10,0,4,4,2,0,10
DAMAN & DIU,2013,9,Service (Government),0,0,0,1,0,1,0,0,0,0,0,0,0,0,0,1,0,1
DAMAN & DIU,2013,9,Service (Private),0,6,2,2,0,10,0,1,1,1,0,3,0,7,3,3,0,13
DAMAN & DIU,2013,9,Public Sector Undertaking,0,0,0,0,0,0,0,0,0,0,0,0,0,0,0,0,0,0
DAMAN & DIU,2013,9,Students,0,1,0,0,0,1,0,3,0,0,0,3,0,4,0,0,0,4
DAMAN & DIU,2013,9,Unemployed,0,0,0,0,0,0,0,0,0,0,0,0,0,0,0,0,0,0
DAMAN & DIU,2013,9,Professional Activity,0,0,0,0,0,0,0,0,0,0,0,0,0,0,0,0,0,0
DAMAN & DIU,2013,9,Agriculture (Total),0,0,0,0,0,0,0,0,0,0,0,0,0,0,0,0,0,0
DAMAN & DIU,2013,9,Retired Persons,0,0,0,0,0,0,0,0,0,0,0,0,0,0,0,0,0,0
DAMAN & DIU,2014,9,House Wife,0,0,0,0,0,0,0,2,2,0,0,4,0,2,2,0,0,4
DAMAN & DIU,2014,9,Service (Government),0,6,0,0,0,6,0,0,0,0,0,0,0,6,0,0,0,6
DAMAN & DIU,2014,9,Service (Private),0,0,0,0,0,0,0,0,0,0,0,0,0,0,0,0,0,0
DAMAN & DIU,2014,9,Public Sector Undertaking,0,0,0,0,0,0,0,0,0,0,0,0,0,0,0,0,0,0
DAMAN & DIU,2014,9,Students,0,0,0,0,0,0,0,1,0,0,0,1,0,1,0,0,0,1
DAMAN & DIU,2014,9,Unemployed,0,2,2,0,0,4,0,0,0,0,0,0,0,2,2,0,0,4
DAMAN & DIU,2014,9,Agriculture (Total),0,0,0,0,0,0,0,0,0,0,0,0,0,0,0,0,0,0
DAMAN & DIU,2014,9,Retired Persons,0,0,0,0,1,1,0,0,0,0,0,0,0,0,0,0,1,1
DELHI (UT),2001,10,House Wife,0,0,0,0,0,0,0,174,118,27,8,327,0,174,118,27,8,327
DELHI (UT),2001,10,Service (Government),0,11,13,5,0,29,0,1,1,0,0,2,0,12,14,5,0,31
DELHI (UT),2001,10,Service (Private),0,68,51,27,1,147,0,12,1,0,0,13,0,80,52,27,1,160
DELHI (UT),2001,10,Public Sector Undertaking,0,10,6,2,1,19,0,1,0,0,0,1,0,11,6,2,1,20
DELHI (UT),2001,10,Students,9,42,4,0,0,55,14,35,0,0,0,49,23,77,4,0,0,104
DELHI (UT),2001,10,Unemployed,1,91,76,34,7,209,4,13,3,0,0,20,5,104,79,34,7,229
DELHI (UT),2001,10,Professional Activity,0,3,4,4,0,11,0,1,0,0,0,1,0,4,4,4,0,12
DELHI (UT),2001,10,Agriculture (Total),0,8,7,1,0,16,0,2,0,0,0,2,0,10,7,1,0,18
DELHI (UT),2001,10,Retired Persons,0,0,0,0,1,1,0,0,0,0,0,0,0,0,0,0,1,1
DELHI (UT),2002,10,House Wife,0,0,0,0,0,0,0,139,93,16,2,250,0,139,93,16,2,250
DELHI (UT),2002,10,Service (Government),0,12,10,4,0,26,0,6,0,0,0,6,0,18,10,4,0,32
DELHI (UT),2002,10,Service (Private),0,49,53,20,0,122,0,8,6,0,0,14,0,57,59,20,0,136
DELHI (UT),2002,10,Public Sector Undertaking,0,1,5,3,0,9,0,0,0,0,0,0,0,1,5,3,0,9
DELHI (UT),2002,10,Students,10,37,0,0,0,47,14,37,7,0,0,58,24,74,7,0,0,105
DELHI (UT),2002,10,Unemployed,1,132,69,26,5,233,1,22,3,1,0,27,2,154,72,27,5,260
DELHI (UT),2002,10,Professional Activity,0,3,3,5,0,11,0,0,0,0,0,0,0,3,3,5,0,11
DELHI (UT),2002,10,Agriculture (Total),0,5,11,8,6,30,0,3,0,0,0,3,0,8,11,8,6,33
DELHI (UT),2002,10,Retired Persons,0,0,1,1,4,6,0,0,0,0,0,0,0,0,1,1,4,6
DELHI (UT),2003,10,House Wife,0,0,0,0,0,0,0,115,77,26,3,221,0,115,77,26,3,221
DELHI (UT),2003,10,Service (Government),0,7,8,3,0,18,0,8,2,3,0,13,0,15,10,6,0,31
DELHI (UT),2003,10,Service (Private),0,46,46,14,2,108,0,13,7,0,0,20,0,59,53,14,2,128
DELHI (UT),2003,10,Public Sector Undertaking,0,2,6,2,0,10,0,1,0,0,0,1,0,3,6,2,0,11
DELHI (UT),2003,10,Students,9,43,0,0,0,52,12,50,3,0,0,65,21,93,3,0,0,117
DELHI (UT),2003,10,Unemployed,1,119,99,19,15,253,2,19,10,10,0,41,3,138,109,29,15,294
DELHI (UT),2003,10,Professional Activity,0,4,2,1,0,7,0,0,0,0,0,0,0,4,2,1,0,7
DELHI (UT),2003,10,Agriculture (Total),0,4,2,2,0,8,0,0,0,0,0,0,0,4,2,2,0,8
DELHI (UT),2003,10,Retired Persons,0,0,0,0,0,0,0,0,0,0,0,0,0,0,0,0,0,0
DELHI (UT),2004,10,House Wife,0,0,0,0,0,0,0,158,78,16,14,266,0,158,78,16,14,266
DELHI (UT),2004,10,Service (Government),0,1,9,4,0,14,0,0,0,0,0,0,0,1,9,4,0,14
DELHI (UT),2004,10,Service (Private),0,88,84,24,3,199,0,4,2,0,0,6,0,92,86,24,3,205
DELHI (UT),2004,10,Public Sector Undertaking,0,5,3,2,1,11,0,3,1,0,0,4,0,8,4,2,1,15
DELHI (UT),2004,10,Students,15,42,0,0,0,57,12,41,0,0,0,53,27,83,0,0,0,110
DELHI (UT),2004,10,Unemployed,2,112,101,33,6,254,1,42,18,3,2,66,3,154,119,36,8,320
DELHI (UT),2004,10,Professional Activity,0,3,2,0,0,5,0,0,0,0,0,0,0,3,2,0,0,5
DELHI (UT),2004,10,Agriculture (Total),0,1,3,5,3,12,0,0,0,1,0,1,0,1,3,6,3,13
DELHI (UT),2004,10,Retired Persons,0,0,0,0,2,2,0,0,0,0,0,0,0,0,0,0,2,2
DELHI (UT),2005,10,House Wife,0,0,0,0,0,0,0,162,102,23,7,294,0,162,102,23,7,294
DELHI (UT),2005,10,Service (Government),0,7,18,11,0,36,0,3,0,1,0,4,0,10,18,12,0,40
DELHI (UT),2005,10,Service (Private),0,76,58,29,2,165,1,14,3,0,0,18,1,90,61,29,2,183
DELHI (UT),2005,10,Public Sector Undertaking,0,1,2,1,0,4,0,1,0,0,0,1,0,2,2,1,0,5
DELHI (UT),2005,10,Students,4,50,5,0,0,59,5,33,1,0,0,39,9,83,6,0,0,98
DELHI (UT),2005,10,Unemployed,1,109,69,24,6,209,2,25,5,0,0,32,3,134,74,24,6,241
DELHI (UT),2005,10,Professional Activity,0,0,1,3,1,5,0,1,0,0,0,1,0,1,1,3,1,6
DELHI (UT),2005,10,Agriculture (Total),0,1,5,1,0,7,0,0,0,0,0,0,0,1,5,1,0,7
DELHI (UT),2005,10,Retired Persons,0,0,0,0,3,3,0,0,0,0,0,0,0,0,0,0,3,3
DELHI (UT),2006,10,House Wife,0,0,0,0,0,0,0,194,111,24,2,331,0,194,111,24,2,331
DELHI (UT),2006,10,Service (Government),0,4,15,8,0,27,0,1,3,0,0,4,0,5,18,8,0,31
DELHI (UT),2006,10,Service (Private),0,116,94,37,1,248,0,15,2,0,0,17,0,131,96,37,1,265
DELHI (UT),2006,10,Public Sector Undertaking,0,10,11,1,0,22,1,2,0,0,0,3,1,12,11,1,0,25
DELHI (UT),2006,10,Students,3,52,0,0,0,55,9,53,1,0,0,63,12,105,1,0,0,118
DELHI (UT),2006,10,Unemployed,1,150,90,33,3,277,1,32,5,0,2,40,2,182,95,33,5,317
DELHI (UT),2006,10,Professional Activity,0,1,1,2,0,4,0,0,0,0,0,0,0,1,1,2,0,4
DELHI (UT),2006,10,Agriculture (Total),0,0,3,0,0,3,0,0,0,0,0,0,0,0,3,0,0,3
DELHI (UT),2006,10,Retired Persons,0,9,5,2,1,17,0,0,0,0,0,0,0,9,5,2,1,17
DELHI (UT),2007,10,House Wife,0,0,0,0,0,0,0,158,86,12,7,263,0,158,86,12,7,263
DELHI (UT),2007,10,Service (Government),0,6,15,3,0,24,0,3,1,0,0,4,0,9,16,3,0,28
DELHI (UT),2007,10,Service (Private),1,100,90,25,3,219,0,22,6,1,0,29,1,122,96,26,3,248
DELHI (UT),2007,10,Public Sector Undertaking,0,4,5,3,0,12,0,2,0,0,0,2,0,6,5,3,0,14
DELHI (UT),2007,10,Students,9,61,5,0,0,75,7,53,0,0,0,60,16,114,5,0,0,135
DELHI (UT),2007,10,Unemployed,1,108,70,18,5,202,0,44,6,0,0,50,1,152,76,18,5,252
DELHI (UT),2007,10,Professional Activity,0,3,0,1,0,4,0,1,0,0,0,1,0,4,0,1,0,5
DELHI (UT),2007,10,Agriculture (Total),0,5,10,7,1,23,0,0,0,0,0,0,0,5,10,7,1,23
DELHI (UT),2007,10,Retired Persons,0,0,0,0,5,5,0,0,0,0,0,0,0,0,0,0,5,5
DELHI (UT),2008,10,House Wife,0,0,0,0,0,0,0,166,89,19,2,276,0,166,89,19,2,276
DELHI (UT),2008,10,Service (Government),0,2,7,4,0,13,0,0,1,1,0,2,0,2,8,5,0,15
DELHI (UT),2008,10,Service (Private),0,78,82,24,2,186,0,18,7,2,0,27,0,96,89,26,2,213
DELHI (UT),2008,10,Public Sector Undertaking,0,16,12,3,4,35,0,3,0,0,0,3,0,19,12,3,4,38
DELHI (UT),2008,10,Students,13,63,1,0,0,77,13,79,6,0,0,98,26,142,7,0,0,175
DELHI (UT),2008,10,Unemployed,1,99,84,22,5,211,1,36,4,0,0,41,2,135,88,22,5,252
DELHI (UT),2008,10,Professional Activity,0,0,3,3,1,7,0,0,0,0,0,0,0,0,3,3,1,7
DELHI (UT),2008,10,Agriculture (Total),0,5,5,2,3,15,1,0,0,0,0,1,1,5,5,2,3,16
DELHI (UT),2008,10,Retired Persons,0,0,0,1,1,2,0,0,0,0,0,0,0,0,0,1,1,2
DELHI (UT),2009,10,House Wife,0,0,0,0,0,0,0,198,98,21,6,323,0,198,98,21,6,323
DELHI (UT),2009,10,Service (Government),0,4,9,5,0,18,0,1,1,0,0,2,0,5,10,5,0,20
DELHI (UT),2009,10,Service (Private),0,88,99,21,2,210,0,16,3,2,0,21,0,104,102,23,2,231
DELHI (UT),2009,10,Public Sector Undertaking,0,9,11,4,0,24,0,2,0,0,0,2,0,11,11,4,0,26
DELHI (UT),2009,10,Students,10,87,2,0,0,99,7,58,1,0,0,66,17,145,3,0,0,165
DELHI (UT),2009,10,Unemployed,1,129,80,25,3,238,5,30,7,0,0,42,6,159,87,25,3,280
DELHI (UT),2009,10,Professional Activity,0,3,5,4,0,12,0,1,0,0,0,1,0,4,5,4,0,13
DELHI (UT),2009,10,Agriculture (Total),0,1,3,1,0,5,0,0,0,0,0,0,0,1,3,1,0,5
DELHI (UT),2009,10,Retired Persons,0,0,0,0,7,7,0,0,0,0,0,0,0,0,0,0,7,7
DELHI (UT),2010,10,House Wife,0,0,0,0,0,0,0,197,117,31,7,352,0,197,117,31,7,352
DELHI (UT),2010,10,Service (Government),0,2,7,6,0,15,0,3,0,0,0,3,0,5,7,6,0,18
DELHI (UT),2010,10,Service (Private),0,90,78,22,11,201,0,18,3,1,0,22,0,108,81,23,11,223
DELHI (UT),2010,10,Public Sector Undertaking,0,12,23,4,0,39,0,5,0,0,0,5,0,17,23,4,0,44
DELHI (UT),2010,10,Students,11,75,1,0,0,87,18,56,3,2,0,79,29,131,4,2,0,166
DELHI (UT),2010,10,Unemployed,0,102,88,30,16,236,3,32,8,0,0,43,3,134,96,30,16,279
DELHI (UT),2010,10,Professional Activity,0,1,2,0,0,3,0,0,1,0,0,1,0,1,3,0,0,4
DELHI (UT),2010,10,Agriculture (Total),0,2,5,2,0,9,0,0,0,0,0,0,0,2,5,2,0,9
DELHI (UT),2010,10,Retired Persons,0,0,0,0,4,4,0,0,0,0,0,0,0,0,0,0,4,4
DELHI (UT),2011,10,House Wife,0,0,0,0,0,0,0,158,101,20,11,290,0,158,101,20,11,290
DELHI (UT),2011,10,Service (Government),0,12,10,5,0,27,0,4,1,1,0,6,0,16,11,6,0,33
DELHI (UT),2011,10,Service (Private),0,97,100,28,2,227,0,21,5,2,0,28,0,118,105,30,2,255
DELHI (UT),2011,10,Public Sector Undertaking,0,20,6,3,0,29,0,1,0,0,0,1,0,21,6,3,0,30
DELHI (UT),2011,10,Students,12,102,0,0,0,114,11,75,0,0,0,86,23,177,0,0,0,200
DELHI (UT),2011,10,Unemployed,1,210,130,25,4,370,1,40,10,3,1,55,2,250,140,28,5,425
DELHI (UT),2011,10,Professional Activity,0,5,7,1,0,13,0,0,0,0,0,0,0,5,7,1,0,13
DELHI (UT),2011,10,Agriculture (Total),0,2,6,2,0,10,0,0,0,0,0,0,0,2,6,2,0,10
DELHI (UT),2011,10,Retired Persons,0,0,0,0,11,11,0,0,0,0,0,0,0,0,0,0,11,11
DELHI (UT),2012,10,House Wife,0,0,0,0,0,0,0,194,114,36,11,355,0,194,114,36,11,355
DELHI (UT),2012,10,Service (Government),0,4,10,10,0,24,0,0,0,1,0,1,0,4,10,11,0,25
DELHI (UT),2012,10,Service (Private),0,120,107,35,2,264,0,14,2,0,0,16,0,134,109,35,2,280
DELHI (UT),2012,10,Public Sector Undertaking,0,15,20,3,0,38,0,3,0,0,0,3,0,18,20,3,0,41
DELHI (UT),2012,10,Students,19,118,0,0,0,137,22,101,6,0,0,129,41,219,6,0,0,266
DELHI (UT),2012,10,Unemployed,3,177,109,27,4,320,4,43,2,0,0,49,7,220,111,27,4,369
DELHI (UT),2012,10,Professional Activity,0,3,3,1,0,7,0,0,3,0,0,3,0,3,6,1,0,10
DELHI (UT),2012,10,Agriculture (Total),0,12,3,6,0,21,0,0,0,0,0,0,0,12,3,6,0,21
DELHI (UT),2012,10,Retired Persons,0,0,1,2,14,17,0,0,0,0,0,0,0,0,1,2,14,17
DELHI (UT),2013,10,House Wife,0,0,0,0,0,0,0,175,86,21,4,286,0,175,86,21,4,286
DELHI (UT),2013,10,Service (Government),0,8,15,7,0,30,0,4,2,2,0,8,0,12,17,9,0,38
DELHI (UT),2013,10,Service (Private),0,62,65,32,0,159,0,9,4,0,0,13,0,71,69,32,0,172
DELHI (UT),2013,10,Public Sector Undertaking,0,20,25,8,0,53,0,8,1,0,0,9,0,28,26,8,0,62
DELHI (UT),2013,10,Students,13,110,2,0,0,125,19,102,4,0,0,125,32,212,6,0,0,250
DELHI (UT),2013,10,Unemployed,0,145,118,37,9,309,0,23,4,1,1,29,0,168,122,38,10,338
DELHI (UT),2013,10,Professional Activity,0,4,4,1,3,12,0,0,0,0,0,0,0,4,4,1,3,12
DELHI (UT),2013,10,Agriculture (Total),0,3,2,2,0,7,0,1,0,0,0,1,0,4,2,2,0,8
DELHI (UT),2013,10,Retired Persons,0,0,1,1,13,15,0,0,0,0,0,0,0,0,1,1,13,15
DELHI (UT),2014,10,House Wife,0,0,0,0,0,0,0,142,64,12,5,223,0,142,64,12,5,223
DELHI (UT),2014,10,Service (Government),0,6,12,1,0,19,0,14,1,0,0,15,0,20,13,1,0,34
DELHI (UT),2014,10,Service (Private),0,56,33,6,0,95,0,5,3,0,0,8,0,61,36,6,0,103
DELHI (UT),2014,10,Public Sector Undertaking,0,14,23,8,0,45,0,5,0,1,0,6,0,19,23,9,0,51
DELHI (UT),2014,10,Students,14,130,3,0,0,147,7,87,0,0,0,94,21,217,3,0,0,241
DELHI (UT),2014,10,Unemployed,0,109,93,27,2,231,2,27,9,0,0,38,2,136,102,27,2,269
DELHI (UT),2014,10,Agriculture (Total),0,0,0,0,0,0,0,0,0,0,0,0,0,0,0,0,0,0
DELHI (UT),2014,10,Retired Persons,0,0,0,0,4,4,0,0,0,0,1,1,0,0,0,0,5,5
GOA,2001,11,House Wife,0,0,0,0,0,0,0,11,24,6,14,55,0,11,24,6,14,55
GOA,2001,11,Service (Government),0,0,2,2,0,4,0,0,1,0,1,2,0,0,3,2,1,6
GOA,2001,11,Service (Private),0,11,29,6,0,46,0,5,1,0,0,6,0,16,30,6,0,52
GOA,2001,11,Public Sector Undertaking,0,0,0,0,0,0,0,0,0,0,0,0,0,0,0,0,0,0
GOA,2001,11,Students,0,4,0,0,0,4,3,6,0,0,0,9,3,10,0,0,0,13
GOA,2001,11,Unemployed,0,17,21,3,3,44,0,6,4,0,0,10,0,23,25,3,3,54
GOA,2001,11,Professional Activity,0,0,2,0,0,2,0,0,0,0,0,0,0,0,2,0,0,2
GOA,2001,11,Agriculture (Total),0,1,4,9,4,18,0,0,0,0,0,0,0,1,4,9,4,18
GOA,2001,11,Retired Persons,0,0,0,0,3,3,0,0,0,0,0,0,0,0,0,0,3,3
GOA,2002,11,House Wife,0,0,0,0,0,0,0,17,13,6,6,42,0,17,13,6,6,42
GOA,2002,11,Service (Government),0,0,2,2,0,4,0,0,3,0,0,3,0,0,5,2,0,7
GOA,2002,11,Service (Private),0,21,25,9,0,55,0,3,4,1,0,8,0,24,29,10,0,63
GOA,2002,11,Public Sector Undertaking,0,0,3,1,0,4,0,0,0,0,0,0,0,0,3,1,0,4
GOA,2002,11,Students,0,8,0,0,0,8,2,7,0,0,0,9,2,15,0,0,0,17
GOA,2002,11,Unemployed,0,21,26,15,3,65,0,5,2,1,0,8,0,26,28,16,3,73
GOA,2002,11,Professional Activity,0,0,0,1,1,2,0,0,0,0,0,0,0,0,0,1,1,2
GOA,2002,11,Agriculture (Total),0,2,4,3,0,9,0,1,1,0,0,2,0,3,5,3,0,11
GOA,2002,11,Retired Persons,0,0,0,1,4,5,0,0,0,0,0,0,0,0,0,1,4,5
GOA,2003,11,House Wife,0,0,0,0,0,0,0,27,12,8,2,49,0,27,12,8,2,49
GOA,2003,11,Service (Government),0,0,6,1,0,7,0,0,1,0,0,1,0,0,7,1,0,8
GOA,2003,11,Service (Private),0,15,32,15,0,62,0,7,2,1,0,10,0,22,34,16,0,72
GOA,2003,11,Public Sector Undertaking,0,0,1,0,0,1,0,0,0,0,0,0,0,0,1,0,0,1
GOA,2003,11,Students,0,11,1,0,0,12,3,4,0,0,0,7,3,15,1,0,0,19
GOA,2003,11,Unemployed,0,17,26,2,2,47,0,10,1,0,0,11,0,27,27,2,2,58
GOA,2003,11,Professional Activity,0,1,1,0,0,2,0,0,1,0,0,1,0,1,2,0,0,3
GOA,2003,11,Agriculture (Total),0,1,3,9,4,17,0,0,0,1,0,1,0,1,3,10,4,18
GOA,2003,11,Retired Persons,0,0,0,0,0,0,0,0,0,0,0,0,0,0,0,0,0,0
GOA,2004,11,House Wife,0,0,0,0,0,0,0,19,22,10,4,55,0,19,22,10,4,55
GOA,2004,11,Service (Government),0,1,4,2,0,7,0,0,1,2,0,3,0,1,5,4,0,10
GOA,2004,11,Service (Private),0,11,19,9,0,39,0,6,0,1,0,7,0,17,19,10,0,46
GOA,2004,11,Public Sector Undertaking,0,4,3,3,0,10,0,0,3,0,0,3,0,4,6,3,0,13
GOA,2004,11,Students,2,11,0,0,0,13,3,7,0,0,0,10,5,18,0,0,0,23
GOA,2004,11,Unemployed,0,20,19,8,1,48,0,9,1,0,1,11,0,29,20,8,2,59
GOA,2004,11,Professional Activity,0,0,1,0,0,1,0,1,0,0,0,1,0,1,1,0,0,2
GOA,2004,11,Agriculture (Total),0,0,2,5,0,7,0,0,1,0,0,1,0,0,3,5,0,8
GOA,2004,11,Retired Persons,0,0,0,2,1,3,0,0,0,0,0,0,0,0,0,2,1,3
GOA,2005,11,House Wife,0,0,0,0,0,0,0,18,8,13,8,47,0,18,8,13,8,47
GOA,2005,11,Service (Government),0,2,3,2,0,7,0,0,0,0,0,0,0,2,3,2,0,7
GOA,2005,11,Service (Private),0,13,25,8,0,46,0,4,2,0,0,6,0,17,27,8,0,52
GOA,2005,11,Public Sector Undertaking,0,2,3,1,0,6,0,0,0,0,0,0,0,2,3,1,0,6
GOA,2005,11,Students,2,6,0,0,0,8,1,6,0,0,0,7,3,12,0,0,0,15
GOA,2005,11,Unemployed,0,15,17,8,5,45,0,10,1,1,1,13,0,25,18,9,6,58
GOA,2005,11,Professional Activity,0,1,0,0,0,1,0,0,0,0,0,0,0,1,0,0,0,1
GOA,2005,11,Agriculture (Total),0,0,4,2,4,10,0,0,0,0,1,1,0,0,4,2,5,11
GOA,2005,11,Retired Persons,0,0,0,3,1,4,0,0,0,0,1,1,0,0,0,3,2,5
GOA,2006,11,House Wife,0,0,0,0,0,0,0,12,16,13,10,51,0,12,16,13,10,51
GOA,2006,11,Service (Government),0,2,1,0,0,3,0,0,0,0,0,0,0,2,1,0,0,3
GOA,2006,11,Service (Private),0,20,18,11,0,49,0,3,1,0,0,4,0,23,19,11,0,53
GOA,2006,11,Public Sector Undertaking,0,0,0,0,0,0,0,0,0,0,0,0,0,0,0,0,0,0
GOA,2006,11,Students,1,7,0,0,0,8,4,8,0,0,0,12,5,15,0,0,0,20
GOA,2006,11,Unemployed,0,19,22,8,2,51,0,10,2,0,0,12,0,29,24,8,2,63
GOA,2006,11,Professional Activity,0,0,0,0,0,0,0,0,0,0,0,0,0,0,0,0,0,0
GOA,2006,11,Agriculture (Total),0,0,5,0,0,5,0,0,0,0,0,0,0,0,5,0,0,5
GOA,2006,11,Retired Persons,0,0,0,2,6,8,0,0,0,0,0,0,0,0,0,2,6,8
GOA,2007,11,House Wife,0,0,0,0,0,0,0,24,20,11,4,59,0,24,20,11,4,59
GOA,2007,11,Service (Government),0,0,2,1,0,3,0,0,1,2,0,3,0,0,3,3,0,6
GOA,2007,11,Service (Private),0,19,23,11,2,55,0,7,1,1,0,9,0,26,24,12,2,64
GOA,2007,11,Public Sector Undertaking,0,0,0,0,0,0,0,0,0,0,0,0,0,0,0,0,0,0
GOA,2007,11,Students,1,10,3,0,0,14,1,3,0,0,0,4,2,13,3,0,0,18
GOA,2007,11,Unemployed,0,16,29,15,7,67,0,12,2,0,0,14,0,28,31,15,7,81
GOA,2007,11,Professional Activity,0,1,0,0,0,1,0,0,0,0,0,0,0,1,0,0,0,1
GOA,2007,11,Agriculture (Total),0,0,0,0,0,0,0,0,0,0,0,0,0,0,0,0,0,0
GOA,2007,11,Retired Persons,0,0,0,4,6,10,0,0,0,0,0,0,0,0,0,4,6,10
GOA,2008,11,House Wife,0,0,0,0,0,0,0,25,19,10,11,65,0,25,19,10,11,65
GOA,2008,11,Service (Government),0,0,3,0,0,3,0,1,0,0,0,1,0,1,3,0,0,4
GOA,2008,11,Service (Private),0,23,25,7,1,56,0,5,2,0,0,7,0,28,27,7,1,63
GOA,2008,11,Public Sector Undertaking,0,0,0,0,0,0,0,0,0,0,0,0,0,0,0,0,0,0
GOA,2008,11,Students,0,5,0,0,0,5,2,5,0,0,0,7,2,10,0,0,0,12
GOA,2008,11,Unemployed,0,18,22,12,2,54,1,13,3,0,0,17,1,31,25,12,2,71
GOA,2008,11,Professional Activity,0,0,1,0,0,1,0,0,0,0,0,0,0,0,1,0,0,1
GOA,2008,11,Agriculture (Total),0,0,2,2,2,6,0,0,0,0,0,0,0,0,2,2,2,6
GOA,2008,11,Retired Persons,0,0,0,0,2,2,0,0,0,0,0,0,0,0,0,0,2,2
GOA,2009,11,House Wife,0,0,0,0,0,0,0,24,19,10,7,60,0,24,19,10,7,60
GOA,2009,11,Service (Government),0,2,2,1,0,5,0,2,2,1,0,5,0,4,4,2,0,10
GOA,2009,11,Service (Private),0,14,19,10,1,44,0,6,0,0,0,6,0,20,19,10,1,50
GOA,2009,11,Public Sector Undertaking,0,1,0,2,0,3,0,0,0,0,0,0,0,1,0,2,0,3
GOA,2009,11,Students,1,7,0,0,0,8,2,4,0,1,0,7,3,11,0,1,0,15
GOA,2009,11,Unemployed,0,15,22,16,0,53,0,4,0,1,1,6,0,19,22,17,1,59
GOA,2009,11,Professional Activity,0,1,2,1,0,4,0,0,1,0,0,1,0,1,3,1,0,5
GOA,2009,11,Agriculture (Total),0,0,2,1,1,4,0,0,0,0,0,0,0,0,2,1,1,4
GOA,2009,11,Retired Persons,0,0,0,0,4,4,0,0,0,0,0,0,0,0,0,0,4,4
GOA,2010,11,House Wife,0,0,0,0,0,0,0,14,18,9,11,52,0,14,18,9,11,52
GOA,2010,11,Service (Government),0,1,4,4,0,9,0,0,0,0,0,0,0,1,4,4,0,9
GOA,2010,11,Service (Private),0,24,31,11,1,67,0,3,0,0,0,3,0,27,31,11,1,70
GOA,2010,11,Public Sector Undertaking,0,1,1,0,0,2,0,0,0,0,0,0,0,1,1,0,0,2
GOA,2010,11,Students,2,10,1,0,0,13,2,8,0,0,0,10,4,18,1,0,0,23
GOA,2010,11,Unemployed,0,15,19,14,3,51,1,7,2,0,0,10,1,22,21,14,3,61
GOA,2010,11,Professional Activity,0,0,0,1,0,1,0,0,0,0,0,0,0,0,0,1,0,1
GOA,2010,11,Agriculture (Total),0,2,3,3,7,15,0,0,0,0,0,0,0,2,3,3,7,15
GOA,2010,11,Retired Persons,0,0,0,0,3,3,0,0,0,0,0,0,0,0,0,0,3,3
GOA,2011,11,House Wife,0,0,0,0,0,0,0,18,22,7,9,56,0,18,22,7,9,56
GOA,2011,11,Service (Government),0,0,0,0,0,0,0,0,0,0,0,0,0,0,0,0,0,0
GOA,2011,11,Service (Private),0,19,25,9,0,53,0,7,1,0,0,8,0,26,26,9,0,61
GOA,2011,11,Public Sector Undertaking,0,0,0,0,0,0,0,0,0,0,0,0,0,0,0,0,0,0
GOA,2011,11,Students,3,4,0,0,0,7,2,17,1,0,0,20,5,21,1,0,0,27
GOA,2011,11,Unemployed,1,13,12,13,4,43,1,5,2,0,0,8,2,18,14,13,4,51
GOA,2011,11,Professional Activity,0,2,1,1,0,4,0,1,0,0,0,1,0,3,1,1,0,5
GOA,2011,11,Agriculture (Total),0,0,0,0,1,1,0,0,0,0,0,0,0,0,0,0,1,1
GOA,2011,11,Retired Persons,0,0,0,0,4,4,0,0,0,1,0,1,0,0,0,1,4,5
GOA,2012,11,House Wife,0,0,0,0,0,0,0,11,24,7,13,55,0,11,24,7,13,55
GOA,2012,11,Service (Government),0,1,5,3,0,9,0,0,1,0,0,1,0,1,6,3,0,10
GOA,2012,11,Service (Private),0,23,17,8,2,50,0,4,1,0,0,5,0,27,18,8,2,55
GOA,2012,11,Public Sector Undertaking,0,2,2,1,1,6,0,1,1,0,0,2,0,3,3,1,1,8
GOA,2012,11,Students,3,5,0,0,0,8,2,13,0,0,0,15,5,18,0,0,0,23
GOA,2012,11,Unemployed,0,12,20,12,2,46,0,3,0,0,0,3,0,15,20,12,2,49
GOA,2012,11,Professional Activity,0,1,1,1,1,4,0,0,0,0,0,0,0,1,1,1,1,4
GOA,2012,11,Agriculture (Total),0,0,0,1,0,1,0,0,0,0,0,0,0,0,0,1,0,1
GOA,2012,11,Retired Persons,0,0,0,0,5,5,0,0,0,0,0,0,0,0,0,0,5,5
GOA,2013,11,House Wife,0,0,0,0,0,0,1,17,24,7,7,56,1,17,24,7,7,56
GOA,2013,11,Service (Government),0,0,2,2,0,4,0,0,2,0,0,2,0,0,4,2,0,6
GOA,2013,11,Service (Private),0,27,24,8,0,59,0,3,2,0,0,5,0,30,26,8,0,64
GOA,2013,11,Public Sector Undertaking,0,0,0,0,0,0,0,1,0,0,0,1,0,1,0,0,0,1
GOA,2013,11,Students,0,12,0,0,0,12,2,9,0,0,0,11,2,21,0,0,0,23
GOA,2013,11,Unemployed,0,20,19,23,11,73,0,8,2,0,1,11,0,28,21,23,12,84
GOA,2013,11,Professional Activity,0,1,2,2,0,5,0,0,0,0,0,0,0,1,2,2,0,5
GOA,2013,11,Agriculture (Total),0,0,0,1,0,1,0,0,0,0,0,0,0,0,0,1,0,1
GOA,2013,11,Retired Persons,0,0,1,1,2,4,0,0,0,0,0,0,0,0,1,1,2,4
GOA,2014,11,House Wife,0,0,0,0,0,0,0,13,16,9,8,46,0,13,16,9,8,46
GOA,2014,11,Service (Government),0,3,2,2,0,7,0,0,1,0,0,1,0,3,3,2,0,8
GOA,2014,11,Service (Private),0,17,5,4,2,28,0,8,1,1,0,10,0,25,6,5,2,38
GOA,2014,11,Public Sector Undertaking,0,0,2,1,0,3,0,0,0,0,0,0,0,0,2,1,0,3
GOA,2014,11,Students,1,6,0,0,0,7,2,6,0,0,0,8,3,12,0,0,0,15
GOA,2014,11,Unemployed,0,15,13,15,8,51,0,3,1,1,3,8,0,18,14,16,11,59
GOA,2014,11,Agriculture (Total),0,0,0,0,0,0,0,0,0,0,0,0,0,0,0,0,0,0
GOA,2014,11,Retired Persons,0,0,0,0,3,3,0,0,0,0,0,0,0,0,0,0,3,3
GUJARAT,2001,12,House Wife,0,0,0,0,0,0,15,736,534,199,84,1568,15,736,534,199,84,1568
GUJARAT,2001,12,Service (Government),0,12,26,24,0,62,0,3,5,0,0,8,0,15,31,24,0,70
GUJARAT,2001,12,Service (Private),0,145,169,45,6,365,0,18,14,7,0,39,0,163,183,52,6,404
GUJARAT,2001,12,Public Sector Undertaking,0,22,47,21,2,92,0,8,4,3,0,15,0,30,51,24,2,107
GUJARAT,2001,12,Students,19,109,6,0,0,134,28,101,1,0,0,130,47,210,7,0,0,264
GUJARAT,2001,12,Unemployed,5,210,137,66,8,426,6,27,28,10,0,71,11,237,165,76,8,497
GUJARAT,2001,12,Professional Activity,0,98,127,86,14,325,0,18,5,2,2,27,0,116,132,88,16,352
GUJARAT,2001,12,Agriculture (Total),1,188,213,84,31,517,2,34,30,7,4,77,3,222,243,91,35,594
GUJARAT,2001,12,Retired Persons,0,0,0,13,43,56,0,0,0,5,38,43,0,0,0,18,81,99
GUJARAT,2002,12,House Wife,0,0,0,0,0,0,2,698,508,191,62,1461,2,698,508,191,62,1461
GUJARAT,2002,12,Service (Government),0,10,12,18,0,40,0,3,0,0,0,3,0,13,12,18,0,43
GUJARAT,2002,12,Service (Private),0,108,155,46,8,317,0,18,8,7,0,33,0,126,163,53,8,350
GUJARAT,2002,12,Public Sector Undertaking,0,24,31,13,4,72,0,6,1,1,0,8,0,30,32,14,4,80
GUJARAT,2002,12,Students,16,127,12,0,0,155,26,85,3,0,0,114,42,212,15,0,0,269
GUJARAT,2002,12,Unemployed,1,192,169,92,13,467,1,30,18,8,2,59,2,222,187,100,15,526
GUJARAT,2002,12,Professional Activity,1,117,125,93,8,344,0,15,1,3,0,19,1,132,126,96,8,363
GUJARAT,2002,12,Agriculture (Total),0,173,208,74,27,482,2,43,22,16,5,88,2,216,230,90,32,570
GUJARAT,2002,12,Retired Persons,0,0,0,18,45,63,0,0,2,3,28,33,0,0,2,21,73,96
GUJARAT,2003,12,House Wife,0,0,0,0,0,0,1,608,466,202,97,1374,1,608,466,202,97,1374
GUJARAT,2003,12,Service (Government),0,21,33,15,2,71,0,1,4,0,0,5,0,22,37,15,2,76
GUJARAT,2003,12,Service (Private),0,120,144,56,6,326,0,34,18,3,0,55,0,154,162,59,6,381
GUJARAT,2003,12,Public Sector Undertaking,0,8,18,11,0,37,0,7,3,0,0,10,0,15,21,11,0,47
GUJARAT,2003,12,Students,12,77,2,0,0,91,21,73,1,1,0,96,33,150,3,1,0,187
GUJARAT,2003,12,Unemployed,0,176,153,64,12,405,3,30,16,6,1,56,3,206,169,70,13,461
GUJARAT,2003,12,Professional Activity,0,143,135,81,17,376,0,8,1,0,5,14,0,151,136,81,22,390
GUJARAT,2003,12,Agriculture (Total),0,149,169,121,30,469,0,46,33,24,9,112,0,195,202,145,39,581
GUJARAT,2003,12,Retired Persons,0,5,6,17,57,85,0,2,3,4,29,38,0,7,9,21,86,123
GUJARAT,2004,12,House Wife,0,0,0,0,0,0,6,616,489,190,59,1360,6,616,489,190,59,1360
GUJARAT,2004,12,Service (Government),0,15,30,15,0,60,0,1,4,1,0,6,0,16,34,16,0,66
GUJARAT,2004,12,Service (Private),0,107,153,81,10,351,0,40,19,9,1,69,0,147,172,90,11,420
GUJARAT,2004,12,Public Sector Undertaking,0,9,14,16,2,41,0,1,1,0,0,2,0,10,15,16,2,43
GUJARAT,2004,12,Students,15,115,10,0,0,140,13,92,1,0,1,107,28,207,11,0,1,247
GUJARAT,2004,12,Unemployed,1,171,170,73,10,425,0,27,19,6,0,52,1,198,189,79,10,477
GUJARAT,2004,12,Professional Activity,0,123,141,85,16,365,0,10,8,2,1,21,0,133,149,87,17,386
GUJARAT,2004,12,Agriculture (Total),0,134,153,123,42,452,0,31,20,18,2,71,0,165,173,141,44,523
GUJARAT,2004,12,Retired Persons,0,0,0,15,46,61,0,0,0,11,30,41,0,0,0,26,76,102
GUJARAT,2005,12,House Wife,0,0,0,0,0,0,0,548,498,203,71,1320,0,548,498,203,71,1320
GUJARAT,2005,12,Service (Government),0,21,35,17,0,73,0,1,1,2,0,4,0,22,36,19,0,77
GUJARAT,2005,12,Service (Private),0,135,191,97,5,428,0,32,19,5,0,56,0,167,210,102,5,484
GUJARAT,2005,12,Public Sector Undertaking,0,18,33,16,0,67,0,2,1,0,0,3,0,20,34,16,0,70
GUJARAT,2005,12,Students,16,82,7,0,0,105,21,99,0,0,0,120,37,181,7,0,0,225
GUJARAT,2005,12,Unemployed,1,151,140,75,5,372,1,26,8,3,2,40,2,177,148,78,7,412
GUJARAT,2005,12,Professional Activity,0,120,115,68,17,320,0,10,3,0,0,13,0,130,118,68,17,333
GUJARAT,2005,12,Agriculture (Total),0,159,182,136,42,519,2,45,29,16,4,96,2,204,211,152,46,615
GUJARAT,2005,12,Retired Persons,0,0,1,35,68,104,0,0,0,5,23,28,0,0,1,40,91,132
GUJARAT,2006,12,House Wife,0,0,0,0,0,0,0,651,469,219,57,1396,0,651,469,219,57,1396
GUJARAT,2006,12,Service (Government),0,8,22,14,1,45,0,5,3,1,0,9,0,13,25,15,1,54
GUJARAT,2006,12,Service (Private),0,141,215,102,3,461,0,37,25,8,0,70,0,178,240,110,3,531
GUJARAT,2006,12,Public Sector Undertaking,0,13,17,10,1,41,0,10,4,1,0,15,0,23,21,11,1,56
GUJARAT,2006,12,Students,24,100,13,0,0,137,17,85,1,0,0,103,41,185,14,0,0,240
GUJARAT,2006,12,Unemployed,0,162,154,86,8,410,0,19,22,5,0,46,0,181,176,91,8,456
GUJARAT,2006,12,Professional Activity,0,126,141,87,16,370,2,10,12,5,0,29,2,136,153,92,16,399
GUJARAT,2006,12,Agriculture (Total),0,101,175,116,19,411,3,24,29,14,6,76,3,125,204,130,25,487
GUJARAT,2006,12,Retired Persons,0,2,1,24,86,113,0,0,0,7,50,57,0,2,1,31,136,170
GUJARAT,2007,12,House Wife,0,0,0,0,0,0,2,729,540,235,107,1613,2,729,540,235,107,1613
GUJARAT,2007,12,Service (Government),0,29,37,19,0,85,0,8,7,4,1,20,0,37,44,23,1,105
GUJARAT,2007,12,Service (Private),0,190,215,105,6,516,1,26,19,8,1,55,1,216,234,113,7,571
GUJARAT,2007,12,Public Sector Undertaking,0,37,59,42,2,140,0,7,7,1,0,15,0,44,66,43,2,155
GUJARAT,2007,12,Students,23,123,6,3,0,155,26,102,17,3,0,148,49,225,23,6,0,303
GUJARAT,2007,12,Unemployed,1,179,182,73,8,443,1,23,22,9,2,57,2,202,204,82,10,500
GUJARAT,2007,12,Professional Activity,0,179,173,79,23,454,0,16,15,5,1,37,0,195,188,84,24,491
GUJARAT,2007,12,Agriculture (Total),0,60,128,81,20,289,0,12,8,5,3,28,0,72,136,86,23,317
GUJARAT,2007,12,Retired Persons,0,20,23,34,98,175,0,7,0,14,28,49,0,27,23,48,126,224
GUJARAT,2008,12,House Wife,0,0,0,0,0,0,3,751,622,255,113,1744,3,751,622,255,113,1744
GUJARAT,2008,12,Service (Government),0,9,30,18,0,57,0,2,3,0,0,5,0,11,33,18,0,62
GUJARAT,2008,12,Service (Private),0,178,244,119,3,544,0,25,30,9,0,64,0,203,274,128,3,608
GUJARAT,2008,12,Public Sector Undertaking,0,23,55,22,2,102,0,16,7,2,0,25,0,39,62,24,2,127
GUJARAT,2008,12,Students,13,131,9,2,0,155,18,122,7,2,0,149,31,253,16,4,0,304
GUJARAT,2008,12,Unemployed,1,206,219,76,11,513,4,28,8,4,1,45,5,234,227,80,12,558
GUJARAT,2008,12,Professional Activity,0,155,161,85,19,420,0,4,4,0,0,8,0,159,165,85,19,428
GUJARAT,2008,12,Agriculture (Total),0,115,182,92,52,441,1,21,19,38,6,85,1,136,201,130,58,526
GUJARAT,2008,12,Retired Persons,0,3,1,48,90,142,0,0,0,11,34,45,0,3,1,59,124,187
GUJARAT,2009,12,House Wife,0,0,0,0,0,0,3,781,580,262,110,1736,3,781,580,262,110,1736
GUJARAT,2009,12,Service (Government),0,10,19,13,1,43,0,17,4,4,1,26,0,27,23,17,2,69
GUJARAT,2009,12,Service (Private),0,192,247,133,9,581,0,16,24,8,0,48,0,208,271,141,9,629
GUJARAT,2009,12,Public Sector Undertaking,0,24,48,17,2,91,0,13,6,5,0,24,0,37,54,22,2,115
GUJARAT,2009,12,Students,17,154,2,1,0,174,25,118,10,1,0,154,42,272,12,2,0,328
GUJARAT,2009,12,Unemployed,1,184,226,69,19,499,0,43,28,7,2,80,1,227,254,76,21,579
GUJARAT,2009,12,Professional Activity,0,180,198,109,22,509,0,21,16,6,0,43,0,201,214,115,22,552
GUJARAT,2009,12,Agriculture (Total),0,153,198,107,40,498,0,36,30,14,10,90,0,189,228,121,50,588
GUJARAT,2009,12,Retired Persons,0,1,1,16,76,94,0,0,1,2,21,24,0,1,2,18,97,118
GUJARAT,2010,12,House Wife,0,0,0,0,0,0,2,726,512,253,82,1575,2,726,512,253,82,1575
GUJARAT,2010,12,Service (Government),0,17,31,14,0,62,0,6,5,2,0,13,0,23,36,16,0,75
GUJARAT,2010,12,Service (Private),0,197,202,116,9,524,0,42,44,11,1,98,0,239,246,127,10,622
GUJARAT,2010,12,Public Sector Undertaking,0,23,31,20,3,77,0,11,7,6,0,24,0,34,38,26,3,101
GUJARAT,2010,12,Students,19,125,6,1,0,151,18,121,3,0,0,142,37,246,9,1,0,293
GUJARAT,2010,12,Unemployed,1,217,231,81,18,548,0,39,17,5,0,61,1,256,248,86,18,609
GUJARAT,2010,12,Professional Activity,2,116,127,63,13,321,0,10,5,4,0,19,2,126,132,67,13,340
GUJARAT,2010,12,Agriculture (Total),1,127,201,104,25,458,1,18,25,17,4,65,2,145,226,121,29,523
GUJARAT,2010,12,Retired Persons,0,2,1,11,85,99,0,0,0,8,44,52,0,2,1,19,129,151
GUJARAT,2011,12,House Wife,0,0,0,0,0,0,4,719,512,258,78,1571,4,719,512,258,78,1571
GUJARAT,2011,12,Service (Government),0,18,26,16,0,60,0,7,2,2,3,14,0,25,28,18,3,74
GUJARAT,2011,12,Service (Private),0,226,226,119,10,581,0,39,31,17,5,92,0,265,257,136,15,673
GUJARAT,2011,12,Public Sector Undertaking,0,31,35,24,8,98,0,8,9,9,0,26,0,39,44,33,8,124
GUJARAT,2011,12,Students,24,146,8,0,0,178,36,110,2,0,0,148,60,256,10,0,0,326
GUJARAT,2011,12,Unemployed,2,163,182,82,14,443,0,24,18,6,0,48,2,187,200,88,14,491
GUJARAT,2011,12,Professional Activity,0,210,185,107,29,531,2,31,24,2,2,61,2,241,209,109,31,592
GUJARAT,2011,12,Agriculture (Total),1,133,189,118,32,473,3,25,35,31,11,105,4,158,224,149,43,578
GUJARAT,2011,12,Retired Persons,0,3,1,29,70,103,0,0,0,11,43,54,0,3,1,40,113,157
GUJARAT,2012,12,House Wife,0,0,0,0,0,0,2,800,595,310,88,1795,2,800,595,310,88,1795
GUJARAT,2012,12,Service (Government),0,20,35,20,0,75,0,6,3,7,0,16,0,26,38,27,0,91
GUJARAT,2012,12,Service (Private),1,277,329,137,14,758,0,61,54,22,0,137,1,338,383,159,14,895
GUJARAT,2012,12,Public Sector Undertaking,0,38,52,21,4,115,0,12,17,5,1,35,0,50,69,26,5,150
GUJARAT,2012,12,Students,23,188,4,0,0,215,23,148,2,0,0,173,46,336,6,0,0,388
GUJARAT,2012,12,Unemployed,7,191,215,91,7,511,4,18,14,10,0,46,11,209,229,101,7,557
GUJARAT,2012,12,Professional Activity,1,189,168,97,23,478,0,20,9,2,1,32,1,209,177,99,24,510
GUJARAT,2012,12,Agriculture (Total),2,138,193,110,29,472,4,46,23,16,3,92,6,184,216,126,32,564
GUJARAT,2012,12,Retired Persons,0,4,4,29,102,139,3,3,2,6,33,47,3,7,6,35,135,186
GUJARAT,2013,12,House Wife,0,0,0,0,0,0,3,754,575,295,105,1732,3,754,575,295,105,1732
GUJARAT,2013,12,Service (Government),0,20,58,31,0,109,0,10,7,1,0,18,0,30,65,32,0,127
GUJARAT,2013,12,Service (Private),0,228,284,145,15,672,0,48,28,12,0,88,0,276,312,157,15,760
GUJARAT,2013,12,Public Sector Undertaking,0,39,37,26,4,106,1,13,15,7,0,36,1,52,52,33,4,142
GUJARAT,2013,12,Students,19,170,8,0,0,197,20,165,4,0,0,189,39,335,12,0,0,386
GUJARAT,2013,12,Unemployed,0,173,231,117,3,524,1,23,14,5,3,46,1,196,245,122,6,570
GUJARAT,2013,12,Professional Activity,1,215,237,169,32,654,0,34,8,12,2,56,1,249,245,181,34,710
GUJARAT,2013,12,Agriculture (Total),2,158,181,121,27,489,0,42,30,15,6,93,2,200,211,136,33,582
GUJARAT,2013,12,Retired Persons,0,0,0,34,136,170,0,2,1,0,50,53,0,2,1,34,186,223
GUJARAT,2014,12,House Wife,0,0,0,0,0,0,2,809,605,264,89,1769,2,809,605,264,89,1769
GUJARAT,2014,12,Service (Government),0,23,45,28,0,96,0,6,6,0,0,12,0,29,51,28,0,108
GUJARAT,2014,12,Service (Private),0,142,198,78,4,422,0,9,9,1,0,19,0,151,207,79,4,441
GUJARAT,2014,12,Public Sector Undertaking,0,12,15,9,0,36,0,3,1,1,0,5,0,15,16,10,0,41
GUJARAT,2014,12,Students,8,167,8,0,0,183,15,165,4,0,0,184,23,332,12,0,0,367
GUJARAT,2014,12,Unemployed,0,188,170,82,10,450,0,7,1,1,2,11,0,195,171,83,12,461
GUJARAT,2014,12,Agriculture (Total),0,174,199,104,36,513,1,44,23,10,9,87,1,218,222,114,45,600
GUJARAT,2014,12,Retired Persons,0,2,7,32,70,111,0,0,0,1,30,31,0,2,7,33,100,142
HARYANA,2001,13,House Wife,0,0,0,0,0,0,0,167,104,15,11,297,0,167,104,15,11,297
HARYANA,2001,13,Service (Government),0,25,32,16,0,73,0,0,13,8,0,21,0,25,45,24,0,94
HARYANA,2001,13,Service (Private),0,40,45,13,0,98,0,24,15,6,2,47,0,64,60,19,2,145
HARYANA,2001,13,Public Sector Undertaking,0,33,29,4,0,66,0,14,13,1,0,28,0,47,42,5,0,94
HARYANA,2001,13,Students,15,64,8,0,0,87,7,29,2,3,0,41,22,93,10,3,0,128
HARYANA,2001,13,Unemployed,13,117,52,42,3,227,7,26,18,9,0,60,20,143,70,51,3,287
HARYANA,2001,13,Professional Activity,0,17,33,12,2,64,0,0,1,0,0,1,0,17,34,12,2,65
HARYANA,2001,13,Agriculture (Total),0,50,43,27,13,133,0,6,3,3,0,12,0,56,46,30,13,145
HARYANA,2001,13,Retired Persons,0,0,0,1,17,18,0,0,0,0,4,4,0,0,0,1,21,22
HARYANA,2002,13,House Wife,0,0,0,0,0,0,1,198,131,31,10,371,1,198,131,31,10,371
HARYANA,2002,13,Service (Government),0,18,28,20,0,66,0,9,13,9,0,31,0,27,41,29,0,97
HARYANA,2002,13,Service (Private),0,66,107,31,4,208,0,26,9,0,0,35,0,92,116,31,4,243
HARYANA,2002,13,Public Sector Undertaking,0,29,34,2,0,65,0,5,9,0,0,14,0,34,43,2,0,79
HARYANA,2002,13,Students,10,69,20,0,0,99,1,55,2,0,0,58,11,124,22,0,0,157
HARYANA,2002,13,Unemployed,1,67,73,51,2,194,0,2,7,2,0,11,1,69,80,53,2,205
HARYANA,2002,13,Professional Activity,0,9,11,9,3,32,0,1,0,0,0,1,0,10,11,9,3,33
HARYANA,2002,13,Agriculture (Total),0,52,66,40,9,167,0,15,6,0,2,23,0,67,72,40,11,190
HARYANA,2002,13,Retired Persons,0,0,1,3,4,8,0,0,7,2,0,9,0,0,8,5,4,17
HARYANA,2003,13,House Wife,0,0,0,0,0,0,0,173,107,29,12,321,0,173,107,29,12,321
HARYANA,2003,13,Service (Government),0,20,28,20,0,68,0,5,4,1,0,10,0,25,32,21,0,78
HARYANA,2003,13,Service (Private),6,68,90,25,1,190,0,26,8,2,0,36,6,94,98,27,1,226
HARYANA,2003,13,Public Sector Undertaking,0,17,33,4,0,54,0,10,6,1,0,17,0,27,39,5,0,71
HARYANA,2003,13,Students,5,69,12,0,0,86,10,28,1,0,0,39,15,97,13,0,0,125
HARYANA,2003,13,Unemployed,2,89,65,25,3,184,1,17,7,3,0,28,3,106,72,28,3,212
HARYANA,2003,13,Professional Activity,0,11,13,9,0,33,0,0,0,0,0,0,0,11,13,9,0,33
HARYANA,2003,13,Agriculture (Total),1,59,66,51,15,192,0,5,6,4,0,15,1,64,72,55,15,207
HARYANA,2003,13,Retired Persons,0,0,0,10,13,23,0,0,0,4,3,7,0,0,0,14,16,30
HARYANA,2004,13,House Wife,0,0,0,0,0,0,1,157,120,37,15,330,1,157,120,37,15,330
HARYANA,2004,13,Service (Government),0,20,28,19,0,67,0,11,4,1,0,16,0,31,32,20,0,83
HARYANA,2004,13,Service (Private),0,62,82,26,2,172,0,27,8,2,0,37,0,89,90,28,2,209
HARYANA,2004,13,Public Sector Undertaking,0,13,32,5,0,50,0,3,6,1,0,10,0,16,38,6,0,60
HARYANA,2004,13,Students,5,71,3,0,0,79,11,27,0,0,0,38,16,98,3,0,0,117
HARYANA,2004,13,Unemployed,4,71,72,34,6,187,3,6,10,5,0,24,7,77,82,39,6,211
HARYANA,2004,13,Professional Activity,0,1,19,13,0,33,0,0,0,0,0,0,0,1,19,13,0,33
HARYANA,2004,13,Agriculture (Total),0,40,56,38,10,144,0,6,6,4,0,16,0,46,62,42,10,160
HARYANA,2004,13,Retired Persons,0,0,0,0,9,9,0,0,0,0,0,0,0,0,0,0,9,9
HARYANA,2005,13,House Wife,0,0,0,0,0,0,2,119,125,49,8,303,2,119,125,49,8,303
HARYANA,2005,13,Service (Government),0,14,16,7,0,37,0,1,5,0,0,6,0,15,21,7,0,43
HARYANA,2005,13,Service (Private),0,72,48,24,0,144,1,6,3,1,0,11,1,78,51,25,0,155
HARYANA,2005,13,Public Sector Undertaking,0,4,10,1,0,15,0,3,2,0,0,5,0,7,12,1,0,20
HARYANA,2005,13,Students,7,57,3,0,0,67,6,25,3,0,0,34,13,82,6,0,0,101
HARYANA,2005,13,Unemployed,5,64,54,17,6,146,0,7,4,1,1,13,5,71,58,18,7,159
HARYANA,2005,13,Professional Activity,0,6,11,0,1,18,1,0,0,0,0,1,1,6,11,0,1,19
HARYANA,2005,13,Agriculture (Total),1,37,57,23,10,128,2,6,2,2,0,12,3,43,59,25,10,140
HARYANA,2005,13,Retired Persons,0,0,6,4,1,11,0,0,2,2,1,5,0,0,8,6,2,16
HARYANA,2006,13,House Wife,0,0,0,0,0,0,2,152,110,40,15,319,2,152,110,40,15,319
HARYANA,2006,13,Service (Government),0,13,28,8,0,49,0,5,5,0,0,10,0,18,33,8,0,59
HARYANA,2006,13,Service (Private),0,129,127,58,7,321,0,12,23,15,4,54,0,141,150,73,11,375
HARYANA,2006,13,Public Sector Undertaking,0,14,50,14,0,78,0,16,5,0,0,21,0,30,55,14,0,99
HARYANA,2006,13,Students,8,75,3,0,0,86,10,30,0,0,0,40,18,105,3,0,0,126
HARYANA,2006,13,Unemployed,1,81,105,51,5,243,0,5,7,2,1,15,1,86,112,53,6,258
HARYANA,2006,13,Professional Activity,0,10,8,6,0,24,0,2,0,0,0,2,0,12,8,6,0,26
HARYANA,2006,13,Agriculture (Total),0,48,78,35,20,181,0,6,2,1,0,9,0,54,80,36,20,190
HARYANA,2006,13,Retired Persons,1,20,18,10,5,54,0,1,0,0,0,1,1,21,18,10,5,55
HARYANA,2007,13,House Wife,0,0,0,0,0,0,0,193,110,37,16,356,0,193,110,37,16,356
HARYANA,2007,13,Service (Government),0,18,25,20,1,64,0,12,3,0,0,15,0,30,28,20,1,79
HARYANA,2007,13,Service (Private),0,99,95,28,2,224,0,18,4,0,0,22,0,117,99,28,2,246
HARYANA,2007,13,Public Sector Undertaking,0,29,42,4,0,75,0,5,6,1,0,12,0,34,48,5,0,87
HARYANA,2007,13,Students,8,68,4,0,0,80,4,34,3,1,0,42,12,102,7,1,0,122
HARYANA,2007,13,Unemployed,2,111,108,32,6,259,0,5,12,6,0,23,2,116,120,38,6,282
HARYANA,2007,13,Professional Activity,0,5,23,29,0,57,0,0,0,0,0,0,0,5,23,29,0,57
HARYANA,2007,13,Agriculture (Total),0,68,63,37,11,179,0,0,0,0,0,0,0,68,63,37,11,179
HARYANA,2007,13,Retired Persons,0,13,26,16,18,73,0,1,0,0,1,2,0,14,26,16,19,75
HARYANA,2008,13,House Wife,0,0,0,0,0,0,0,159,135,52,20,366,0,159,135,52,20,366
HARYANA,2008,13,Service (Government),0,29,40,14,7,90,0,3,0,0,0,3,0,32,40,14,7,93
HARYANA,2008,13,Service (Private),0,95,101,38,5,239,0,9,2,0,0,11,0,104,103,38,5,250
HARYANA,2008,13,Public Sector Undertaking,0,41,33,11,7,92,0,3,1,0,0,4,0,44,34,11,7,96
HARYANA,2008,13,Students,10,78,3,1,0,92,15,28,0,0,0,43,25,106,3,1,0,135
HARYANA,2008,13,Unemployed,0,47,75,30,7,159,0,6,12,5,1,24,0,53,87,35,8,183
HARYANA,2008,13,Professional Activity,0,12,28,9,1,50,0,0,0,0,0,0,0,12,28,9,1,50
HARYANA,2008,13,Agriculture (Total),0,34,62,36,18,150,0,0,0,0,0,0,0,34,62,36,18,150
HARYANA,2008,13,Retired Persons,0,1,0,0,7,8,0,2,0,2,0,4,0,3,0,2,7,12
HARYANA,2009,13,House Wife,0,0,0,0,0,0,2,176,196,57,10,441,2,176,196,57,10,441
HARYANA,2009,13,Service (Government),0,26,34,15,5,80,0,3,3,0,0,6,0,29,37,15,5,86
HARYANA,2009,13,Service (Private),0,100,98,47,8,253,0,16,13,3,0,32,0,116,111,50,8,285
HARYANA,2009,13,Public Sector Undertaking,0,35,19,8,2,64,0,7,0,0,0,7,0,42,19,8,2,71
HARYANA,2009,13,Students,10,70,3,0,0,83,16,16,0,0,0,32,26,86,3,0,0,115
HARYANA,2009,13,Unemployed,0,86,90,37,7,220,0,17,15,0,1,33,0,103,105,37,8,253
HARYANA,2009,13,Professional Activity,0,7,13,8,0,28,0,0,0,0,0,0,0,7,13,8,0,28
HARYANA,2009,13,Agriculture (Total),0,44,107,62,12,225,0,1,2,2,0,5,0,45,109,64,12,230
HARYANA,2009,13,Retired Persons,0,0,0,0,0,0,0,0,0,0,0,0,0,0,0,0,0,0
HARYANA,2010,13,House Wife,0,0,0,0,0,0,0,174,124,50,16,364,0,174,124,50,16,364
HARYANA,2010,13,Service (Government),0,14,16,10,0,40,0,24,18,3,0,45,0,38,34,13,0,85
HARYANA,2010,13,Service (Private),0,78,72,42,2,194,0,18,7,2,0,27,0,96,79,44,2,221
HARYANA,2010,13,Public Sector Undertaking,0,8,2,1,0,11,1,4,0,0,0,5,1,12,2,1,0,16
HARYANA,2010,13,Students,12,101,6,0,0,119,8,21,0,0,0,29,20,122,6,0,0,148
HARYANA,2010,13,Unemployed,3,143,118,67,16,347,0,21,9,4,3,37,3,164,127,71,19,384
HARYANA,2010,13,Professional Activity,0,14,17,13,1,45,0,0,0,0,0,0,0,14,17,13,1,45
HARYANA,2010,13,Agriculture (Total),0,94,103,59,25,281,0,9,5,2,0,16,0,103,108,61,25,297
HARYANA,2010,13,Retired Persons,0,0,0,0,0,0,0,0,0,0,0,0,0,0,0,0,0,0
HARYANA,2011,13,House Wife,0,0,0,0,0,0,0,203,148,56,9,416,0,203,148,56,9,416
HARYANA,2011,13,Service (Government),0,20,28,24,0,72,0,2,5,0,0,7,0,22,33,24,0,79
HARYANA,2011,13,Service (Private),0,75,91,22,5,193,0,11,7,2,0,20,0,86,98,24,5,213
HARYANA,2011,13,Public Sector Undertaking,0,9,9,2,0,20,0,5,0,0,0,5,0,14,9,2,0,25
HARYANA,2011,13,Students,14,105,5,5,0,129,4,47,0,0,0,51,18,152,5,5,0,180
HARYANA,2011,13,Unemployed,4,91,146,75,16,332,0,15,11,17,1,44,4,106,157,92,17,376
HARYANA,2011,13,Professional Activity,0,8,13,3,0,24,0,0,0,0,0,0,0,8,13,3,0,24
HARYANA,2011,13,Agriculture (Total),0,140,113,74,23,350,0,8,18,8,0,34,0,148,131,82,23,384
HARYANA,2011,13,Retired Persons,0,1,0,1,0,2,0,0,0,0,0,0,0,1,0,1,0,2
HARYANA,2012,13,House Wife,0,0,0,0,0,0,0,221,119,37,12,389,0,221,119,37,12,389
HARYANA,2012,13,Service (Government),0,15,17,16,0,48,0,2,1,0,0,3,0,17,18,16,0,51
HARYANA,2012,13,Service (Private),4,88,102,38,3,235,0,4,4,4,0,12,4,92,106,42,3,247
HARYANA,2012,13,Public Sector Undertaking,0,25,22,5,0,52,0,1,4,0,0,5,0,26,26,5,0,57
HARYANA,2012,13,Students,11,86,7,5,0,109,6,27,0,0,0,33,17,113,7,5,0,142
HARYANA,2012,13,Unemployed,2,120,108,52,11,293,1,12,16,4,1,34,3,132,124,56,12,327
HARYANA,2012,13,Professional Activity,0,11,21,9,0,41,0,0,0,0,0,0,0,11,21,9,0,41
HARYANA,2012,13,Agriculture (Total),0,53,100,73,25,251,0,9,12,2,2,25,0,62,112,75,27,276
HARYANA,2012,13,Retired Persons,0,0,0,2,1,3,0,0,0,0,0,0,0,0,0,2,1,3
HARYANA,2013,13,House Wife,0,0,0,0,0,0,0,239,112,38,12,401,0,239,112,38,12,401
HARYANA,2013,13,Service (Government),0,7,12,18,0,37,0,1,2,0,0,3,0,8,14,18,0,40
HARYANA,2013,13,Service (Private),1,84,112,53,4,254,0,14,13,6,0,33,1,98,125,59,4,287
HARYANA,2013,13,Public Sector Undertaking,0,48,43,18,0,109,0,2,7,2,0,11,0,50,50,20,0,120
HARYANA,2013,13,Students,18,97,6,0,0,121,10,44,0,1,1,56,28,141,6,1,1,177
HARYANA,2013,13,Unemployed,1,111,110,63,7,292,0,8,5,5,1,19,1,119,115,68,8,311
HARYANA,2013,13,Professional Activity,0,8,12,8,1,29,0,0,0,0,0,0,0,8,12,8,1,29
HARYANA,2013,13,Agriculture (Total),0,79,110,114,33,336,0,13,12,12,1,38,0,92,122,126,34,374
HARYANA,2013,13,Retired Persons,0,0,1,2,1,4,0,0,0,2,0,2,0,0,1,4,1,6
HARYANA,2014,13,House Wife,0,0,0,0,0,0,1,169,88,32,15,305,1,169,88,32,15,305
HARYANA,2014,13,Service (Government),0,10,23,16,4,53,0,4,3,1,0,8,0,14,26,17,4,61
HARYANA,2014,13,Service (Private),0,29,53,23,4,109,0,11,14,1,0,26,0,40,67,24,4,135
HARYANA,2014,13,Public Sector Undertaking,0,12,15,12,1,40,0,1,2,1,0,4,0,13,17,13,1,44
HARYANA,2014,13,Students,12,99,8,0,2,121,4,36,2,0,0,42,16,135,10,0,2,163
HARYANA,2014,13,Unemployed,4,95,83,45,5,232,0,3,0,1,0,4,4,98,83,46,5,236
HARYANA,2014,13,Agriculture (Total),0,39,50,26,4,119,0,0,0,0,0,0,0,39,50,26,4,119
HARYANA,2014,13,Retired Persons,0,2,2,3,3,10,0,0,0,0,0,0,0,2,2,3,3,10
HIMACHAL PRADESH,2001,14,House Wife,0,0,0,0,0,0,0,44,26,12,2,84,0,44,26,12,2,84
HIMACHAL PRADESH,2001,14,Service (Government),0,0,5,3,0,8,0,2,1,0,0,3,0,2,6,3,0,11
HIMACHAL PRADESH,2001,14,Service (Private),0,6,9,8,1,24,0,0,0,0,0,0,0,6,9,8,1,24
HIMACHAL PRADESH,2001,14,Public Sector Undertaking,0,0,3,4,0,7,0,0,0,0,0,0,0,0,3,4,0,7
HIMACHAL PRADESH,2001,14,Students,0,8,0,0,0,8,2,9,0,0,0,11,2,17,0,0,0,19
HIMACHAL PRADESH,2001,14,Unemployed,0,18,9,4,0,31,0,6,1,0,0,7,0,24,10,4,0,38
HIMACHAL PRADESH,2001,14,Professional Activity,0,0,2,0,0,2,0,0,1,0,0,1,0,0,3,0,0,3
HIMACHAL PRADESH,2001,14,Agriculture (Total),0,3,9,8,2,22,0,0,0,0,0,0,0,3,9,8,2,22
HIMACHAL PRADESH,2001,14,Retired Persons,0,0,0,1,0,1,0,0,0,0,0,0,0,0,0,1,0,1
HIMACHAL PRADESH,2002,14,House Wife,0,0,0,0,0,0,2,46,29,5,1,83,2,46,29,5,1,83
HIMACHAL PRADESH,2002,14,Service (Government),0,3,6,2,0,11,0,1,1,0,0,2,0,4,7,2,0,13
HIMACHAL PRADESH,2002,14,Service (Private),0,6,5,1,0,12,0,0,0,0,0,0,0,6,5,1,0,12
HIMACHAL PRADESH,2002,14,Public Sector Undertaking,0,2,1,1,0,4,0,0,0,1,0,1,0,2,1,2,0,5
HIMACHAL PRADESH,2002,14,Students,2,16,1,0,0,19,1,11,0,0,0,12,3,27,1,0,0,31
HIMACHAL PRADESH,2002,14,Unemployed,0,11,6,7,1,25,0,3,1,0,0,4,0,14,7,7,1,29
HIMACHAL PRADESH,2002,14,Professional Activity,0,0,12,0,0,12,0,0,1,0,0,1,0,0,13,0,0,13
HIMACHAL PRADESH,2002,14,Agriculture (Total),0,7,12,3,2,24,0,0,0,1,0,1,0,7,12,4,2,25
HIMACHAL PRADESH,2002,14,Retired Persons,0,0,0,0,0,0,0,0,0,0,0,0,0,0,0,0,0,0
HIMACHAL PRADESH,2003,14,House Wife,0,0,0,0,0,0,0,37,25,10,0,72,0,37,25,10,0,72
HIMACHAL PRADESH,2003,14,Service (Government),0,1,8,5,0,14,0,0,1,1,0,2,0,1,9,6,0,16
HIMACHAL PRADESH,2003,14,Service (Private),0,8,12,9,1,30,0,1,1,0,0,2,0,9,13,9,1,32
HIMACHAL PRADESH,2003,14,Public Sector Undertaking,0,0,2,0,0,2,0,0,0,0,0,0,0,0,2,0,0,2
HIMACHAL PRADESH,2003,14,Students,2,9,0,0,0,11,4,15,0,0,0,19,6,24,0,0,0,30
HIMACHAL PRADESH,2003,14,Unemployed,0,24,15,0,2,41,0,1,0,0,0,1,0,25,15,0,2,42
HIMACHAL PRADESH,2003,14,Professional Activity,0,1,0,0,1,2,0,0,0,0,0,0,0,1,0,0,1,2
HIMACHAL PRADESH,2003,14,Agriculture (Total),0,5,13,10,1,29,0,2,3,0,0,5,0,7,16,10,1,34
HIMACHAL PRADESH,2003,14,Retired Persons,0,0,0,0,1,1,0,0,0,0,0,0,0,0,0,0,1,1
HIMACHAL PRADESH,2004,14,House Wife,0,0,0,0,0,0,0,40,24,9,2,75,0,40,24,9,2,75
HIMACHAL PRADESH,2004,14,Service (Government),0,6,4,3,0,13,0,0,0,1,0,1,0,6,4,4,0,14
HIMACHAL PRADESH,2004,14,Service (Private),1,21,21,4,2,49,0,1,1,0,0,2,1,22,22,4,2,51
HIMACHAL PRADESH,2004,14,Public Sector Undertaking,0,1,0,1,0,2,0,0,0,0,0,0,0,1,0,1,0,2
HIMACHAL PRADESH,2004,14,Students,4,7,0,0,0,11,2,9,1,0,0,12,6,16,1,0,0,23
HIMACHAL PRADESH,2004,14,Unemployed,0,18,10,2,4,34,0,12,0,0,0,12,0,30,10,2,4,46
HIMACHAL PRADESH,2004,14,Professional Activity,0,0,0,1,0,1,0,0,0,0,0,0,0,0,0,1,0,1
HIMACHAL PRADESH,2004,14,Agriculture (Total),0,14,14,13,2,43,0,3,4,1,1,9,0,17,18,14,3,52
HIMACHAL PRADESH,2004,14,Retired Persons,0,0,0,0,0,0,0,0,0,0,0,0,0,0,0,0,0,0
HIMACHAL PRADESH,2005,14,House Wife,0,0,0,0,0,0,0,41,26,8,0,75,0,41,26,8,0,75
HIMACHAL PRADESH,2005,14,Service (Government),0,1,9,4,0,14,0,1,1,0,0,2,0,2,10,4,0,16
HIMACHAL PRADESH,2005,14,Service (Private),0,10,14,4,1,29,0,0,0,0,0,0,0,10,14,4,1,29
HIMACHAL PRADESH,2005,14,Public Sector Undertaking,0,1,5,1,0,7,0,1,0,0,0,1,0,2,5,1,0,8
HIMACHAL PRADESH,2005,14,Students,0,9,1,0,0,10,1,14,0,0,0,15,1,23,1,0,0,25
HIMACHAL PRADESH,2005,14,Unemployed,0,9,9,1,0,19,0,5,3,0,0,8,0,14,12,1,0,27
HIMACHAL PRADESH,2005,14,Professional Activity,0,1,3,0,0,4,0,0,0,0,0,0,0,1,3,0,0,4
HIMACHAL PRADESH,2005,14,Agriculture (Total),0,8,3,7,2,20,0,0,0,0,0,0,0,8,3,7,2,20
HIMACHAL PRADESH,2005,14,Retired Persons,0,0,0,0,0,0,0,0,0,0,0,0,0,0,0,0,0,0
HIMACHAL PRADESH,2006,14,House Wife,0,0,0,0,0,0,0,31,22,21,4,78,0,31,22,21,4,78
HIMACHAL PRADESH,2006,14,Service (Government),0,7,8,6,0,21,0,0,0,1,0,1,0,7,8,7,0,22
HIMACHAL PRADESH,2006,14,Service (Private),0,12,19,15,1,47,0,6,1,3,0,10,0,18,20,18,1,57
HIMACHAL PRADESH,2006,14,Public Sector Undertaking,0,10,24,4,2,40,0,1,0,0,0,1,0,11,24,4,2,41
HIMACHAL PRADESH,2006,14,Students,4,14,2,0,0,20,1,18,1,0,0,20,5,32,3,0,0,40
HIMACHAL PRADESH,2006,14,Unemployed,0,10,13,8,1,32,0,0,0,0,0,0,0,10,13,8,1,32
HIMACHAL PRADESH,2006,14,Professional Activity,0,0,3,1,0,4,0,0,0,0,0,0,0,0,3,1,0,4
HIMACHAL PRADESH,2006,14,Agriculture (Total),0,7,11,3,1,22,0,0,0,0,0,0,0,7,11,3,1,22
HIMACHAL PRADESH,2006,14,Retired Persons,0,0,0,0,1,1,0,0,0,0,0,0,0,0,0,0,1,1
HIMACHAL PRADESH,2007,14,House Wife,0,0,0,0,0,0,0,31,16,5,4,56,0,31,16,5,4,56
HIMACHAL PRADESH,2007,14,Service (Government),0,2,7,2,0,11,0,0,0,0,0,0,0,2,7,2,0,11
HIMACHAL PRADESH,2007,14,Service (Private),0,18,21,6,1,46,0,1,2,1,0,4,0,19,23,7,1,50
HIMACHAL PRADESH,2007,14,Public Sector Undertaking,0,4,3,4,1,12,0,1,2,0,0,3,0,5,5,4,1,15
HIMACHAL PRADESH,2007,14,Students,2,11,0,0,0,13,0,20,2,0,0,22,2,31,2,0,0,35
HIMACHAL PRADESH,2007,14,Unemployed,0,12,7,3,1,23,0,2,2,0,0,4,0,14,9,3,1,27
HIMACHAL PRADESH,2007,14,Professional Activity,0,2,4,1,1,8,0,0,1,1,0,2,0,2,5,2,1,10
HIMACHAL PRADESH,2007,14,Agriculture (Total),0,0,11,3,0,14,0,0,1,0,0,1,0,0,12,3,0,15
HIMACHAL PRADESH,2007,14,Retired Persons,0,0,0,0,1,1,0,0,0,0,0,0,0,0,0,0,1,1
HIMACHAL PRADESH,2008,14,House Wife,0,0,0,0,0,0,0,38,29,11,9,87,0,38,29,11,9,87
HIMACHAL PRADESH,2008,14,Service (Government),0,6,5,8,0,19,0,1,0,1,0,2,0,7,5,9,0,21
HIMACHAL PRADESH,2008,14,Service (Private),0,20,10,8,1,39,0,3,5,1,1,10,0,23,15,9,2,49
HIMACHAL PRADESH,2008,14,Public Sector Undertaking,0,6,5,4,1,16,0,4,1,2,0,7,0,10,6,6,1,23
HIMACHAL PRADESH,2008,14,Students,3,17,0,0,0,20,5,10,0,1,0,16,8,27,0,1,0,36
HIMACHAL PRADESH,2008,14,Unemployed,0,16,11,2,0,29,0,9,0,0,0,9,0,25,11,2,0,38
HIMACHAL PRADESH,2008,14,Professional Activity,0,3,3,3,0,9,0,1,2,1,1,5,0,4,5,4,1,14
HIMACHAL PRADESH,2008,14,Agriculture (Total),3,36,42,46,23,150,3,14,10,4,7,38,6,50,52,50,30,188
HIMACHAL PRADESH,2008,14,Retired Persons,0,0,0,1,2,3,0,0,0,0,0,0,0,0,0,1,2,3
HIMACHAL PRADESH,2009,14,House Wife,0,0,0,0,0,0,0,38,32,14,10,94,0,38,32,14,10,94
HIMACHAL PRADESH,2009,14,Service (Government),0,5,13,8,0,26,0,0,5,1,0,6,0,5,18,9,0,32
HIMACHAL PRADESH,2009,14,Service (Private),0,11,19,5,0,35,0,2,2,3,0,7,0,13,21,8,0,42
HIMACHAL PRADESH,2009,14,Public Sector Undertaking,0,7,3,5,3,18,0,2,0,3,1,6,0,9,3,8,4,24
HIMACHAL PRADESH,2009,14,Students,2,21,2,0,0,25,4,21,0,0,0,25,6,42,2,0,0,50
HIMACHAL PRADESH,2009,14,Unemployed,0,22,15,11,4,52,0,3,6,1,2,12,0,25,21,12,6,64
HIMACHAL PRADESH,2009,14,Professional Activity,0,0,3,0,0,3,0,0,0,0,0,0,0,0,3,0,0,3
HIMACHAL PRADESH,2009,14,Agriculture (Total),0,1,8,10,5,24,0,0,0,0,0,0,0,1,8,10,5,24
HIMACHAL PRADESH,2009,14,Retired Persons,0,0,0,0,4,4,0,0,0,0,1,1,0,0,0,0,5,5
HIMACHAL PRADESH,2010,14,House Wife,0,0,0,0,0,0,0,44,24,15,5,88,0,44,24,15,5,88
HIMACHAL PRADESH,2010,14,Service (Government),0,2,7,11,0,20,0,1,1,1,0,3,0,3,8,12,0,23
HIMACHAL PRADESH,2010,14,Service (Private),0,10,17,9,2,38,0,4,2,1,0,7,0,14,19,10,2,45
HIMACHAL PRADESH,2010,14,Public Sector Undertaking,0,3,6,2,1,12,0,2,1,2,1,6,0,5,7,4,2,18
HIMACHAL PRADESH,2010,14,Students,7,26,0,0,0,33,4,27,2,0,0,33,11,53,2,0,0,66
HIMACHAL PRADESH,2010,14,Unemployed,0,24,23,4,1,52,0,2,1,0,0,3,0,26,24,4,1,55
HIMACHAL PRADESH,2010,14,Professional Activity,0,10,4,6,1,21,0,0,1,0,0,1,0,10,5,6,1,22
HIMACHAL PRADESH,2010,14,Agriculture (Total),0,12,24,15,8,59,0,2,0,0,0,2,0,14,24,15,8,61
HIMACHAL PRADESH,2010,14,Retired Persons,0,0,1,4,2,7,0,0,0,0,0,0,0,0,1,4,2,7
HIMACHAL PRADESH,2011,14,House Wife,0,0,0,0,0,0,0,23,29,11,2,65,0,23,29,11,2,65
HIMACHAL PRADESH,2011,14,Service (Government),0,1,5,4,0,10,0,0,2,1,0,3,0,1,7,5,0,13
HIMACHAL PRADESH,2011,14,Service (Private),0,17,15,8,1,41,0,1,3,1,0,5,0,18,18,9,1,46
HIMACHAL PRADESH,2011,14,Public Sector Undertaking,0,6,10,4,1,21,0,2,2,2,1,7,0,8,12,6,2,28
HIMACHAL PRADESH,2011,14,Students,2,20,0,0,0,22,3,21,0,0,0,24,5,41,0,0,0,46
HIMACHAL PRADESH,2011,14,Unemployed,0,9,7,0,1,17,0,4,2,0,0,6,0,13,9,0,1,23
HIMACHAL PRADESH,2011,14,Professional Activity,0,0,1,2,2,5,0,0,2,0,0,2,0,0,3,2,2,7
HIMACHAL PRADESH,2011,14,Agriculture (Total),0,8,14,10,10,42,0,3,0,1,0,4,0,11,14,11,10,46
HIMACHAL PRADESH,2011,14,Retired Persons,0,0,0,0,0,0,0,0,0,0,0,0,0,0,0,0,0,0
HIMACHAL PRADESH,2012,14,House Wife,0,0,0,0,0,0,0,40,25,12,3,80,0,40,25,12,3,80
HIMACHAL PRADESH,2012,14,Service (Government),0,0,3,3,0,6,0,2,1,1,0,4,0,2,4,4,0,10
HIMACHAL PRADESH,2012,14,Service (Private),0,10,12,9,1,32,0,2,4,1,0,7,0,12,16,10,1,39
HIMACHAL PRADESH,2012,14,Public Sector Undertaking,0,6,9,4,1,20,0,3,2,2,1,8,0,9,11,6,2,28
HIMACHAL PRADESH,2012,14,Students,5,24,0,0,0,29,3,15,0,0,0,18,8,39,0,0,0,47
HIMACHAL PRADESH,2012,14,Unemployed,1,19,14,5,1,40,0,3,1,0,0,4,1,22,15,5,1,44
HIMACHAL PRADESH,2012,14,Professional Activity,0,1,2,2,1,6,0,1,1,0,0,2,0,2,3,2,1,8
HIMACHAL PRADESH,2012,14,Agriculture (Total),0,4,12,8,3,27,0,0,1,1,0,2,0,4,13,9,3,29
HIMACHAL PRADESH,2012,14,Retired Persons,0,0,0,0,3,3,0,0,0,0,0,0,0,0,0,0,3,3
HIMACHAL PRADESH,2013,14,House Wife,0,0,0,0,0,0,0,41,30,15,2,88,0,41,30,15,2,88
HIMACHAL PRADESH,2013,14,Service (Government),0,1,8,9,0,18,0,0,2,0,0,2,0,1,10,9,0,20
HIMACHAL PRADESH,2013,14,Service (Private),0,8,12,6,3,29,0,1,4,1,0,6,0,9,16,7,3,35
HIMACHAL PRADESH,2013,14,Public Sector Undertaking,0,6,6,4,1,17,0,1,3,1,0,5,0,7,9,5,1,22
HIMACHAL PRADESH,2013,14,Students,4,21,0,0,0,25,2,20,0,0,0,22,6,41,0,0,0,47
HIMACHAL PRADESH,2013,14,Unemployed,0,27,22,3,1,53,0,1,2,1,0,4,0,28,24,4,1,57
HIMACHAL PRADESH,2013,14,Professional Activity,0,2,2,2,1,7,0,1,1,0,0,2,0,3,3,2,1,9
HIMACHAL PRADESH,2013,14,Agriculture (Total),0,6,13,11,2,32,0,0,1,0,0,1,0,6,14,11,2,33
HIMACHAL PRADESH,2013,14,Retired Persons,0,0,0,0,5,5,0,0,0,0,0,0,0,0,0,0,5,5
HIMACHAL PRADESH,2014,14,House Wife,0,0,0,0,0,0,0,42,45,27,7,121,0,42,45,27,7,121
HIMACHAL PRADESH,2014,14,Service (Government),0,4,9,6,1,20,0,1,0,0,0,1,0,5,9,6,1,21
HIMACHAL PRADESH,2014,14,Service (Private),0,5,6,7,3,21,0,1,2,1,0,4,0,6,8,8,3,25
HIMACHAL PRADESH,2014,14,Public Sector Undertaking,0,0,2,1,0,3,0,0,0,0,0,0,0,0,2,1,0,3
HIMACHAL PRADESH,2014,14,Students,6,18,0,0,0,24,1,21,0,0,0,22,7,39,0,0,0,46
HIMACHAL PRADESH,2014,14,Unemployed,0,36,36,12,8,92,0,10,11,0,1,22,0,46,47,12,9,114
HIMACHAL PRADESH,2014,14,Agriculture (Total),0,22,23,12,2,59,0,0,2,2,0,4,0,22,25,14,2,63
HIMACHAL PRADESH,2014,14,Retired Persons,0,0,0,0,0,0,0,0,0,0,0,0,0,0,0,0,0,0
JAMMU & KASHMIR,2001,15,House Wife,0,0,0,0,0,0,0,18,13,4,1,36,0,18,13,4,1,36
JAMMU & KASHMIR,2001,15,Service (Government),0,1,7,1,0,9,0,0,0,0,0,0,0,1,7,1,0,9
JAMMU & KASHMIR,2001,15,Service (Private),0,0,2,0,0,2,0,0,0,0,0,0,0,0,2,0,0,2
JAMMU & KASHMIR,2001,15,Public Sector Undertaking,0,0,1,0,0,1,0,0,0,0,0,0,0,0,1,0,0,1
JAMMU & KASHMIR,2001,15,Students,0,5,0,0,0,5,0,1,0,0,0,1,0,6,0,0,0,6
JAMMU & KASHMIR,2001,15,Unemployed,0,3,4,4,1,12,0,3,0,0,0,3,0,6,4,4,1,15
JAMMU & KASHMIR,2001,15,Professional Activity,2,0,0,0,0,2,0,0,0,0,0,0,2,0,0,0,0,2
JAMMU & KASHMIR,2001,15,Agriculture (Total),0,5,4,3,0,12,1,0,1,1,0,3,1,5,5,4,0,15
JAMMU & KASHMIR,2001,15,Retired Persons,0,0,0,0,0,0,0,0,0,0,0,0,0,0,0,0,0,0
JAMMU & KASHMIR,2002,15,House Wife,0,0,0,0,0,0,0,39,11,3,0,53,0,39,11,3,0,53
JAMMU & KASHMIR,2002,15,Service (Government),0,2,8,1,0,11,0,0,0,0,0,0,0,2,8,1,0,11
JAMMU & KASHMIR,2002,15,Service (Private),0,3,3,1,1,8,0,0,0,0,0,0,0,3,3,1,1,8
JAMMU & KASHMIR,2002,15,Public Sector Undertaking,0,1,1,0,0,2,0,0,0,0,0,0,0,1,1,0,0,2
JAMMU & KASHMIR,2002,15,Students,1,3,3,1,0,8,0,3,1,0,0,4,1,6,4,1,0,12
JAMMU & KASHMIR,2002,15,Unemployed,3,9,4,0,0,16,0,3,1,0,0,4,3,12,5,0,0,20
JAMMU & KASHMIR,2002,15,Professional Activity,0,0,0,0,0,0,0,0,0,0,0,0,0,0,0,0,0,0
JAMMU & KASHMIR,2002,15,Agriculture (Total),0,9,4,1,1,15,0,1,0,0,0,1,0,10,4,1,1,16
JAMMU & KASHMIR,2002,15,Retired Persons,0,0,0,0,0,0,0,0,0,0,0,0,0,0,0,0,0,0
JAMMU & KASHMIR,2003,15,House Wife,0,0,0,0,0,0,1,26,12,0,2,41,1,26,12,0,2,41
JAMMU & KASHMIR,2003,15,Service (Government),0,2,3,0,0,5,0,0,0,0,0,0,0,2,3,0,0,5
JAMMU & KASHMIR,2003,15,Service (Private),0,0,0,0,0,0,0,0,0,0,0,0,0,0,0,0,0,0
JAMMU & KASHMIR,2003,15,Public Sector Undertaking,0,0,0,0,0,0,0,0,0,0,0,0,0,0,0,0,0,0
JAMMU & KASHMIR,2003,15,Students,0,2,0,0,0,2,0,2,0,0,0,2,0,4,0,0,0,4
JAMMU & KASHMIR,2003,15,Unemployed,0,3,1,0,0,4,0,0,0,0,0,0,0,3,1,0,0,4
JAMMU & KASHMIR,2003,15,Professional Activity,0,0,0,0,0,0,0,0,0,0,0,0,0,0,0,0,0,0
JAMMU & KASHMIR,2003,15,Agriculture (Total),0,4,0,1,0,5,1,0,2,0,0,3,1,4,2,1,0,8
JAMMU & KASHMIR,2003,15,Retired Persons,0,0,0,0,0,0,0,0,0,0,0,0,0,0,0,0,0,0
JAMMU & KASHMIR,2004,15,House Wife,0,0,0,0,0,0,0,13,16,0,0,29,0,13,16,0,0,29
JAMMU & KASHMIR,2004,15,Service (Government),0,2,2,0,0,4,0,0,0,0,0,0,0,2,2,0,0,4
JAMMU & KASHMIR,2004,15,Service (Private),0,0,0,0,0,0,0,0,0,0,0,0,0,0,0,0,0,0
JAMMU & KASHMIR,2004,15,Public Sector Undertaking,0,0,0,0,0,0,0,1,0,0,0,1,0,1,0,0,0,1
JAMMU & KASHMIR,2004,15,Students,0,3,0,0,0,3,0,3,0,0,0,3,0,6,0,0,0,6
JAMMU & KASHMIR,2004,15,Unemployed,0,6,0,0,0,6,0,0,0,0,0,0,0,6,0,0,0,6
JAMMU & KASHMIR,2004,15,Professional Activity,0,0,0,0,0,0,0,0,0,0,0,0,0,0,0,0,0,0
JAMMU & KASHMIR,2004,15,Agriculture (Total),0,0,0,1,0,1,0,0,0,0,0,0,0,0,0,1,0,1
JAMMU & KASHMIR,2004,15,Retired Persons,0,0,0,0,0,0,0,0,0,0,0,0,0,0,0,0,0,0
JAMMU & KASHMIR,2005,15,House Wife,0,0,0,0,0,0,0,17,14,1,0,32,0,17,14,1,0,32
JAMMU & KASHMIR,2005,15,Service (Government),0,14,4,0,0,18,0,0,0,0,0,0,0,14,4,0,0,18
JAMMU & KASHMIR,2005,15,Service (Private),0,23,11,0,0,34,0,0,0,0,0,0,0,23,11,0,0,34
JAMMU & KASHMIR,2005,15,Public Sector Undertaking,0,0,0,0,0,0,0,0,0,0,0,0,0,0,0,0,0,0
JAMMU & KASHMIR,2005,15,Students,1,14,5,0,0,20,1,3,0,0,0,4,2,17,5,0,0,24
JAMMU & KASHMIR,2005,15,Unemployed,0,18,8,1,0,27,0,3,10,0,0,13,0,21,18,1,0,40
JAMMU & KASHMIR,2005,15,Professional Activity,0,0,0,0,0,0,0,0,0,0,0,0,0,0,0,0,0,0
JAMMU & KASHMIR,2005,15,Agriculture (Total),0,1,0,0,0,1,0,1,0,0,0,1,0,2,0,0,0,2
JAMMU & KASHMIR,2005,15,Retired Persons,0,6,0,1,0,7,0,0,0,0,0,0,0,6,0,1,0,7
JAMMU & KASHMIR,2006,15,House Wife,0,0,0,0,0,0,0,20,20,2,0,42,0,20,20,2,0,42
JAMMU & KASHMIR,2006,15,Service (Government),0,11,9,4,0,24,0,2,1,0,0,3,0,13,10,4,0,27
JAMMU & KASHMIR,2006,15,Service (Private),0,2,2,3,1,8,0,2,1,1,0,4,0,4,3,4,1,12
JAMMU & KASHMIR,2006,15,Public Sector Undertaking,0,1,0,1,0,2,0,0,0,0,0,0,0,1,0,1,0,2
JAMMU & KASHMIR,2006,15,Students,0,7,0,0,0,7,0,15,0,0,0,15,0,22,0,0,0,22
JAMMU & KASHMIR,2006,15,Unemployed,0,15,11,0,0,26,0,6,1,1,0,8,0,21,12,1,0,34
JAMMU & KASHMIR,2006,15,Professional Activity,0,0,0,0,0,0,0,5,0,0,0,5,0,5,0,0,0,5
JAMMU & KASHMIR,2006,15,Agriculture (Total),1,10,12,6,1,30,0,2,1,1,0,4,1,12,13,7,1,34
JAMMU & KASHMIR,2006,15,Retired Persons,0,0,0,0,2,2,0,0,0,0,0,0,0,0,0,0,2,2
JAMMU & KASHMIR,2007,15,House Wife,0,0,0,0,0,0,0,26,21,4,2,53,0,26,21,4,2,53
JAMMU & KASHMIR,2007,15,Service (Government),0,5,6,1,0,12,0,1,1,0,0,2,0,6,7,1,0,14
JAMMU & KASHMIR,2007,15,Service (Private),0,2,5,3,0,10,0,1,0,0,0,1,0,3,5,3,0,11
JAMMU & KASHMIR,2007,15,Public Sector Undertaking,0,4,1,0,0,5,0,2,0,0,0,2,0,6,1,0,0,7
JAMMU & KASHMIR,2007,15,Students,0,13,1,0,0,14,0,10,0,0,0,10,0,23,1,0,0,24
JAMMU & KASHMIR,2007,15,Unemployed,0,16,5,4,0,25,0,3,0,0,0,3,0,19,5,4,0,28
JAMMU & KASHMIR,2007,15,Professional Activity,0,2,1,0,0,3,0,0,0,0,0,0,0,2,1,0,0,3
JAMMU & KASHMIR,2007,15,Agriculture (Total),0,9,10,9,3,31,0,1,1,0,0,2,0,10,11,9,3,33
JAMMU & KASHMIR,2007,15,Retired Persons,0,0,1,1,2,4,0,0,0,0,0,0,0,0,1,1,2,4
JAMMU & KASHMIR,2008,15,House Wife,0,0,0,0,0,0,0,38,36,1,0,75,0,38,36,1,0,75
JAMMU & KASHMIR,2008,15,Service (Government),0,4,12,9,0,25,0,1,2,0,0,3,0,5,14,9,0,28
JAMMU & KASHMIR,2008,15,Service (Private),0,5,11,6,0,22,0,2,3,0,0,5,0,7,14,6,0,27
JAMMU & KASHMIR,2008,15,Public Sector Undertaking,0,1,5,13,1,20,0,1,0,0,0,1,0,2,5,13,1,21
JAMMU & KASHMIR,2008,15,Students,0,7,0,0,0,7,1,8,0,0,0,9,1,15,0,0,0,16
JAMMU & KASHMIR,2008,15,Unemployed,0,16,19,1,1,37,0,12,2,0,0,14,0,28,21,1,1,51
JAMMU & KASHMIR,2008,15,Professional Activity,0,0,1,2,1,4,0,0,0,0,0,0,0,0,1,2,1,4
JAMMU & KASHMIR,2008,15,Agriculture (Total),0,2,1,1,0,4,0,2,0,0,0,2,0,4,1,1,0,6
JAMMU & KASHMIR,2008,15,Retired Persons,0,0,0,0,6,6,0,0,0,0,0,0,0,0,0,0,6,6
JAMMU & KASHMIR,2009,15,House Wife,0,0,0,0,0,0,0,34,14,1,1,50,0,34,14,1,1,50
JAMMU & KASHMIR,2009,15,Service (Government),0,8,14,4,0,26,0,3,4,2,0,9,0,11,18,6,0,35
JAMMU & KASHMIR,2009,15,Service (Private),0,4,11,6,3,24,0,2,3,1,0,6,0,6,14,7,3,30
JAMMU & KASHMIR,2009,15,Public Sector Undertaking,0,1,2,1,2,6,0,0,1,0,0,1,0,1,3,1,2,7
JAMMU & KASHMIR,2009,15,Students,0,3,1,0,0,4,0,12,4,0,0,16,0,15,5,0,0,20
JAMMU & KASHMIR,2009,15,Unemployed,0,12,20,9,0,41,0,9,10,2,0,21,0,21,30,11,0,62
JAMMU & KASHMIR,2009,15,Professional Activity,0,0,2,0,0,2,0,1,0,0,0,1,0,1,2,0,0,3
JAMMU & KASHMIR,2009,15,Agriculture (Total),0,6,1,0,1,8,0,0,0,0,0,0,0,6,1,0,1,8
JAMMU & KASHMIR,2009,15,Retired Persons,0,0,0,0,0,0,0,0,0,0,0,0,0,0,0,0,0,0
JAMMU & KASHMIR,2010,15,House Wife,0,0,0,0,0,0,0,30,24,4,0,58,0,30,24,4,0,58
JAMMU & KASHMIR,2010,15,Service (Government),0,2,2,0,0,4,0,1,1,0,0,2,0,3,3,0,0,6
JAMMU & KASHMIR,2010,15,Service (Private),0,1,9,3,0,13,0,0,0,0,0,0,0,1,9,3,0,13
JAMMU & KASHMIR,2010,15,Public Sector Undertaking,0,1,1,0,0,2,0,0,0,0,0,0,0,1,1,0,0,2
JAMMU & KASHMIR,2010,15,Students,3,11,3,0,0,17,2,12,3,2,0,19,5,23,6,2,0,36
JAMMU & KASHMIR,2010,15,Unemployed,0,12,11,4,0,27,1,12,3,0,0,16,1,24,14,4,0,43
JAMMU & KASHMIR,2010,15,Professional Activity,0,2,0,0,0,2,0,0,1,0,0,1,0,2,1,0,0,3
JAMMU & KASHMIR,2010,15,Agriculture (Total),0,3,8,4,1,16,0,2,0,0,0,2,0,5,8,4,1,18
JAMMU & KASHMIR,2010,15,Retired Persons,0,0,0,1,0,1,0,0,0,0,0,0,0,0,0,1,0,1
JAMMU & KASHMIR,2011,15,House Wife,0,0,0,0,0,0,0,22,29,7,0,58,0,22,29,7,0,58
JAMMU & KASHMIR,2011,15,Service (Government),0,1,7,1,0,9,0,1,2,1,0,4,0,2,9,2,0,13
JAMMU & KASHMIR,2011,15,Service (Private),0,4,3,2,0,9,0,1,1,0,0,2,0,5,4,2,0,11
JAMMU & KASHMIR,2011,15,Public Sector Undertaking,0,0,2,2,0,4,0,0,0,0,0,0,0,0,2,2,0,4
JAMMU & KASHMIR,2011,15,Students,2,9,2,0,0,13,3,24,0,0,0,27,5,33,2,0,0,40
JAMMU & KASHMIR,2011,15,Unemployed,0,2,12,4,0,18,0,15,3,0,0,18,0,17,15,4,0,36
JAMMU & KASHMIR,2011,15,Professional Activity,0,1,2,3,1,7,0,0,0,0,0,0,0,1,2,3,1,7
JAMMU & KASHMIR,2011,15,Agriculture (Total),0,0,3,6,2,11,0,2,0,1,0,3,0,2,3,7,2,14
JAMMU & KASHMIR,2011,15,Retired Persons,0,0,0,2,2,4,0,0,0,0,0,0,0,0,0,2,2,4
JAMMU & KASHMIR,2012,15,House Wife,0,0,0,0,0,0,0,29,39,6,1,75,0,29,39,6,1,75
JAMMU & KASHMIR,2012,15,Service (Government),0,3,10,5,3,21,0,1,0,2,0,3,0,4,10,7,3,24
JAMMU & KASHMIR,2012,15,Service (Private),0,1,3,0,1,5,0,1,1,1,10,13,0,2,4,1,11,18
JAMMU & KASHMIR,2012,15,Public Sector Undertaking,0,0,0,0,0,0,0,0,0,0,0,0,0,0,0,0,0,0
JAMMU & KASHMIR,2012,15,Students,2,13,5,0,0,20,1,36,0,1,4,42,3,49,5,1,4,62
JAMMU & KASHMIR,2012,15,Unemployed,0,11,14,5,3,33,0,8,12,0,0,20,0,19,26,5,3,53
JAMMU & KASHMIR,2012,15,Professional Activity,0,1,4,1,1,7,0,1,2,1,0,4,0,2,6,2,1,11
JAMMU & KASHMIR,2012,15,Agriculture (Total),0,3,5,2,0,10,0,0,0,0,0,0,0,3,5,2,0,10
JAMMU & KASHMIR,2012,15,Retired Persons,0,0,0,1,4,5,0,0,0,0,0,0,0,0,0,1,4,5
JAMMU & KASHMIR,2013,15,House Wife,0,0,0,0,0,0,0,17,43,6,5,71,0,17,43,6,5,71
JAMMU & KASHMIR,2013,15,Service (Government),0,4,5,6,0,15,0,0,0,0,0,0,0,4,5,6,0,15
JAMMU & KASHMIR,2013,15,Service (Private),0,1,0,4,2,7,0,0,0,0,0,0,0,1,0,4,2,7
JAMMU & KASHMIR,2013,15,Public Sector Undertaking,0,0,3,2,5,10,0,0,0,0,0,0,0,0,3,2,5,10
JAMMU & KASHMIR,2013,15,Students,1,13,0,0,0,14,1,14,0,0,0,15,2,27,0,0,0,29
JAMMU & KASHMIR,2013,15,Unemployed,0,5,12,1,0,18,0,10,3,0,0,13,0,15,15,1,0,31
JAMMU & KASHMIR,2013,15,Professional Activity,0,0,2,0,0,2,0,0,0,0,0,0,0,0,2,0,0,2
JAMMU & KASHMIR,2013,15,Agriculture (Total),0,3,7,6,2,18,0,0,0,0,0,0,0,3,7,6,2,18
JAMMU & KASHMIR,2013,15,Retired Persons,0,0,0,0,0,0,0,0,0,0,0,0,0,0,0,0,0,0
JAMMU & KASHMIR,2014,15,House Wife,0,0,0,0,0,0,0,16,6,4,0,26,0,16,6,4,0,26
JAMMU & KASHMIR,2014,15,Service (Government),0,0,9,2,0,11,0,0,0,0,0,0,0,0,9,2,0,11
JAMMU & KASHMIR,2014,15,Service (Private),0,1,3,3,0,7,0,0,0,0,0,0,0,1,3,3,0,7
JAMMU & KASHMIR,2014,15,Public Sector Undertaking,0,0,0,0,0,0,0,0,0,0,0,0,0,0,0,0,0,0
JAMMU & KASHMIR,2014,15,Students,2,6,0,0,0,8,0,12,0,0,0,12,2,18,0,0,0,20
JAMMU & KASHMIR,2014,15,Unemployed,0,14,9,5,1,29,0,12,2,0,0,14,0,26,11,5,1,43
JAMMU & KASHMIR,2014,15,Agriculture (Total),0,13,11,6,2,32,0,3,2,0,0,5,0,16,13,6,2,37
JAMMU & KASHMIR,2014,15,Retired Persons,0,0,1,1,0,2,0,0,0,0,0,0,0,0,1,1,0,2
JHARKHAND,2001,16,House Wife,0,0,0,0,0,0,1,29,21,8,0,59,1,29,21,8,0,59
JHARKHAND,2001,16,Service (Government),0,0,0,0,0,0,0,0,0,0,0,0,0,0,0,0,0,0
JHARKHAND,2001,16,Service (Private),0,0,3,1,0,4,0,0,2,0,0,2,0,0,5,1,0,6
JHARKHAND,2001,16,Public Sector Undertaking,0,0,3,0,0,3,0,0,2,0,0,2,0,0,5,0,0,5
JHARKHAND,2001,16,Students,3,3,0,0,0,6,0,1,0,0,0,1,3,4,0,0,0,7
JHARKHAND,2001,16,Unemployed,0,9,7,1,1,18,0,1,0,0,0,1,0,10,7,1,1,19
JHARKHAND,2001,16,Professional Activity,0,3,2,1,0,6,0,0,0,0,0,0,0,3,2,1,0,6
JHARKHAND,2001,16,Agriculture (Total),0,5,17,5,0,27,0,0,0,0,0,0,0,5,17,5,0,27
JHARKHAND,2001,16,Retired Persons,0,0,0,0,0,0,0,0,0,0,0,0,0,0,0,0,0,0
JHARKHAND,2002,16,House Wife,0,0,0,0,0,0,0,28,25,10,0,63,0,28,25,10,0,63
JHARKHAND,2002,16,Service (Government),0,0,0,0,0,0,0,0,0,0,0,0,0,0,0,0,0,0
JHARKHAND,2002,16,Service (Private),0,0,4,1,0,5,0,0,3,0,0,3,0,0,7,1,0,8
JHARKHAND,2002,16,Public Sector Undertaking,0,0,2,1,0,3,0,0,2,1,0,3,0,0,4,2,0,6
JHARKHAND,2002,16,Students,3,4,0,0,0,7,0,3,0,0,0,3,3,7,0,0,0,10
JHARKHAND,2002,16,Unemployed,0,8,8,11,0,27,0,1,1,0,0,2,0,9,9,11,0,29
JHARKHAND,2002,16,Professional Activity,0,4,1,2,2,9,0,0,0,0,0,0,0,4,1,2,2,9
JHARKHAND,2002,16,Agriculture (Total),0,4,14,3,0,21,0,0,0,0,0,0,0,4,14,3,0,21
JHARKHAND,2002,16,Retired Persons,0,2,0,0,0,2,0,0,0,0,0,0,0,2,0,0,0,2
JHARKHAND,2003,16,House Wife,0,0,0,0,0,0,0,28,25,10,0,63,0,28,25,10,0,63
JHARKHAND,2003,16,Service (Government),0,0,0,0,0,0,0,0,0,0,0,0,0,0,0,0,0,0
JHARKHAND,2003,16,Service (Private),0,0,4,1,0,5,0,0,3,0,0,3,0,0,7,1,0,8
JHARKHAND,2003,16,Public Sector Undertaking,0,0,2,1,0,3,0,0,2,1,0,3,0,0,4,2,0,6
JHARKHAND,2003,16,Students,3,4,0,0,0,7,0,3,0,0,0,3,3,7,0,0,0,10
JHARKHAND,2003,16,Unemployed,0,8,8,11,0,27,0,1,1,0,0,2,0,9,9,11,0,29
JHARKHAND,2003,16,Professional Activity,0,4,1,2,2,9,0,0,0,0,0,0,0,4,1,2,2,9
JHARKHAND,2003,16,Agriculture (Total),0,4,14,3,0,21,0,0,0,0,0,0,0,4,14,3,0,21
JHARKHAND,2003,16,Retired Persons,0,2,0,0,0,2,0,0,0,0,0,0,0,2,0,0,0,2
JHARKHAND,2004,16,House Wife,0,0,0,0,0,0,0,0,0,0,0,0,0,0,0,0,0,0
JHARKHAND,2004,16,Service (Government),0,0,0,0,0,0,0,0,0,0,0,0,0,0,0,0,0,0
JHARKHAND,2004,16,Service (Private),0,0,4,1,0,5,0,0,3,0,0,3,0,0,7,1,0,8
JHARKHAND,2004,16,Public Sector Undertaking,0,0,2,1,0,3,0,0,2,1,0,3,0,0,4,2,0,6
JHARKHAND,2004,16,Students,3,4,0,0,0,7,0,3,0,0,0,3,3,7,0,0,0,10
JHARKHAND,2004,16,Unemployed,0,8,8,11,0,27,0,1,1,0,0,2,0,9,9,11,0,29
JHARKHAND,2004,16,Professional Activity,0,4,1,2,2,9,0,0,0,0,0,0,0,4,1,2,2,9
JHARKHAND,2004,16,Agriculture (Total),0,4,14,3,0,21,0,0,0,0,0,0,0,4,14,3,0,21
JHARKHAND,2004,16,Retired Persons,0,0,0,0,0,0,0,0,0,0,0,0,0,0,0,0,0,0
JHARKHAND,2005,16,House Wife,0,0,0,0,0,0,0,57,76,22,3,158,0,57,76,22,3,158
JHARKHAND,2005,16,Service (Government),0,0,4,5,0,9,0,1,1,0,0,2,0,1,5,5,0,11
JHARKHAND,2005,16,Service (Private),0,14,13,6,0,33,0,0,9,0,0,9,0,14,22,6,0,42
JHARKHAND,2005,16,Public Sector Undertaking,0,2,3,0,0,5,0,1,0,0,0,1,0,3,3,0,0,6
JHARKHAND,2005,16,Students,2,53,14,0,0,69,6,14,9,0,0,29,8,67,23,0,0,98
JHARKHAND,2005,16,Unemployed,0,20,6,0,0,26,0,8,14,0,0,22,0,28,20,0,0,48
JHARKHAND,2005,16,Professional Activity,0,0,4,5,0,9,0,0,0,0,0,0,0,0,4,5,0,9
JHARKHAND,2005,16,Agriculture (Total),0,38,56,29,1,124,0,0,0,0,0,0,0,38,56,29,1,124
JHARKHAND,2005,16,Retired Persons,0,0,0,0,3,3,0,0,0,0,0,0,0,0,0,0,3,3
JHARKHAND,2006,16,House Wife,0,0,0,0,0,0,1,94,70,23,2,190,1,94,70,23,2,190
JHARKHAND,2006,16,Service (Government),0,5,5,10,0,20,0,0,6,0,0,6,0,5,11,10,0,26
JHARKHAND,2006,16,Service (Private),0,20,12,8,0,40,0,2,5,1,0,8,0,22,17,9,0,48
JHARKHAND,2006,16,Public Sector Undertaking,0,1,0,0,0,1,0,0,0,0,0,0,0,1,0,0,0,1
JHARKHAND,2006,16,Students,10,58,1,2,0,71,5,35,0,0,0,40,15,93,1,2,0,111
JHARKHAND,2006,16,Unemployed,0,31,37,12,1,81,1,6,7,0,0,14,1,37,44,12,1,95
JHARKHAND,2006,16,Professional Activity,0,5,24,5,0,34,0,0,0,0,0,0,0,5,24,5,0,34
JHARKHAND,2006,16,Agriculture (Total),0,19,53,30,1,103,0,0,0,0,0,0,0,19,53,30,1,103
JHARKHAND,2006,16,Retired Persons,0,2,1,0,6,9,0,0,0,0,0,0,0,2,1,0,6,9
JHARKHAND,2007,16,House Wife,0,0,0,0,0,0,3,87,77,30,8,205,3,87,77,30,8,205
JHARKHAND,2007,16,Service (Government),0,6,5,6,2,19,0,0,0,1,0,1,0,6,5,7,2,20
JHARKHAND,2007,16,Service (Private),4,28,36,9,3,80,0,0,4,0,0,4,4,28,40,9,3,84
JHARKHAND,2007,16,Public Sector Undertaking,0,0,0,0,0,0,0,0,0,0,0,0,0,0,0,0,0,0
JHARKHAND,2007,16,Students,24,33,10,0,0,67,10,23,2,0,0,35,34,56,12,0,0,102
JHARKHAND,2007,16,Unemployed,0,40,26,12,1,79,0,8,8,0,0,16,0,48,34,12,1,95
JHARKHAND,2007,16,Professional Activity,0,2,27,10,1,40,0,0,2,0,0,2,0,2,29,10,1,42
JHARKHAND,2007,16,Agriculture (Total),0,28,40,28,5,101,1,7,3,1,0,12,1,35,43,29,5,113
JHARKHAND,2007,16,Retired Persons,0,0,1,0,18,19,0,0,0,0,0,0,0,0,1,0,18,19
JHARKHAND,2008,16,House Wife,0,0,0,0,0,0,1,58,67,41,3,170,1,58,67,41,3,170
JHARKHAND,2008,16,Service (Government),0,2,7,3,0,12,0,0,0,1,0,1,0,2,7,4,0,13
JHARKHAND,2008,16,Service (Private),0,8,19,4,0,31,0,0,4,0,0,4,0,8,23,4,0,35
JHARKHAND,2008,16,Public Sector Undertaking,0,5,7,2,0,14,0,0,0,0,0,0,0,5,7,2,0,14
JHARKHAND,2008,16,Students,8,52,1,0,0,61,13,26,1,0,0,40,21,78,2,0,0,101
JHARKHAND,2008,16,Unemployed,0,17,18,10,5,50,1,3,6,0,0,10,1,20,24,10,5,60
JHARKHAND,2008,16,Professional Activity,0,1,32,10,0,43,5,0,0,0,0,5,5,1,32,10,0,48
JHARKHAND,2008,16,Agriculture (Total),3,17,18,23,3,64,2,2,2,1,0,7,5,19,20,24,3,71
JHARKHAND,2008,16,Retired Persons,0,0,0,0,4,4,0,0,0,0,0,0,0,0,0,0,4,4
JHARKHAND,2009,16,House Wife,0,0,0,0,0,0,0,54,87,40,4,185,0,54,87,40,4,185
JHARKHAND,2009,16,Service (Government),0,1,14,2,0,17,0,5,2,0,0,7,0,6,16,2,0,24
JHARKHAND,2009,16,Service (Private),0,21,68,30,1,120,1,12,2,1,0,16,1,33,70,31,1,136
JHARKHAND,2009,16,Public Sector Undertaking,0,1,1,1,0,3,1,0,0,0,0,1,1,1,1,1,0,4
JHARKHAND,2009,16,Students,7,53,3,0,0,63,8,25,0,0,0,33,15,78,3,0,0,96
JHARKHAND,2009,16,Unemployed,0,23,39,15,10,87,0,7,6,0,0,13,0,30,45,15,10,100
JHARKHAND,2009,16,Professional Activity,0,6,9,5,0,20,0,1,1,0,0,2,0,7,10,5,0,22
JHARKHAND,2009,16,Agriculture (Total),0,35,84,34,6,159,0,0,4,1,0,5,0,35,88,35,6,164
JHARKHAND,2009,16,Retired Persons,0,0,0,0,1,1,0,0,0,0,0,0,0,0,0,0,1,1
JHARKHAND,2010,16,House Wife,0,0,0,0,0,0,1,52,104,51,4,212,1,52,104,51,4,212
JHARKHAND,2010,16,Service (Government),0,1,3,4,0,8,0,0,1,1,0,2,0,1,4,5,0,10
JHARKHAND,2010,16,Service (Private),0,20,29,28,0,77,0,5,3,2,0,10,0,25,32,30,0,87
JHARKHAND,2010,16,Public Sector Undertaking,18,1,2,3,0,24,0,4,0,0,0,4,18,5,2,3,0,28
JHARKHAND,2010,16,Students,18,70,4,0,0,92,9,40,1,0,0,50,27,110,5,0,0,142
JHARKHAND,2010,16,Unemployed,0,34,41,13,0,88,0,8,4,0,0,12,0,42,45,13,0,100
JHARKHAND,2010,16,Professional Activity,0,3,4,2,0,9,0,0,0,0,0,0,0,3,4,2,0,9
JHARKHAND,2010,16,Agriculture (Total),10,47,58,30,5,150,0,13,6,4,0,23,10,60,64,34,5,173
JHARKHAND,2010,16,Retired Persons,0,0,0,0,3,3,0,0,0,0,0,0,0,0,0,0,3,3
JHARKHAND,2011,16,House Wife,0,0,0,0,0,0,10,70,95,24,7,206,10,70,95,24,7,206
JHARKHAND,2011,16,Service (Government),0,4,8,3,0,15,0,2,3,2,0,7,0,6,11,5,0,22
JHARKHAND,2011,16,Service (Private),0,25,63,17,0,105,0,6,2,1,0,9,0,31,65,18,0,114
JHARKHAND,2011,16,Public Sector Undertaking,7,12,1,0,0,20,1,10,0,0,0,11,8,22,1,0,0,31
JHARKHAND,2011,16,Students,3,37,11,0,0,51,6,34,4,0,0,44,9,71,15,0,0,95
JHARKHAND,2011,16,Unemployed,0,23,44,17,1,85,0,2,1,2,1,6,0,25,45,19,2,91
JHARKHAND,2011,16,Professional Activity,0,15,16,17,1,49,0,3,3,0,0,6,0,18,19,17,1,55
JHARKHAND,2011,16,Agriculture (Total),0,19,44,24,3,90,0,2,1,1,0,4,0,21,45,25,3,94
JHARKHAND,2011,16,Retired Persons,0,1,0,0,6,7,0,0,0,0,0,0,0,1,0,0,6,7
JHARKHAND,2012,16,House Wife,0,0,0,0,0,0,6,65,93,44,4,212,6,65,93,44,4,212
JHARKHAND,2012,16,Service (Government),0,2,7,3,5,17,0,1,0,1,0,2,0,3,7,4,5,19
JHARKHAND,2012,16,Service (Private),0,27,32,19,0,78,0,8,3,0,0,11,0,35,35,19,0,89
JHARKHAND,2012,16,Public Sector Undertaking,0,6,7,0,0,13,0,4,2,0,0,6,0,10,9,0,0,19
JHARKHAND,2012,16,Students,17,90,11,0,0,118,12,41,3,0,1,57,29,131,14,0,1,175
JHARKHAND,2012,16,Unemployed,0,41,53,32,0,126,2,24,5,1,0,32,2,65,58,33,0,158
JHARKHAND,2012,16,Professional Activity,0,5,7,10,0,22,0,0,0,0,0,0,0,5,7,10,0,22
JHARKHAND,2012,16,Agriculture (Total),0,24,37,29,3,93,0,7,11,6,2,26,0,31,48,35,5,119
JHARKHAND,2012,16,Retired Persons,0,0,0,0,3,3,0,0,0,0,0,0,0,0,0,0,3,3
JHARKHAND,2013,16,House Wife,0,0,0,0,0,0,0,70,90,29,4,193,0,70,90,29,4,193
JHARKHAND,2013,16,Service (Government),0,4,7,4,0,15,0,0,1,0,0,1,0,4,8,4,0,16
JHARKHAND,2013,16,Service (Private),0,34,44,24,2,104,0,2,8,1,0,11,0,36,52,25,2,115
JHARKHAND,2013,16,Public Sector Undertaking,0,3,3,6,1,13,0,7,0,0,0,7,0,10,3,6,1,20
JHARKHAND,2013,16,Students,7,84,8,0,0,99,8,41,2,0,0,51,15,125,10,0,0,150
JHARKHAND,2013,16,Unemployed,0,35,51,33,6,125,0,10,1,3,0,14,0,45,52,36,6,139
JHARKHAND,2013,16,Professional Activity,0,5,11,0,2,18,0,3,3,0,0,6,0,8,14,0,2,24
JHARKHAND,2013,16,Agriculture (Total),0,30,34,69,2,135,0,2,2,3,0,7,0,32,36,72,2,142
JHARKHAND,2013,16,Retired Persons,0,0,0,0,3,3,0,0,0,0,0,0,0,0,0,0,3,3
JHARKHAND,2014,16,House Wife,0,0,0,0,0,0,0,55,40,9,2,106,0,55,40,9,2,106
JHARKHAND,2014,16,Service (Government),0,9,12,3,0,24,0,2,0,0,0,2,0,11,12,3,0,26
JHARKHAND,2014,16,Service (Private),0,12,13,7,0,32,0,3,2,1,0,6,0,15,15,8,0,38
JHARKHAND,2014,16,Public Sector Undertaking,0,14,9,0,0,23,0,0,0,0,0,0,0,14,9,0,0,23
JHARKHAND,2014,16,Students,7,79,6,5,0,97,9,33,3,0,0,45,16,112,9,5,0,142
JHARKHAND,2014,16,Unemployed,0,31,33,23,1,88,2,4,5,0,0,11,2,35,38,23,1,99
JHARKHAND,2014,16,Agriculture (Total),0,0,4,0,0,4,0,0,0,0,0,0,0,0,4,0,0,4
JHARKHAND,2014,16,Retired Persons,0,0,0,0,1,1,0,0,0,0,0,0,0,0,0,0,1,1
KARNATAKA,2001,17,House Wife,0,0,0,0,0,0,10,1008,707,334,138,2197,10,1008,707,334,138,2197
KARNATAKA,2001,17,Service (Government),0,35,108,67,1,211,0,23,24,12,0,59,0,58,132,79,1,270
KARNATAKA,2001,17,Service (Private),3,241,352,190,79,865,6,111,40,31,12,200,9,352,392,221,91,1065
KARNATAKA,2001,17,Public Sector Undertaking,0,66,95,60,7,228,0,15,0,0,0,15,0,81,95,60,7,243
KARNATAKA,2001,17,Students,72,230,26,1,0,329,60,120,1,2,0,183,132,350,27,3,0,512
KARNATAKA,2001,17,Unemployed,6,225,207,103,17,558,5,48,23,5,4,85,11,273,230,108,21,643
KARNATAKA,2001,17,Professional Activity,1,69,71,41,13,195,1,6,1,0,0,8,2,75,72,41,13,203
KARNATAKA,2001,17,Agriculture (Total),25,551,811,579,187,2153,17,138,117,68,12,352,42,689,928,647,199,2505
KARNATAKA,2001,17,Retired Persons,0,16,18,16,46,96,0,5,14,11,9,39,0,21,32,27,55,135
KARNATAKA,2002,17,House Wife,0,0,0,0,0,0,6,914,776,347,182,2225,6,914,776,347,182,2225
KARNATAKA,2002,17,Service (Government),0,41,86,59,0,186,0,14,14,5,1,34,0,55,100,64,1,220
KARNATAKA,2002,17,Service (Private),2,272,325,228,61,888,9,80,59,28,3,179,11,352,384,256,64,1067
KARNATAKA,2002,17,Public Sector Undertaking,0,51,87,42,3,183,0,21,3,0,0,24,0,72,90,42,3,207
KARNATAKA,2002,17,Students,49,194,12,0,0,255,118,120,16,0,0,254,167,314,28,0,0,509
KARNATAKA,2002,17,Unemployed,8,203,191,101,40,543,7,82,13,2,4,108,15,285,204,103,44,651
KARNATAKA,2002,17,Professional Activity,0,32,46,10,4,92,0,6,1,0,0,7,0,38,47,10,4,99
KARNATAKA,2002,17,Agriculture (Total),5,515,799,498,191,2008,8,121,125,55,23,332,13,636,924,553,214,2340
KARNATAKA,2002,17,Retired Persons,0,0,0,13,39,52,0,0,0,7,8,15,0,0,0,20,47,67
KARNATAKA,2003,17,House Wife,0,0,0,0,0,0,6,703,658,309,188,1864,6,703,658,309,188,1864
KARNATAKA,2003,17,Service (Government),0,40,75,81,2,198,0,14,11,0,0,25,0,54,86,81,2,223
KARNATAKA,2003,17,Service (Private),5,194,266,161,62,688,0,71,51,34,8,164,5,265,317,195,70,852
KARNATAKA,2003,17,Public Sector Undertaking,0,57,91,56,8,212,2,17,6,8,1,34,2,74,97,64,9,246
KARNATAKA,2003,17,Students,54,154,16,2,1,227,62,127,4,2,0,195,116,281,20,4,1,422
KARNATAKA,2003,17,Unemployed,12,235,207,132,64,650,3,63,26,8,7,107,15,298,233,140,71,757
KARNATAKA,2003,17,Professional Activity,0,44,60,26,6,136,0,2,4,2,0,8,0,46,64,28,6,144
KARNATAKA,2003,17,Agriculture (Total),8,593,809,642,274,2326,21,119,107,85,20,352,29,712,916,727,294,2678
KARNATAKA,2003,17,Retired Persons,0,0,0,9,37,46,0,0,0,0,6,6,0,0,0,9,43,52
KARNATAKA,2004,17,House Wife,0,0,0,0,0,0,0,736,609,300,138,1783,0,736,609,300,138,1783
KARNATAKA,2004,17,Service (Government),0,38,65,58,4,165,0,21,10,3,0,34,0,59,75,61,4,199
KARNATAKA,2004,17,Service (Private),5,286,358,192,46,887,1,104,77,29,7,218,6,390,435,221,53,1105
KARNATAKA,2004,17,Public Sector Undertaking,0,55,78,29,7,169,0,30,10,9,0,49,0,85,88,38,7,218
KARNATAKA,2004,17,Students,45,162,25,0,0,232,48,162,6,0,0,216,93,324,31,0,0,448
KARNATAKA,2004,17,Unemployed,4,179,185,101,57,526,2,38,24,7,14,85,6,217,209,108,71,611
KARNATAKA,2004,17,Professional Activity,0,33,35,14,3,85,0,0,0,0,0,0,0,33,35,14,3,85
KARNATAKA,2004,17,Agriculture (Total),1,464,661,432,148,1706,5,84,112,48,8,257,6,548,773,480,156,1963
KARNATAKA,2004,17,Retired Persons,0,0,8,17,50,75,0,0,0,0,0,0,0,0,8,17,50,75
KARNATAKA,2005,17,House Wife,0,0,0,0,0,0,4,816,658,280,116,1874,4,816,658,280,116,1874
KARNATAKA,2005,17,Service (Government),0,32,41,66,0,139,0,9,7,5,0,21,0,41,48,71,0,160
KARNATAKA,2005,17,Service (Private),1,342,295,235,16,889,1,54,35,24,10,124,2,396,330,259,26,1013
KARNATAKA,2005,17,Public Sector Undertaking,0,57,60,56,11,184,0,11,13,10,0,34,0,68,73,66,11,218
KARNATAKA,2005,17,Students,35,137,15,2,0,189,32,134,13,0,0,179,67,271,28,2,0,368
KARNATAKA,2005,17,Unemployed,3,192,117,68,23,403,0,34,20,8,4,66,3,226,137,76,27,469
KARNATAKA,2005,17,Professional Activity,1,59,96,69,17,242,2,3,3,21,7,36,3,62,99,90,24,278
KARNATAKA,2005,17,Agriculture (Total),4,350,691,422,196,1663,0,58,91,61,10,220,4,408,782,483,206,1883
KARNATAKA,2005,17,Retired Persons,0,1,2,8,24,35,0,2,0,3,0,5,0,3,2,11,24,40
KARNATAKA,2006,17,House Wife,0,0,0,0,0,0,0,697,649,369,136,1851,0,697,649,369,136,1851
KARNATAKA,2006,17,Service (Government),0,68,71,75,0,214,0,11,6,7,0,24,0,79,77,82,0,238
KARNATAKA,2006,17,Service (Private),2,285,362,343,46,1038,0,65,48,28,3,144,2,350,410,371,49,1182
KARNATAKA,2006,17,Public Sector Undertaking,0,47,41,43,5,136,0,16,9,8,1,34,0,63,50,51,6,170
KARNATAKA,2006,17,Students,25,173,15,14,3,230,38,174,5,0,0,217,63,347,20,14,3,447
KARNATAKA,2006,17,Unemployed,0,162,146,59,31,398,0,53,14,16,7,90,0,215,160,75,38,488
KARNATAKA,2006,17,Professional Activity,12,64,76,44,14,210,1,4,4,2,2,13,13,68,80,46,16,223
KARNATAKA,2006,17,Agriculture (Total),2,348,576,395,129,1450,5,90,97,56,22,270,7,438,673,451,151,1720
KARNATAKA,2006,17,Retired Persons,0,0,1,6,21,28,0,0,0,0,1,1,0,0,1,6,22,29
KARNATAKA,2007,17,House Wife,0,0,0,0,0,0,1,656,611,382,152,1802,1,656,611,382,152,1802
KARNATAKA,2007,17,Service (Government),0,58,53,67,1,179,0,11,9,5,3,28,0,69,62,72,4,207
KARNATAKA,2007,17,Service (Private),0,273,332,248,49,902,1,114,36,18,5,174,1,387,368,266,54,1076
KARNATAKA,2007,17,Public Sector Undertaking,0,54,68,36,18,176,0,9,9,9,0,27,0,63,77,45,18,203
KARNATAKA,2007,17,Students,51,177,18,0,0,246,58,193,10,0,0,261,109,370,28,0,0,507
KARNATAKA,2007,17,Unemployed,0,137,185,106,22,450,6,63,21,11,1,102,6,200,206,117,23,552
KARNATAKA,2007,17,Professional Activity,0,37,82,58,10,187,0,3,4,0,0,7,0,40,86,58,10,194
KARNATAKA,2007,17,Agriculture (Total),0,311,655,595,211,1772,7,112,125,91,28,363,7,423,780,686,239,2135
KARNATAKA,2007,17,Retired Persons,0,0,1,10,36,47,0,0,0,0,4,4,0,0,1,10,40,51
KARNATAKA,2008,17,House Wife,0,0,0,0,0,0,3,658,587,291,114,1653,3,658,587,291,114,1653
KARNATAKA,2008,17,Service (Government),0,53,57,84,2,196,0,21,19,7,6,53,0,74,76,91,8,249
KARNATAKA,2008,17,Service (Private),0,279,417,311,47,1054,5,120,50,15,22,212,5,399,467,326,69,1266
KARNATAKA,2008,17,Public Sector Undertaking,0,60,77,75,23,235,1,46,6,10,6,69,1,106,83,85,29,304
KARNATAKA,2008,17,Students,24,180,19,18,2,243,25,176,11,0,0,212,49,356,30,18,2,455
KARNATAKA,2008,17,Unemployed,0,146,153,78,24,401,2,45,35,11,0,93,2,191,188,89,24,494
KARNATAKA,2008,17,Professional Activity,0,30,31,52,5,118,0,16,3,2,1,22,0,46,34,54,6,140
KARNATAKA,2008,17,Agriculture (Total),0,255,570,435,179,1439,0,99,120,59,20,298,0,354,690,494,199,1737
KARNATAKA,2008,17,Retired Persons,0,0,4,12,35,51,0,1,0,1,4,6,0,1,4,13,39,57
KARNATAKA,2009,17,House Wife,0,0,0,0,0,0,12,526,608,378,172,1696,12,526,608,378,172,1696
KARNATAKA,2009,17,Service (Government),0,14,32,45,1,92,0,9,4,2,0,15,0,23,36,47,1,107
KARNATAKA,2009,17,Service (Private),0,230,296,139,68,733,1,66,31,11,13,122,1,296,327,150,81,855
KARNATAKA,2009,17,Public Sector Undertaking,0,115,72,42,15,244,0,18,16,12,2,48,0,133,88,54,17,292
KARNATAKA,2009,17,Students,39,206,29,0,0,274,19,207,7,0,0,233,58,413,36,0,0,507
KARNATAKA,2009,17,Unemployed,0,130,227,98,25,480,2,33,12,5,3,55,2,163,239,103,28,535
KARNATAKA,2009,17,Professional Activity,0,39,58,40,7,144,0,8,2,1,0,11,0,47,60,41,7,155
KARNATAKA,2009,17,Agriculture (Total),6,318,705,590,296,1915,0,112,163,70,22,367,6,430,868,660,318,2282
KARNATAKA,2009,17,Retired Persons,0,0,5,3,41,49,0,4,1,0,1,6,0,4,6,3,42,55
KARNATAKA,2010,17,House Wife,0,0,0,0,0,0,2,703,664,361,159,1889,2,703,664,361,159,1889
KARNATAKA,2010,17,Service (Government),0,37,60,65,16,178,0,17,17,4,2,40,0,54,77,69,18,218
KARNATAKA,2010,17,Service (Private),0,244,377,204,64,889,0,124,71,23,9,227,0,368,448,227,73,1116
KARNATAKA,2010,17,Public Sector Undertaking,0,85,79,58,32,254,0,15,12,14,0,41,0,100,91,72,32,295
KARNATAKA,2010,17,Students,43,238,9,22,7,319,89,176,7,0,0,272,132,414,16,22,7,591
KARNATAKA,2010,17,Unemployed,0,125,122,95,20,362,0,35,21,2,0,58,0,160,143,97,20,420
KARNATAKA,2010,17,Professional Activity,2,30,34,38,6,110,0,5,7,3,0,15,2,35,41,41,6,125
KARNATAKA,2010,17,Agriculture (Total),3,381,723,751,270,2128,11,159,128,111,48,457,14,540,851,862,318,2585
KARNATAKA,2010,17,Retired Persons,0,0,2,29,60,91,0,0,0,2,7,9,0,0,2,31,67,100
KARNATAKA,2011,17,House Wife,0,0,0,0,0,0,0,585,635,417,139,1776,0,585,635,417,139,1776
KARNATAKA,2011,17,Service (Government),0,29,73,57,1,160,0,13,10,5,3,31,0,42,83,62,4,191
KARNATAKA,2011,17,Service (Private),0,180,377,159,45,761,1,107,68,35,22,233,1,287,445,194,67,994
KARNATAKA,2011,17,Public Sector Undertaking,0,125,114,98,25,362,0,37,22,17,1,77,0,162,136,115,26,439
KARNATAKA,2011,17,Students,68,343,10,4,0,425,19,235,21,8,3,286,87,578,31,12,3,711
KARNATAKA,2011,17,Unemployed,0,256,362,154,28,800,2,86,14,14,8,124,2,342,376,168,36,924
KARNATAKA,2011,17,Professional Activity,1,60,48,36,21,166,1,14,6,5,4,30,2,74,54,41,25,196
KARNATAKA,2011,17,Agriculture (Total),0,339,630,527,198,1694,0,127,137,126,16,406,0,466,767,653,214,2100
KARNATAKA,2011,17,Retired Persons,0,0,0,9,46,55,0,0,2,3,3,8,0,0,2,12,49,63
KARNATAKA,2012,17,House Wife,0,0,0,0,0,0,0,717,601,373,159,1850,0,717,601,373,159,1850
KARNATAKA,2012,17,Service (Government),0,24,68,78,4,174,0,14,13,2,0,29,0,38,81,80,4,203
KARNATAKA,2012,17,Service (Private),0,392,338,233,37,1000,4,126,82,40,9,261,4,518,420,273,46,1261
KARNATAKA,2012,17,Public Sector Undertaking,0,71,98,70,15,254,0,19,47,21,1,88,0,90,145,91,16,342
KARNATAKA,2012,17,Students,33,257,6,0,0,296,51,198,9,5,1,264,84,455,15,5,1,560
KARNATAKA,2012,17,Unemployed,0,166,299,134,34,633,0,47,16,13,6,82,0,213,315,147,40,715
KARNATAKA,2012,17,Professional Activity,6,67,83,83,29,268,0,14,12,5,2,33,6,81,95,88,31,301
KARNATAKA,2012,17,Agriculture (Total),0,289,554,482,191,1516,0,113,124,100,22,359,0,402,678,582,213,1875
KARNATAKA,2012,17,Retired Persons,0,0,1,28,31,60,0,0,0,1,8,9,0,0,1,29,39,69
KARNATAKA,2013,17,House Wife,0,0,0,0,0,0,3,703,583,258,127,1674,3,703,583,258,127,1674
KARNATAKA,2013,17,Service (Government),0,31,66,67,19,183,0,29,13,6,4,52,0,60,79,73,23,235
KARNATAKA,2013,17,Service (Private),0,307,339,204,37,887,0,105,54,23,4,186,0,412,393,227,41,1073
KARNATAKA,2013,17,Public Sector Undertaking,0,45,52,48,14,159,0,20,11,8,6,45,0,65,63,56,20,204
KARNATAKA,2013,17,Students,59,283,27,7,10,386,46,224,4,8,4,286,105,507,31,15,14,672
KARNATAKA,2013,17,Unemployed,3,226,265,136,60,690,2,59,16,8,5,90,5,285,281,144,65,780
KARNATAKA,2013,17,Professional Activity,3,64,59,58,19,203,0,2,4,3,1,10,3,66,63,61,20,213
KARNATAKA,2013,17,Agriculture (Total),0,220,461,374,177,1232,3,38,49,43,38,171,3,258,510,417,215,1403
KARNATAKA,2013,17,Retired Persons,0,0,0,2,41,43,0,0,0,0,3,3,0,0,0,2,44,46
KARNATAKA,2014,17,House Wife,0,0,0,0,0,0,0,560,423,185,107,1275,0,560,423,185,107,1275
KARNATAKA,2014,17,Service (Government),0,31,65,58,2,156,0,9,16,5,1,31,0,40,81,63,3,187
KARNATAKA,2014,17,Service (Private),0,194,172,65,5,436,0,64,24,8,1,97,0,258,196,73,6,533
KARNATAKA,2014,17,Public Sector Undertaking,0,23,34,13,2,72,0,1,1,5,0,7,0,24,35,18,2,79
KARNATAKA,2014,17,Students,26,245,6,1,0,278,24,253,15,0,0,292,50,498,21,1,0,570
KARNATAKA,2014,17,Unemployed,0,201,180,73,44,498,0,47,9,11,1,68,0,248,189,84,45,566
KARNATAKA,2014,17,Agriculture (Total),0,209,252,198,55,714,0,25,15,10,4,54,0,234,267,208,59,768
KARNATAKA,2014,17,Retired Persons,0,9,7,9,40,65,0,0,1,0,0,1,0,9,8,9,40,66
KERALA,2001,18,House Wife,0,0,0,0,0,0,0,290,475,394,247,1406,0,290,475,394,247,1406
KERALA,2001,18,Service (Government),0,10,53,111,2,176,0,7,15,9,0,31,0,17,68,120,2,207
KERALA,2001,18,Service (Private),0,73,145,139,92,449,0,25,33,24,35,117,0,98,178,163,127,566
KERALA,2001,18,Public Sector Undertaking,0,35,48,63,37,183,0,3,12,10,2,27,0,38,60,73,39,210
KERALA,2001,18,Students,37,90,1,0,0,128,33,119,1,0,0,153,70,209,2,0,0,281
KERALA,2001,18,Unemployed,0,312,550,560,334,1756,3,155,74,41,66,339,3,467,624,601,400,2095
KERALA,2001,18,Professional Activity,0,30,77,74,21,202,0,2,9,8,2,21,0,32,86,82,23,223
KERALA,2001,18,Agriculture (Total),0,93,325,362,194,974,0,18,17,12,14,61,0,111,342,374,208,1035
KERALA,2001,18,Retired Persons,0,1,2,29,67,99,0,0,2,7,11,20,0,1,4,36,78,119
KERALA,2002,18,House Wife,0,0,0,0,0,0,0,295,504,409,245,1453,0,295,504,409,245,1453
KERALA,2002,18,Service (Government),0,19,67,64,2,152,0,6,5,7,2,20,0,25,72,71,4,172
KERALA,2002,18,Service (Private),0,96,148,115,38,397,1,25,27,20,3,76,1,121,175,135,41,473
KERALA,2002,18,Public Sector Undertaking,0,13,35,39,9,96,0,6,10,3,2,21,0,19,45,42,11,117
KERALA,2002,18,Students,32,112,2,0,0,146,41,95,0,0,0,136,73,207,2,0,0,282
KERALA,2002,18,Unemployed,0,340,473,357,429,1599,0,137,94,65,44,340,0,477,567,422,473,1939
KERALA,2002,18,Professional Activity,0,63,112,78,38,291,0,8,10,3,1,22,0,71,122,81,39,313
KERALA,2002,18,Agriculture (Total),0,134,426,614,259,1433,0,17,32,27,24,100,0,151,458,641,283,1533
KERALA,2002,18,Retired Persons,0,0,5,22,93,120,0,0,0,4,13,17,0,0,5,26,106,137
KERALA,2003,18,House Wife,0,0,0,0,0,0,0,294,467,373,297,1431,0,294,467,373,297,1431
KERALA,2003,18,Service (Government),0,4,35,47,0,86,0,7,5,7,0,19,0,11,40,54,0,105
KERALA,2003,18,Service (Private),0,54,142,105,24,325,0,16,17,5,3,41,0,70,159,110,27,366
KERALA,2003,18,Public Sector Undertaking,0,8,22,32,1,63,0,8,0,4,0,12,0,16,22,36,1,75
KERALA,2003,18,Students,43,109,8,0,0,160,33,109,12,0,0,154,76,218,20,0,0,314
KERALA,2003,18,Unemployed,0,249,195,207,232,883,1,118,28,24,45,216,1,367,223,231,277,1099
KERALA,2003,18,Professional Activity,0,26,65,46,12,149,0,3,2,1,0,6,0,29,67,47,12,155
KERALA,2003,18,Agriculture (Total),0,141,407,600,372,1520,0,18,15,17,13,63,0,159,422,617,385,1583
KERALA,2003,18,Retired Persons,0,0,3,29,44,76,0,0,0,4,3,7,0,0,3,33,47,83
KERALA,2004,18,House Wife,0,0,0,0,0,0,0,288,484,413,328,1513,0,288,484,413,328,1513
KERALA,2004,18,Service (Government),0,4,39,40,0,83,0,1,3,1,0,5,0,5,42,41,0,88
KERALA,2004,18,Service (Private),0,38,101,70,11,220,0,13,9,4,2,28,0,51,110,74,13,248
KERALA,2004,18,Public Sector Undertaking,0,6,17,8,0,31,0,1,3,3,1,8,0,7,20,11,1,39
KERALA,2004,18,Students,37,106,0,0,0,143,38,153,2,0,0,193,75,259,2,0,0,336
KERALA,2004,18,Unemployed,2,282,299,208,215,1006,0,123,47,32,56,258,2,405,346,240,271,1264
KERALA,2004,18,Professional Activity,0,39,57,46,8,150,0,4,2,0,0,6,0,43,59,46,8,156
KERALA,2004,18,Agriculture (Total),0,73,240,330,217,860,0,7,13,17,6,43,0,80,253,347,223,903
KERALA,2004,18,Retired Persons,0,0,0,17,67,84,0,0,0,1,8,9,0,0,0,18,75,93
KERALA,2005,18,House Wife,0,0,0,0,0,0,0,305,421,390,297,1413,0,305,421,390,297,1413
KERALA,2005,18,Service (Government),0,1,30,36,0,67,0,4,6,8,0,18,0,5,36,44,0,85
KERALA,2005,18,Service (Private),0,45,131,82,15,273,0,24,14,9,2,49,0,69,145,91,17,322
KERALA,2005,18,Public Sector Undertaking,0,6,17,23,0,46,0,6,1,3,0,10,0,12,18,26,0,56
KERALA,2005,18,Students,40,100,0,0,0,140,40,100,1,0,0,141,80,200,1,0,0,281
KERALA,2005,18,Unemployed,0,268,355,228,129,980,1,114,58,33,35,241,1,382,413,261,164,1221
KERALA,2005,18,Professional Activity,0,31,65,48,7,151,0,7,3,1,0,11,0,38,68,49,7,162
KERALA,2005,18,Agriculture (Total),0,89,337,383,264,1073,1,3,17,17,7,45,1,92,354,400,271,1118
KERALA,2005,18,Retired Persons,0,0,0,31,61,92,0,0,1,1,10,12,0,0,1,32,71,104
KERALA,2006,18,House Wife,0,0,0,0,0,0,0,289,404,388,269,1350,0,289,404,388,269,1350
KERALA,2006,18,Service (Government),0,3,31,41,0,75,0,2,5,7,0,14,0,5,36,48,0,89
KERALA,2006,18,Service (Private),0,75,148,134,13,370,0,27,27,7,1,62,0,102,175,141,14,432
KERALA,2006,18,Public Sector Undertaking,0,3,29,22,4,58,0,4,7,7,2,20,0,7,36,29,6,78
KERALA,2006,18,Students,45,71,0,0,0,116,53,102,0,0,0,155,98,173,0,0,0,271
KERALA,2006,18,Unemployed,1,210,348,283,157,999,0,101,54,29,34,218,1,311,402,312,191,1217
KERALA,2006,18,Professional Activity,0,43,82,69,16,210,0,8,7,5,0,20,0,51,89,74,16,230
KERALA,2006,18,Agriculture (Total),0,86,273,420,249,1028,0,9,26,37,24,96,0,95,299,457,273,1124
KERALA,2006,18,Retired Persons,0,0,8,38,65,111,0,0,0,5,12,17,0,0,8,43,77,128
KERALA,2007,18,House Wife,0,0,0,0,0,0,0,289,394,433,210,1326,0,289,394,433,210,1326
KERALA,2007,18,Service (Government),0,2,34,52,0,88,0,0,5,6,0,11,0,2,39,58,0,99
KERALA,2007,18,Service (Private),0,34,209,135,12,390,0,21,33,24,0,78,0,55,242,159,12,468
KERALA,2007,18,Public Sector Undertaking,0,3,32,50,6,91,0,2,5,6,0,13,0,5,37,56,6,104
KERALA,2007,18,Students,33,82,0,0,0,115,34,124,2,0,0,160,67,206,2,0,0,275
KERALA,2007,18,Unemployed,0,209,325,135,3,672,0,72,66,28,8,174,0,281,391,163,11,846
KERALA,2007,18,Professional Activity,0,38,79,69,8,194,0,4,3,4,1,12,0,42,82,73,9,206
KERALA,2007,18,Agriculture (Total),0,102,290,508,258,1158,0,13,21,25,15,74,0,115,311,533,273,1232
KERALA,2007,18,Retired Persons,0,0,0,20,68,88,0,0,0,0,6,6,0,0,0,20,74,94
KERALA,2008,18,House Wife,0,0,0,0,0,0,0,258,435,376,251,1320,0,258,435,376,251,1320
KERALA,2008,18,Service (Government),0,3,27,36,1,67,0,1,7,5,0,13,0,4,34,41,1,80
KERALA,2008,18,Service (Private),0,52,176,147,14,389,0,23,28,25,1,77,0,75,204,172,15,466
KERALA,2008,18,Public Sector Undertaking,0,4,35,37,0,76,0,3,4,3,0,10,0,7,39,40,0,86
KERALA,2008,18,Students,25,66,0,0,0,91,38,157,0,0,0,195,63,223,0,0,0,286
KERALA,2008,18,Unemployed,0,180,294,131,63,668,0,71,46,35,11,163,0,251,340,166,74,831
KERALA,2008,18,Professional Activity,0,32,57,48,11,148,0,2,5,3,0,10,0,34,62,51,11,158
KERALA,2008,18,Agriculture (Total),0,71,219,294,184,768,0,8,11,23,10,52,0,79,230,317,194,820
KERALA,2008,18,Retired Persons,0,0,1,23,76,100,0,0,0,1,8,9,0,0,1,24,84,109
KERALA,2009,18,House Wife,0,0,0,0,0,0,0,258,375,422,261,1316,0,258,375,422,261,1316
KERALA,2009,18,Service (Government),0,7,24,25,1,57,0,3,6,6,0,15,0,10,30,31,1,72
KERALA,2009,18,Service (Private),1,72,162,103,16,354,0,28,28,18,6,80,1,100,190,121,22,434
KERALA,2009,18,Public Sector Undertaking,0,7,37,43,0,87,0,9,5,5,0,19,0,16,42,48,0,106
KERALA,2009,18,Students,32,75,0,0,0,107,30,137,0,0,0,167,62,212,0,0,0,274
KERALA,2009,18,Unemployed,0,130,220,134,136,620,0,55,57,22,49,183,0,185,277,156,185,803
KERALA,2009,18,Professional Activity,0,48,73,68,24,213,0,3,5,7,0,15,0,51,78,75,24,228
KERALA,2009,18,Agriculture (Total),0,116,252,294,158,820,0,19,18,23,16,76,0,135,270,317,174,896
KERALA,2009,18,Retired Persons,0,0,5,16,62,83,0,0,0,2,10,12,0,0,5,18,72,95
KERALA,2010,18,House Wife,0,0,0,0,0,0,0,270,370,349,230,1219,0,270,370,349,230,1219
KERALA,2010,18,Service (Government),0,7,28,27,0,62,0,1,5,3,0,9,0,8,33,30,0,71
KERALA,2010,18,Service (Private),0,66,149,158,7,380,0,28,33,13,0,74,0,94,182,171,7,454
KERALA,2010,18,Public Sector Undertaking,0,23,59,52,2,136,0,4,4,4,0,12,0,27,63,56,2,148
KERALA,2010,18,Students,56,72,1,0,0,129,44,140,0,0,0,184,100,212,1,0,0,313
KERALA,2010,18,Unemployed,1,162,248,214,207,832,1,52,55,32,70,210,2,214,303,246,277,1042
KERALA,2010,18,Professional Activity,0,25,56,81,13,175,0,4,5,1,1,11,0,29,61,82,14,186
KERALA,2010,18,Agriculture (Total),0,98,242,264,193,797,0,28,26,14,30,98,0,126,268,278,223,895
KERALA,2010,18,Retired Persons,0,0,2,14,50,66,0,0,1,2,7,10,0,0,3,16,57,76
KERALA,2011,18,House Wife,0,0,0,0,0,0,0,238,396,320,260,1214,0,238,396,320,260,1214
KERALA,2011,18,Service (Government),0,3,22,29,0,54,0,2,6,4,1,13,0,5,28,33,1,67
KERALA,2011,18,Service (Private),0,79,139,119,17,354,0,27,34,17,0,78,0,106,173,136,17,432
KERALA,2011,18,Public Sector Undertaking,0,6,20,25,0,51,0,0,1,1,0,2,0,6,21,26,0,53
KERALA,2011,18,Students,28,61,0,0,0,89,32,125,0,0,0,157,60,186,0,0,0,246
KERALA,2011,18,Unemployed,0,94,165,117,54,430,0,54,40,10,11,115,0,148,205,127,65,545
KERALA,2011,18,Professional Activity,0,26,71,43,15,155,0,7,3,2,0,12,0,33,74,45,15,167
KERALA,2011,18,Agriculture (Total),0,101,215,230,186,732,0,21,25,34,18,98,0,122,240,264,204,830
KERALA,2011,18,Retired Persons,0,0,1,41,56,98,0,0,0,2,4,6,0,0,1,43,60,104
KERALA,2012,18,House Wife,0,0,0,0,0,0,0,250,323,372,249,1194,0,250,323,372,249,1194
KERALA,2012,18,Service (Government),0,4,21,27,0,52,0,1,4,4,0,9,0,5,25,31,0,61
KERALA,2012,18,Service (Private),0,92,190,163,38,483,0,36,25,19,0,80,0,128,215,182,38,563
KERALA,2012,18,Public Sector Undertaking,0,9,33,31,2,75,0,1,2,3,1,7,0,10,35,34,3,82
KERALA,2012,18,Students,31,59,0,0,0,90,27,146,0,0,0,173,58,205,0,0,0,263
KERALA,2012,18,Unemployed,0,80,194,214,123,611,0,39,51,27,25,142,0,119,245,241,148,753
KERALA,2012,18,Professional Activity,0,20,50,81,11,162,0,6,2,2,0,10,0,26,52,83,11,172
KERALA,2012,18,Agriculture (Total),0,71,293,360,258,982,0,25,30,26,18,99,0,96,323,386,276,1081
KERALA,2012,18,Retired Persons,0,0,0,28,51,79,0,0,0,3,8,11,0,0,0,31,59,90
KERALA,2013,18,House Wife,0,0,0,0,0,0,0,196,326,302,221,1045,0,196,326,302,221,1045
KERALA,2013,18,Service (Government),0,10,28,29,17,84,0,4,7,10,11,32,0,14,35,39,28,116
KERALA,2013,18,Service (Private),0,122,221,199,38,580,0,21,28,11,4,64,0,143,249,210,42,644
KERALA,2013,18,Public Sector Undertaking,0,4,40,35,2,81,0,2,7,10,1,20,0,6,47,45,3,101
KERALA,2013,18,Students,38,82,6,8,0,134,43,122,2,0,0,167,81,204,8,8,0,301
KERALA,2013,18,Unemployed,0,87,249,191,120,647,0,37,37,24,31,129,0,124,286,215,151,776
KERALA,2013,18,Professional Activity,0,37,61,75,14,187,0,5,7,6,1,19,0,42,68,81,15,206
KERALA,2013,18,Agriculture (Total),0,94,243,341,204,882,0,27,15,17,31,90,0,121,258,358,235,972
KERALA,2013,18,Retired Persons,0,0,1,27,86,114,0,0,0,7,17,24,0,0,1,34,103,138
KERALA,2014,18,House Wife,0,0,0,0,0,0,0,231,304,225,190,950,0,231,304,225,190,950
KERALA,2014,18,Service (Government),0,3,21,29,2,55,0,5,2,7,0,14,0,8,23,36,2,69
KERALA,2014,18,Service (Private),0,97,138,175,24,434,0,31,18,15,0,64,0,128,156,190,24,498
KERALA,2014,18,Public Sector Undertaking,0,9,24,21,0,54,0,1,5,7,0,13,0,10,29,28,0,67
KERALA,2014,18,Students,29,154,1,2,0,186,22,209,1,0,0,232,51,363,2,2,0,418
KERALA,2014,18,Unemployed,0,176,243,330,377,1126,0,67,30,31,75,203,0,243,273,361,452,1329
KERALA,2014,18,Agriculture (Total),0,93,208,219,155,675,0,16,26,39,51,132,0,109,234,258,206,807
KERALA,2014,18,Retired Persons,0,2,2,16,89,109,0,1,0,1,9,11,0,3,2,17,98,120
LAKSHADWEEP,2001,19,House Wife,0,0,0,0,0,0,0,0,0,0,0,0,0,0,0,0,0,0
LAKSHADWEEP,2001,19,Service (Government),0,0,0,0,0,0,0,0,0,0,0,0,0,0,0,0,0,0
LAKSHADWEEP,2001,19,Service (Private),0,0,0,0,0,0,0,0,0,0,0,0,0,0,0,0,0,0
LAKSHADWEEP,2001,19,Public Sector Undertaking,0,0,0,0,0,0,0,0,0,0,0,0,0,0,0,0,0,0
LAKSHADWEEP,2001,19,Students,0,0,0,0,0,0,0,0,0,0,0,0,0,0,0,0,0,0
LAKSHADWEEP,2001,19,Unemployed,0,0,0,0,0,0,0,0,0,0,0,0,0,0,0,0,0,0
LAKSHADWEEP,2001,19,Professional Activity,0,0,0,0,0,0,0,0,0,0,0,0,0,0,0,0,0,0
LAKSHADWEEP,2001,19,Agriculture (Total),0,0,0,0,0,0,0,0,0,0,0,0,0,0,0,0,0,0
LAKSHADWEEP,2001,19,Retired Persons,0,0,0,0,0,0,0,0,0,0,0,0,0,0,0,0,0,0
LAKSHADWEEP,2002,19,House Wife,0,0,0,0,0,0,0,0,0,0,0,0,0,0,0,0,0,0
LAKSHADWEEP,2002,19,Service (Government),0,0,0,0,0,0,0,0,0,0,0,0,0,0,0,0,0,0
LAKSHADWEEP,2002,19,Service (Private),0,0,0,0,0,0,0,0,0,0,0,0,0,0,0,0,0,0
LAKSHADWEEP,2002,19,Public Sector Undertaking,0,0,0,0,0,0,0,0,0,0,0,0,0,0,0,0,0,0
LAKSHADWEEP,2002,19,Students,0,0,0,0,0,0,0,0,0,0,0,0,0,0,0,0,0,0
LAKSHADWEEP,2002,19,Unemployed,0,0,0,0,0,0,0,0,0,0,0,0,0,0,0,0,0,0
LAKSHADWEEP,2002,19,Professional Activity,0,0,0,0,0,0,0,0,0,0,0,0,0,0,0,0,0,0
LAKSHADWEEP,2002,19,Agriculture (Total),0,0,0,0,0,0,0,0,0,0,0,0,0,0,0,0,0,0
LAKSHADWEEP,2002,19,Retired Persons,0,0,0,0,0,0,0,0,0,0,0,0,0,0,0,0,0,0
LAKSHADWEEP,2003,19,House Wife,0,0,0,0,0,0,0,1,0,0,0,1,0,1,0,0,0,1
LAKSHADWEEP,2003,19,Service (Government),0,0,0,0,0,0,0,0,0,0,0,0,0,0,0,0,0,0
LAKSHADWEEP,2003,19,Service (Private),0,0,0,0,0,0,0,0,0,0,0,0,0,0,0,0,0,0
LAKSHADWEEP,2003,19,Public Sector Undertaking,0,0,0,0,0,0,0,0,0,0,0,0,0,0,0,0,0,0
LAKSHADWEEP,2003,19,Students,0,0,0,0,0,0,0,0,0,0,0,0,0,0,0,0,0,0
LAKSHADWEEP,2003,19,Unemployed,0,0,0,0,0,0,0,0,0,0,0,0,0,0,0,0,0,0
LAKSHADWEEP,2003,19,Professional Activity,0,0,0,0,0,0,0,0,0,0,0,0,0,0,0,0,0,0
LAKSHADWEEP,2003,19,Agriculture (Total),0,0,0,0,0,0,0,0,0,0,0,0,0,0,0,0,0,0
LAKSHADWEEP,2003,19,Retired Persons,0,0,0,0,0,0,0,0,0,0,0,0,0,0,0,0,0,0
LAKSHADWEEP,2004,19,House Wife,0,0,0,0,0,0,0,0,0,0,0,0,0,0,0,0,0,0
LAKSHADWEEP,2004,19,Service (Government),0,0,0,0,0,0,0,0,0,0,0,0,0,0,0,0,0,0
LAKSHADWEEP,2004,19,Service (Private),0,0,0,0,0,0,0,0,0,0,0,0,0,0,0,0,0,0
LAKSHADWEEP,2004,19,Public Sector Undertaking,0,0,0,0,0,0,0,0,0,0,0,0,0,0,0,0,0,0
LAKSHADWEEP,2004,19,Students,0,0,0,0,0,0,0,0,0,0,0,0,0,0,0,0,0,0
LAKSHADWEEP,2004,19,Unemployed,0,0,0,0,0,0,0,0,0,0,0,0,0,0,0,0,0,0
LAKSHADWEEP,2004,19,Professional Activity,0,0,0,0,0,0,0,0,0,0,0,0,0,0,0,0,0,0
LAKSHADWEEP,2004,19,Agriculture (Total),0,0,0,0,0,0,0,0,0,0,0,0,0,0,0,0,0,0
LAKSHADWEEP,2004,19,Retired Persons,0,0,0,0,0,0,0,0,0,0,0,0,0,0,0,0,0,0
LAKSHADWEEP,2005,19,House Wife,0,0,0,0,0,0,0,0,0,0,0,0,0,0,0,0,0,0
LAKSHADWEEP,2005,19,Service (Government),0,0,0,0,0,0,0,0,0,0,0,0,0,0,0,0,0,0
LAKSHADWEEP,2005,19,Service (Private),0,0,0,0,0,0,0,0,0,0,0,0,0,0,0,0,0,0
LAKSHADWEEP,2005,19,Public Sector Undertaking,0,0,0,0,0,0,0,0,0,0,0,0,0,0,0,0,0,0
LAKSHADWEEP,2005,19,Students,0,0,0,0,0,0,0,0,0,0,0,0,0,0,0,0,0,0
LAKSHADWEEP,2005,19,Unemployed,0,0,0,0,0,0,0,0,0,0,0,0,0,0,0,0,0,0
LAKSHADWEEP,2005,19,Professional Activity,0,0,0,0,0,0,0,0,0,0,0,0,0,0,0,0,0,0
LAKSHADWEEP,2005,19,Agriculture (Total),0,0,0,0,0,0,0,0,0,0,0,0,0,0,0,0,0,0
LAKSHADWEEP,2005,19,Retired Persons,0,0,0,0,0,0,0,0,0,0,0,0,0,0,0,0,0,0
LAKSHADWEEP,2006,19,House Wife,0,0,0,0,0,0,0,1,0,0,0,1,0,1,0,0,0,1
LAKSHADWEEP,2006,19,Service (Government),0,0,1,0,0,1,0,0,0,0,0,0,0,0,1,0,0,1
LAKSHADWEEP,2006,19,Service (Private),0,0,0,0,0,0,0,0,0,0,0,0,0,0,0,0,0,0
LAKSHADWEEP,2006,19,Public Sector Undertaking,0,0,0,0,0,0,0,0,0,0,0,0,0,0,0,0,0,0
LAKSHADWEEP,2006,19,Students,0,0,0,0,0,0,0,0,0,0,0,0,0,0,0,0,0,0
LAKSHADWEEP,2006,19,Unemployed,0,0,0,0,0,0,0,0,0,0,0,0,0,0,0,0,0,0
LAKSHADWEEP,2006,19,Professional Activity,0,0,0,0,0,0,0,0,0,0,0,0,0,0,0,0,0,0
LAKSHADWEEP,2006,19,Agriculture (Total),0,0,0,0,0,0,0,0,0,0,0,0,0,0,0,0,0,0
LAKSHADWEEP,2006,19,Retired Persons,0,0,0,0,0,0,0,0,0,0,0,0,0,0,0,0,0,0
LAKSHADWEEP,2007,19,House Wife,0,0,0,0,0,0,0,0,0,2,0,2,0,0,0,2,0,2
LAKSHADWEEP,2007,19,Service (Government),0,0,1,0,0,1,0,0,0,0,0,0,0,0,1,0,0,1
LAKSHADWEEP,2007,19,Service (Private),0,0,0,0,0,0,0,0,0,0,0,0,0,0,0,0,0,0
LAKSHADWEEP,2007,19,Public Sector Undertaking,0,0,0,0,0,0,0,0,0,0,0,0,0,0,0,0,0,0
LAKSHADWEEP,2007,19,Students,0,0,0,0,0,0,0,0,0,0,0,0,0,0,0,0,0,0
LAKSHADWEEP,2007,19,Unemployed,0,0,0,0,0,0,0,0,0,0,0,0,0,0,0,0,0,0
LAKSHADWEEP,2007,19,Professional Activity,0,0,0,0,0,0,0,0,0,0,0,0,0,0,0,0,0,0
LAKSHADWEEP,2007,19,Agriculture (Total),0,0,0,0,0,0,0,0,0,0,0,0,0,0,0,0,0,0
LAKSHADWEEP,2007,19,Retired Persons,0,0,0,0,0,0,0,0,0,0,0,0,0,0,0,0,0,0
LAKSHADWEEP,2008,19,House Wife,0,0,0,0,0,0,0,0,0,0,0,0,0,0,0,0,0,0
LAKSHADWEEP,2008,19,Service (Government),0,0,0,0,0,0,0,0,0,0,0,0,0,0,0,0,0,0
LAKSHADWEEP,2008,19,Service (Private),0,0,0,0,0,0,0,0,0,0,0,0,0,0,0,0,0,0
LAKSHADWEEP,2008,19,Public Sector Undertaking,0,0,0,0,0,0,0,0,0,0,0,0,0,0,0,0,0,0
LAKSHADWEEP,2008,19,Students,0,0,0,0,0,0,0,0,0,0,0,0,0,0,0,0,0,0
LAKSHADWEEP,2008,19,Unemployed,0,0,0,0,0,0,0,0,0,0,0,0,0,0,0,0,0,0
LAKSHADWEEP,2008,19,Professional Activity,0,0,0,0,0,0,0,0,0,0,0,0,0,0,0,0,0,0
LAKSHADWEEP,2008,19,Agriculture (Total),0,0,0,0,0,0,0,0,0,0,0,0,0,0,0,0,0,0
LAKSHADWEEP,2008,19,Retired Persons,0,0,0,0,0,0,0,0,0,0,0,0,0,0,0,0,0,0
LAKSHADWEEP,2009,19,House Wife,0,0,0,0,0,0,0,0,1,0,0,1,0,0,1,0,0,1
LAKSHADWEEP,2009,19,Service (Government),0,0,0,0,0,0,0,0,0,0,0,0,0,0,0,0,0,0
LAKSHADWEEP,2009,19,Service (Private),0,0,0,0,0,0,0,0,0,0,0,0,0,0,0,0,0,0
LAKSHADWEEP,2009,19,Public Sector Undertaking,0,0,0,0,0,0,0,0,0,0,0,0,0,0,0,0,0,0
LAKSHADWEEP,2009,19,Students,0,0,0,0,0,0,0,0,0,0,0,0,0,0,0,0,0,0
LAKSHADWEEP,2009,19,Unemployed,0,0,0,0,0,0,0,0,0,0,0,0,0,0,0,0,0,0
LAKSHADWEEP,2009,19,Professional Activity,0,0,0,0,0,0,0,0,0,0,0,0,0,0,0,0,0,0
LAKSHADWEEP,2009,19,Agriculture (Total),0,0,0,0,0,0,0,0,0,0,0,0,0,0,0,0,0,0
LAKSHADWEEP,2009,19,Retired Persons,0,0,0,0,0,0,0,0,0,0,0,0,0,0,0,0,0,0
LAKSHADWEEP,2010,19,House Wife,0,0,0,0,0,0,0,0,1,0,0,1,0,0,1,0,0,1
LAKSHADWEEP,2010,19,Service (Government),0,0,0,0,0,0,0,0,0,0,0,0,0,0,0,0,0,0
LAKSHADWEEP,2010,19,Service (Private),0,0,0,0,0,0,0,0,0,0,0,0,0,0,0,0,0,0
LAKSHADWEEP,2010,19,Public Sector Undertaking,0,0,0,0,0,0,0,0,0,0,0,0,0,0,0,0,0,0
LAKSHADWEEP,2010,19,Students,0,0,0,0,0,0,0,0,0,0,0,0,0,0,0,0,0,0
LAKSHADWEEP,2010,19,Unemployed,0,0,0,0,0,0,0,0,0,0,0,0,0,0,0,0,0,0
LAKSHADWEEP,2010,19,Professional Activity,0,0,0,0,0,0,0,0,0,0,0,0,0,0,0,0,0,0
LAKSHADWEEP,2010,19,Agriculture (Total),0,0,0,0,0,0,0,0,0,0,0,0,0,0,0,0,0,0
LAKSHADWEEP,2010,19,Retired Persons,0,0,0,0,0,0,0,0,0,0,0,0,0,0,0,0,0,0
LAKSHADWEEP,2011,19,House Wife,0,0,0,0,0,0,0,0,0,0,0,0,0,0,0,0,0,0
LAKSHADWEEP,2011,19,Service (Government),0,0,0,0,0,0,0,0,0,0,0,0,0,0,0,0,0,0
LAKSHADWEEP,2011,19,Service (Private),0,0,0,0,0,0,0,0,0,0,0,0,0,0,0,0,0,0
LAKSHADWEEP,2011,19,Public Sector Undertaking,0,0,0,0,0,0,0,0,0,0,0,0,0,0,0,0,0,0
LAKSHADWEEP,2011,19,Students,0,0,0,0,0,0,0,0,0,0,0,0,0,0,0,0,0,0
LAKSHADWEEP,2011,19,Unemployed,0,0,0,0,0,0,0,0,0,0,0,0,0,0,0,0,0,0
LAKSHADWEEP,2011,19,Professional Activity,0,0,0,0,0,0,0,0,0,0,0,0,0,0,0,0,0,0
LAKSHADWEEP,2011,19,Agriculture (Total),0,0,0,0,0,0,0,0,0,0,0,0,0,0,0,0,0,0
LAKSHADWEEP,2011,19,Retired Persons,0,0,0,0,0,0,0,0,0,0,0,0,0,0,0,0,0,0
LAKSHADWEEP,2012,19,House Wife,0,0,0,0,0,0,0,0,0,0,0,0,0,0,0,0,0,0
LAKSHADWEEP,2012,19,Service (Government),0,0,0,0,0,0,0,0,0,0,0,0,0,0,0,0,0,0
LAKSHADWEEP,2012,19,Service (Private),0,0,0,0,0,0,0,0,0,0,0,0,0,0,0,0,0,0
LAKSHADWEEP,2012,19,Public Sector Undertaking,0,0,0,0,0,0,0,0,0,0,0,0,0,0,0,0,0,0
LAKSHADWEEP,2012,19,Students,0,0,0,0,0,0,0,0,0,0,0,0,0,0,0,0,0,0
LAKSHADWEEP,2012,19,Unemployed,0,0,0,0,0,0,0,0,0,0,0,0,0,0,0,0,0,0
LAKSHADWEEP,2012,19,Professional Activity,0,0,0,0,0,0,0,0,0,0,0,0,0,0,0,0,0,0
LAKSHADWEEP,2012,19,Agriculture (Total),0,0,0,0,0,0,0,0,0,0,0,0,0,0,0,0,0,0
LAKSHADWEEP,2012,19,Retired Persons,0,0,0,0,0,0,0,0,0,0,0,0,0,0,0,0,0,0
LAKSHADWEEP,2013,19,House Wife,0,0,0,0,0,0,0,0,1,0,0,1,0,0,1,0,0,1
LAKSHADWEEP,2013,19,Service (Government),0,0,0,0,0,0,0,0,0,0,0,0,0,0,0,0,0,0
LAKSHADWEEP,2013,19,Service (Private),0,0,0,0,0,0,0,0,0,0,0,0,0,0,0,0,0,0
LAKSHADWEEP,2013,19,Public Sector Undertaking,0,0,0,0,0,0,0,0,0,0,0,0,0,0,0,0,0,0
LAKSHADWEEP,2013,19,Students,0,0,0,0,0,0,0,0,0,0,0,0,0,0,0,0,0,0
LAKSHADWEEP,2013,19,Unemployed,0,0,0,0,0,0,0,1,0,0,0,1,0,1,0,0,0,1
LAKSHADWEEP,2013,19,Professional Activity,0,0,0,0,0,0,0,0,0,0,0,0,0,0,0,0,0,0
LAKSHADWEEP,2013,19,Agriculture (Total),0,0,0,0,0,0,0,0,0,0,0,0,0,0,0,0,0,0
LAKSHADWEEP,2013,19,Retired Persons,0,0,0,0,0,0,0,0,0,0,0,0,0,0,0,0,0,0
LAKSHADWEEP,2014,19,House Wife,0,0,0,0,0,0,0,0,1,0,0,1,0,0,1,0,0,1
LAKSHADWEEP,2014,19,Service (Government),0,0,0,0,0,0,0,0,0,0,0,0,0,0,0,0,0,0
LAKSHADWEEP,2014,19,Service (Private),0,0,0,0,0,0,0,0,0,0,0,0,0,0,0,0,0,0
LAKSHADWEEP,2014,19,Public Sector Undertaking,0,0,0,0,0,0,0,0,0,0,0,0,0,0,0,0,0,0
LAKSHADWEEP,2014,19,Students,0,1,0,0,0,1,0,0,0,0,0,0,0,1,0,0,0,1
LAKSHADWEEP,2014,19,Unemployed,0,0,0,0,0,0,0,0,0,0,0,0,0,0,0,0,0,0
LAKSHADWEEP,2014,19,Agriculture (Total),0,0,0,0,0,0,0,0,0,0,0,0,0,0,0,0,0,0
LAKSHADWEEP,2014,19,Retired Persons,0,0,0,0,0,0,0,0,0,0,0,0,0,0,0,0,0,0
MADHYA PRADESH,2001,20,House Wife,0,0,0,0,0,0,14,1346,553,201,87,2201,14,1346,553,201,87,2201
MADHYA PRADESH,2001,20,Service (Government),0,59,54,40,1,154,0,13,12,3,0,28,0,72,66,43,1,182
MADHYA PRADESH,2001,20,Service (Private),0,142,108,40,4,294,0,48,10,5,0,63,0,190,118,45,4,357
MADHYA PRADESH,2001,20,Public Sector Undertaking,0,43,10,9,0,62,0,36,6,2,0,44,0,79,16,11,0,106
MADHYA PRADESH,2001,20,Students,50,147,11,3,0,211,32,62,0,0,0,94,82,209,11,3,0,305
MADHYA PRADESH,2001,20,Unemployed,2,91,63,23,18,197,2,11,0,0,0,13,4,102,63,23,18,210
MADHYA PRADESH,2001,20,Professional Activity,0,30,64,20,12,126,0,4,8,7,3,22,0,34,72,27,15,148
MADHYA PRADESH,2001,20,Agriculture (Total),5,397,384,198,94,1078,5,142,95,31,21,294,10,539,479,229,115,1372
MADHYA PRADESH,2001,20,Retired Persons,0,0,0,0,13,13,0,0,0,0,1,1,0,0,0,0,14,14
MADHYA PRADESH,2002,20,House Wife,0,0,0,0,0,0,7,1362,577,225,116,2287,7,1362,577,225,116,2287
MADHYA PRADESH,2002,20,Service (Government),0,80,67,37,6,190,0,12,13,3,0,28,0,92,80,40,6,218
MADHYA PRADESH,2002,20,Service (Private),0,184,129,58,5,376,0,30,25,4,0,59,0,214,154,62,5,435
MADHYA PRADESH,2002,20,Public Sector Undertaking,0,62,30,3,0,95,0,11,7,5,0,23,0,73,37,8,0,118
MADHYA PRADESH,2002,20,Students,52,151,12,0,0,215,35,87,0,0,0,122,87,238,12,0,0,337
MADHYA PRADESH,2002,20,Unemployed,3,163,84,25,0,275,0,24,15,4,0,43,3,187,99,29,0,318
MADHYA PRADESH,2002,20,Professional Activity,0,28,48,21,11,108,0,0,9,11,4,24,0,28,57,32,15,132
MADHYA PRADESH,2002,20,Agriculture (Total),2,386,350,203,100,1041,4,163,86,35,11,299,6,549,436,238,111,1340
MADHYA PRADESH,2002,20,Retired Persons,0,0,0,1,27,28,0,0,0,0,0,0,0,0,0,1,27,28
MADHYA PRADESH,2003,20,House Wife,0,0,0,0,0,0,1,1185,576,188,79,2029,1,1185,576,188,79,2029
MADHYA PRADESH,2003,20,Service (Government),0,88,88,27,1,204,1,34,22,5,0,62,1,122,110,32,1,266
MADHYA PRADESH,2003,20,Service (Private),0,148,125,43,9,325,0,51,21,2,0,74,0,199,146,45,9,399
MADHYA PRADESH,2003,20,Public Sector Undertaking,0,60,57,15,3,135,1,15,2,5,0,23,1,75,59,20,3,158
MADHYA PRADESH,2003,20,Students,46,136,2,0,0,184,40,98,0,0,0,138,86,234,2,0,0,322
MADHYA PRADESH,2003,20,Unemployed,0,119,68,19,13,219,0,5,7,0,0,12,0,124,75,19,13,231
MADHYA PRADESH,2003,20,Professional Activity,0,52,68,46,23,189,0,5,8,4,5,22,0,57,76,50,28,211
MADHYA PRADESH,2003,20,Agriculture (Total),4,402,431,177,89,1103,6,183,115,29,9,342,10,585,546,206,98,1445
MADHYA PRADESH,2003,20,Retired Persons,0,0,0,0,23,23,0,0,0,0,0,0,0,0,0,0,23,23
MADHYA PRADESH,2004,20,House Wife,0,0,0,0,0,0,0,1244,584,198,86,2112,0,1244,584,198,86,2112
MADHYA PRADESH,2004,20,Service (Government),0,62,70,31,7,170,0,15,13,6,0,34,0,77,83,37,7,204
MADHYA PRADESH,2004,20,Service (Private),1,115,142,65,11,334,0,39,21,1,0,61,1,154,163,66,11,395
MADHYA PRADESH,2004,20,Public Sector Undertaking,0,33,42,15,9,99,0,29,21,1,0,51,0,62,63,16,9,150
MADHYA PRADESH,2004,20,Students,64,88,1,0,0,153,38,73,0,0,0,111,102,161,1,0,0,264
MADHYA PRADESH,2004,20,Unemployed,1,159,70,20,0,250,0,20,11,1,0,32,1,179,81,21,0,282
MADHYA PRADESH,2004,20,Professional Activity,0,42,46,57,16,161,0,6,8,7,6,27,0,48,54,64,22,188
MADHYA PRADESH,2004,20,Agriculture (Total),1,564,441,202,139,1347,9,143,83,38,18,291,10,707,524,240,157,1638
MADHYA PRADESH,2004,20,Retired Persons,0,0,0,0,14,14,0,0,0,0,0,0,0,0,0,0,14,14
MADHYA PRADESH,2005,20,House Wife,0,0,0,0,0,0,0,1114,523,178,77,1892,0,1114,523,178,77,1892
MADHYA PRADESH,2005,20,Service (Government),0,7,19,17,0,43,0,6,4,1,0,11,0,13,23,18,0,54
MADHYA PRADESH,2005,20,Service (Private),0,73,64,26,5,168,0,40,5,1,1,47,0,113,69,27,6,215
MADHYA PRADESH,2005,20,Public Sector Undertaking,0,44,33,10,5,92,0,16,14,1,0,31,0,60,47,11,5,123
MADHYA PRADESH,2005,20,Students,34,95,1,0,0,130,18,51,0,0,0,69,52,146,1,0,0,199
MADHYA PRADESH,2005,20,Unemployed,0,108,62,36,6,212,0,17,8,2,0,27,0,125,70,38,6,239
MADHYA PRADESH,2005,20,Professional Activity,2,30,77,19,3,131,0,17,4,6,3,30,2,47,81,25,6,161
MADHYA PRADESH,2005,20,Agriculture (Total),7,452,333,177,86,1055,4,108,64,12,5,193,11,560,397,189,91,1248
MADHYA PRADESH,2005,20,Retired Persons,0,0,0,0,8,8,0,0,0,0,0,0,0,0,0,0,8,8
MADHYA PRADESH,2006,20,House Wife,0,0,0,0,0,0,13,1026,595,184,83,1901,13,1026,595,184,83,1901
MADHYA PRADESH,2006,20,Service (Government),1,18,22,27,0,68,0,20,8,0,0,28,1,38,30,27,0,96
MADHYA PRADESH,2006,20,Service (Private),2,64,72,51,9,198,0,49,15,4,1,69,2,113,87,55,10,267
MADHYA PRADESH,2006,20,Public Sector Undertaking,2,37,45,17,4,105,2,14,4,4,0,24,4,51,49,21,4,129
MADHYA PRADESH,2006,20,Students,36,140,12,5,5,198,36,111,15,5,0,167,72,251,27,10,5,365
MADHYA PRADESH,2006,20,Unemployed,2,124,76,52,20,274,0,9,6,7,0,22,2,133,82,59,20,296
MADHYA PRADESH,2006,20,Professional Activity,0,62,58,25,8,153,0,3,5,2,2,12,0,65,63,27,10,165
MADHYA PRADESH,2006,20,Agriculture (Total),20,349,448,241,120,1178,5,110,62,18,2,197,25,459,510,259,122,1375
MADHYA PRADESH,2006,20,Retired Persons,0,0,0,1,8,9,0,0,0,0,0,0,0,0,0,1,8,9
MADHYA PRADESH,2007,20,House Wife,0,0,0,0,0,0,17,1128,511,165,86,1907,17,1128,511,165,86,1907
MADHYA PRADESH,2007,20,Service (Government),0,20,18,31,1,70,0,8,6,1,2,17,0,28,24,32,3,87
MADHYA PRADESH,2007,20,Service (Private),11,63,53,35,7,169,1,45,25,8,1,80,12,108,78,43,8,249
MADHYA PRADESH,2007,20,Public Sector Undertaking,0,65,47,26,1,139,1,44,11,9,0,65,1,109,58,35,1,204
MADHYA PRADESH,2007,20,Students,34,155,2,0,0,191,32,98,0,1,4,135,66,253,2,1,4,326
MADHYA PRADESH,2007,20,Unemployed,2,124,81,37,14,258,0,21,7,0,0,28,2,145,88,37,14,286
MADHYA PRADESH,2007,20,Professional Activity,0,75,62,33,12,182,0,11,1,0,0,12,0,86,63,33,12,194
MADHYA PRADESH,2007,20,Agriculture (Total),26,335,376,223,105,1065,8,104,67,15,4,198,34,439,443,238,109,1263
MADHYA PRADESH,2007,20,Retired Persons,0,2,9,5,4,20,2,0,0,0,0,2,2,2,9,5,4,22
MADHYA PRADESH,2008,20,House Wife,0,0,0,0,0,0,6,1204,593,215,55,2073,6,1204,593,215,55,2073
MADHYA PRADESH,2008,20,Service (Government),0,60,66,56,0,182,0,22,26,0,0,48,0,82,92,56,0,230
MADHYA PRADESH,2008,20,Service (Private),2,132,142,55,6,337,0,26,69,5,0,100,2,158,211,60,6,437
MADHYA PRADESH,2008,20,Public Sector Undertaking,0,69,73,73,13,228,0,3,6,0,0,9,0,72,79,73,13,237
MADHYA PRADESH,2008,20,Students,29,180,26,6,0,241,50,128,1,0,0,179,79,308,27,6,0,420
MADHYA PRADESH,2008,20,Unemployed,1,146,78,48,5,278,0,38,15,0,0,53,1,184,93,48,5,331
MADHYA PRADESH,2008,20,Professional Activity,2,62,86,48,4,202,0,19,10,4,0,33,2,81,96,52,4,235
MADHYA PRADESH,2008,20,Agriculture (Total),6,437,389,204,136,1172,2,106,68,21,10,207,8,543,457,225,146,1379
MADHYA PRADESH,2008,20,Retired Persons,0,3,2,0,13,18,0,0,0,0,0,0,0,3,2,0,13,18
MADHYA PRADESH,2009,20,House Wife,0,0,0,0,0,0,11,1334,652,220,69,2286,11,1334,652,220,69,2286
MADHYA PRADESH,2009,20,Service (Government),0,13,15,16,0,44,0,1,4,8,0,13,0,14,19,24,0,57
MADHYA PRADESH,2009,20,Service (Private),1,136,230,144,27,538,0,73,14,11,2,100,1,209,244,155,29,638
MADHYA PRADESH,2009,20,Public Sector Undertaking,0,10,12,8,1,31,0,4,0,0,0,4,0,14,12,8,1,35
MADHYA PRADESH,2009,20,Students,75,213,41,10,0,339,68,169,20,1,0,258,143,382,61,11,0,597
MADHYA PRADESH,2009,20,Unemployed,6,160,94,34,7,301,0,16,5,1,0,22,6,176,99,35,7,323
MADHYA PRADESH,2009,20,Professional Activity,20,96,111,97,32,356,0,11,4,3,0,18,20,107,115,100,32,374
MADHYA PRADESH,2009,20,Agriculture (Total),6,418,354,239,103,1120,6,127,102,25,15,275,12,545,456,264,118,1395
MADHYA PRADESH,2009,20,Retired Persons,0,0,3,2,10,15,0,0,0,0,0,0,0,0,3,2,10,15
MADHYA PRADESH,2010,20,House Wife,0,0,0,0,0,0,18,1366,815,255,110,2564,18,1366,815,255,110,2564
MADHYA PRADESH,2010,20,Service (Government),0,19,48,29,6,102,0,3,5,4,0,12,0,22,53,33,6,114
MADHYA PRADESH,2010,20,Service (Private),0,149,108,66,21,344,2,24,18,8,6,58,2,173,126,74,27,402
MADHYA PRADESH,2010,20,Public Sector Undertaking,0,39,64,15,13,131,0,6,3,2,4,15,0,45,67,17,17,146
MADHYA PRADESH,2010,20,Students,73,175,8,12,0,268,51,135,5,0,0,191,124,310,13,12,0,459
MADHYA PRADESH,2010,20,Unemployed,10,133,111,42,12,308,8,44,12,2,0,66,18,177,123,44,12,374
MADHYA PRADESH,2010,20,Professional Activity,0,93,97,73,29,292,3,10,12,3,0,28,3,103,109,76,29,320
MADHYA PRADESH,2010,20,Agriculture (Total),17,282,357,208,109,973,14,132,74,27,17,264,31,414,431,235,126,1237
MADHYA PRADESH,2010,20,Retired Persons,0,0,1,4,6,11,0,5,0,0,0,5,0,5,1,4,6,16
MADHYA PRADESH,2011,20,House Wife,0,0,0,0,0,0,14,1403,863,305,147,2732,14,1403,863,305,147,2732
MADHYA PRADESH,2011,20,Service (Government),0,20,44,31,0,95,0,10,5,2,0,17,0,30,49,33,0,112
MADHYA PRADESH,2011,20,Service (Private),0,166,198,115,17,496,0,45,21,8,1,75,0,211,219,123,18,571
MADHYA PRADESH,2011,20,Public Sector Undertaking,0,37,57,23,8,125,2,15,16,3,1,37,2,52,73,26,9,162
MADHYA PRADESH,2011,20,Students,53,202,10,0,0,265,39,139,8,0,0,186,92,341,18,0,0,451
MADHYA PRADESH,2011,20,Unemployed,6,107,80,15,5,213,6,32,9,3,0,50,12,139,89,18,5,263
MADHYA PRADESH,2011,20,Professional Activity,0,103,57,56,32,248,0,6,5,6,2,19,0,109,62,62,34,267
MADHYA PRADESH,2011,20,Agriculture (Total),10,366,446,184,126,1132,6,84,84,15,5,194,16,450,530,199,131,1326
MADHYA PRADESH,2011,20,Retired Persons,0,5,0,2,13,20,0,16,3,3,1,23,0,21,3,5,14,43
MADHYA PRADESH,2012,20,House Wife,0,0,0,0,0,0,4,1463,824,314,135,2740,4,1463,824,314,135,2740
MADHYA PRADESH,2012,20,Service (Government),0,21,42,18,2,83,1,5,11,0,0,17,1,26,53,18,2,100
MADHYA PRADESH,2012,20,Service (Private),2,236,251,103,19,611,0,38,35,14,0,87,2,274,286,117,19,698
MADHYA PRADESH,2012,20,Public Sector Undertaking,0,48,62,27,13,150,0,2,12,8,2,24,0,50,74,35,15,174
MADHYA PRADESH,2012,20,Students,85,235,11,0,0,331,74,187,2,1,0,264,159,422,13,1,0,595
MADHYA PRADESH,2012,20,Unemployed,6,177,118,42,8,351,4,23,31,29,4,91,10,200,149,71,12,442
MADHYA PRADESH,2012,20,Professional Activity,0,129,145,90,38,402,0,24,17,14,6,61,0,153,162,104,44,463
MADHYA PRADESH,2012,20,Agriculture (Total),0,270,413,253,102,1038,3,70,39,18,4,134,3,340,452,271,106,1172
MADHYA PRADESH,2012,20,Retired Persons,0,0,0,1,26,27,0,0,0,0,2,2,0,0,0,1,28,29
MADHYA PRADESH,2013,20,House Wife,0,0,0,0,0,0,9,1300,704,229,133,2375,9,1300,704,229,133,2375
MADHYA PRADESH,2013,20,Service (Government),0,31,37,24,1,93,0,5,6,3,1,15,0,36,43,27,2,108
MADHYA PRADESH,2013,20,Service (Private),0,223,250,111,18,602,0,37,35,9,2,83,0,260,285,120,20,685
MADHYA PRADESH,2013,20,Public Sector Undertaking,0,30,41,18,8,97,0,13,3,2,1,19,0,43,44,20,9,116
MADHYA PRADESH,2013,20,Students,77,251,28,0,1,357,66,239,2,3,0,310,143,490,30,3,1,667
MADHYA PRADESH,2013,20,Unemployed,5,140,95,59,23,322,0,18,8,7,2,35,5,158,103,66,25,357
MADHYA PRADESH,2013,20,Professional Activity,0,97,111,59,34,301,0,23,28,14,6,71,0,120,139,73,40,372
MADHYA PRADESH,2013,20,Agriculture (Total),5,312,349,232,99,997,0,42,35,12,4,93,5,354,384,244,103,1090
MADHYA PRADESH,2013,20,Retired Persons,0,0,1,0,21,22,0,20,2,0,0,22,0,20,3,0,21,44
MADHYA PRADESH,2014,20,House Wife,0,0,0,0,0,0,2,1250,647,194,81,2174,2,1250,647,194,81,2174
MADHYA PRADESH,2014,20,Service (Government),0,30,41,34,2,107,0,7,3,1,0,11,0,37,44,35,2,118
MADHYA PRADESH,2014,20,Service (Private),4,123,73,33,8,241,1,50,9,2,3,65,5,173,82,35,11,306
MADHYA PRADESH,2014,20,Public Sector Undertaking,0,54,11,10,5,80,0,2,3,0,0,5,0,56,14,10,5,85
MADHYA PRADESH,2014,20,Students,29,270,1,0,0,300,29,314,2,0,0,345,58,584,3,0,0,645
MADHYA PRADESH,2014,20,Unemployed,0,139,103,34,7,283,2,30,13,3,2,50,2,169,116,37,9,333
MADHYA PRADESH,2014,20,Agriculture (Total),0,300,392,211,89,992,2,124,49,16,15,206,2,424,441,227,104,1198
MADHYA PRADESH,2014,20,Retired Persons,0,4,3,0,6,13,0,2,3,0,0,5,0,6,6,0,6,18
MAHARASHTRA,2001,21,House Wife,0,0,0,0,0,0,9,1663,1078,394,207,3351,9,1663,1078,394,207,3351
MAHARASHTRA,2001,21,Service (Government),0,51,111,57,3,222,0,19,15,3,0,37,0,70,126,60,3,259
MAHARASHTRA,2001,21,Service (Private),0,346,561,337,40,1284,0,74,48,21,2,145,0,420,609,358,42,1429
MAHARASHTRA,2001,21,Public Sector Undertaking,0,33,40,38,2,113,0,7,3,1,0,11,0,40,43,39,2,124
MAHARASHTRA,2001,21,Students,81,337,15,0,0,433,78,273,5,0,0,356,159,610,20,0,0,789
MAHARASHTRA,2001,21,Unemployed,0,386,357,162,51,956,0,60,19,17,5,101,0,446,376,179,56,1057
MAHARASHTRA,2001,21,Professional Activity,0,62,106,54,22,244,0,6,5,9,4,24,0,68,111,63,26,268
MAHARASHTRA,2001,21,Agriculture (Total),11,789,1263,643,239,2945,13,278,205,72,23,591,24,1067,1468,715,262,3536
MAHARASHTRA,2001,21,Retired Persons,0,0,6,39,125,170,0,0,0,5,7,12,0,0,6,44,132,182
MAHARASHTRA,2002,21,House Wife,0,0,0,0,0,0,0,1762,1091,362,200,3415,0,1762,1091,362,200,3415
MAHARASHTRA,2002,21,Service (Government),0,43,123,54,0,220,0,14,11,3,0,28,0,57,134,57,0,248
MAHARASHTRA,2002,21,Service (Private),0,319,554,256,37,1166,0,50,54,20,7,131,0,369,608,276,44,1297
MAHARASHTRA,2002,21,Public Sector Undertaking,0,32,41,30,0,103,0,3,3,1,0,7,0,35,44,31,0,110
MAHARASHTRA,2002,21,Students,77,367,4,0,0,448,86,286,6,0,0,378,163,653,10,0,0,826
MAHARASHTRA,2002,21,Unemployed,0,390,355,149,2,896,7,66,27,2,0,102,7,456,382,151,2,998
MAHARASHTRA,2002,21,Professional Activity,0,148,170,61,28,407,0,5,14,6,3,28,0,153,184,67,31,435
MAHARASHTRA,2002,21,Agriculture (Total),3,868,1229,669,386,3155,0,269,134,86,51,540,3,1137,1363,755,437,3695
MAHARASHTRA,2002,21,Retired Persons,0,0,5,35,113,153,0,0,1,3,12,16,0,0,6,38,125,169
MAHARASHTRA,2003,21,House Wife,0,0,0,0,0,0,0,1701,1206,410,205,3522,0,1701,1206,410,205,3522
MAHARASHTRA,2003,21,Service (Government),0,43,126,77,0,246,0,14,13,3,0,30,0,57,139,80,0,276
MAHARASHTRA,2003,21,Service (Private),0,419,683,297,33,1432,0,86,72,13,0,171,0,505,755,310,33,1603
MAHARASHTRA,2003,21,Public Sector Undertaking,0,24,58,36,0,118,0,9,5,3,0,17,0,33,63,39,0,135
MAHARASHTRA,2003,21,Students,81,408,10,0,0,499,81,290,4,0,0,375,162,698,14,0,0,874
MAHARASHTRA,2003,21,Unemployed,1,414,350,105,17,887,1,42,25,13,0,81,2,456,375,118,17,968
MAHARASHTRA,2003,21,Professional Activity,0,74,116,62,18,270,0,10,4,1,1,16,0,84,120,63,19,286
MAHARASHTRA,2003,21,Agriculture (Total),8,899,1310,812,352,3381,4,202,148,73,28,455,12,1101,1458,885,380,3836
MAHARASHTRA,2003,21,Retired Persons,0,0,1,33,110,144,0,0,0,0,6,6,0,0,1,33,116,150
MAHARASHTRA,2004,21,House Wife,0,0,0,0,0,0,0,1768,1096,422,215,3501,0,1768,1096,422,215,3501
MAHARASHTRA,2004,21,Service (Government),0,38,97,66,0,201,0,23,13,7,0,43,0,61,110,73,0,244
MAHARASHTRA,2004,21,Service (Private),0,403,599,300,43,1345,0,61,30,9,1,101,0,464,629,309,44,1446
MAHARASHTRA,2004,21,Public Sector Undertaking,0,46,62,40,6,154,0,4,2,3,0,9,0,50,64,43,6,163
MAHARASHTRA,2004,21,Students,77,427,12,0,0,516,81,357,5,0,0,443,158,784,17,0,0,959
MAHARASHTRA,2004,21,Unemployed,0,514,396,99,9,1018,2,46,11,1,0,60,2,560,407,100,9,1078
MAHARASHTRA,2004,21,Professional Activity,0,79,123,82,26,310,0,5,4,0,0,9,0,84,127,82,26,319
MAHARASHTRA,2004,21,Agriculture (Total),3,909,1504,940,443,3799,3,155,107,59,24,348,6,1064,1611,999,467,4147
MAHARASHTRA,2004,21,Retired Persons,0,0,0,16,105,121,0,0,0,0,2,2,0,0,0,16,107,123
MAHARASHTRA,2005,21,House Wife,0,0,0,0,0,0,3,1857,1084,409,229,3582,3,1857,1084,409,229,3582
MAHARASHTRA,2005,21,Service (Government),0,36,122,102,0,260,0,18,18,4,0,40,0,54,140,106,0,300
MAHARASHTRA,2005,21,Service (Private),0,456,650,340,39,1485,1,78,34,6,2,121,1,534,684,346,41,1606
MAHARASHTRA,2005,21,Public Sector Undertaking,0,30,39,33,3,105,0,9,3,1,0,13,0,39,42,34,3,118
MAHARASHTRA,2005,21,Students,53,346,3,0,0,402,55,327,0,0,0,382,108,673,3,0,0,784
MAHARASHTRA,2005,21,Unemployed,0,459,368,121,2,950,0,63,13,3,0,79,0,522,381,124,2,1029
MAHARASHTRA,2005,21,Professional Activity,0,97,151,102,27,377,0,7,2,4,3,16,0,104,153,106,30,393
MAHARASHTRA,2005,21,Agriculture (Total),4,826,1433,908,467,3638,2,127,76,58,25,288,6,953,1509,966,492,3926
MAHARASHTRA,2005,21,Retired Persons,0,0,0,15,99,114,0,0,0,1,6,7,0,0,0,16,105,121
MAHARASHTRA,2006,21,House Wife,0,0,0,0,0,0,1,1911,1067,409,265,3653,1,1911,1067,409,265,3653
MAHARASHTRA,2006,21,Service (Government),0,95,202,135,0,432,0,19,25,6,0,50,0,114,227,141,0,482
MAHARASHTRA,2006,21,Service (Private),0,400,536,271,34,1241,0,64,27,11,2,104,0,464,563,282,36,1345
MAHARASHTRA,2006,21,Public Sector Undertaking,0,37,78,40,5,160,0,5,6,1,0,12,0,42,84,41,5,172
MAHARASHTRA,2006,21,Students,54,389,1,0,0,444,70,368,0,0,0,438,124,757,1,0,0,882
MAHARASHTRA,2006,21,Unemployed,4,388,341,108,31,872,2,52,12,6,0,72,6,440,353,114,31,944
MAHARASHTRA,2006,21,Professional Activity,0,156,287,159,51,653,0,25,23,7,1,56,0,181,310,166,52,709
MAHARASHTRA,2006,21,Agriculture (Total),7,942,1589,1032,541,4111,3,142,113,57,27,342,10,1084,1702,1089,568,4453
MAHARASHTRA,2006,21,Retired Persons,0,0,1,25,106,132,0,0,0,0,8,8,0,0,1,25,114,140
MAHARASHTRA,2007,21,House Wife,0,0,0,0,0,0,4,1880,1031,410,238,3563,4,1880,1031,410,238,3563
MAHARASHTRA,2007,21,Service (Government),0,41,90,78,2,211,0,11,3,1,0,15,0,52,93,79,2,226
MAHARASHTRA,2007,21,Service (Private),0,444,616,356,36,1452,0,80,47,11,0,138,0,524,663,367,36,1590
MAHARASHTRA,2007,21,Public Sector Undertaking,0,31,44,37,3,115,0,11,4,5,0,20,0,42,48,42,3,135
MAHARASHTRA,2007,21,Students,41,355,8,0,0,404,69,319,1,0,0,389,110,674,9,0,0,793
MAHARASHTRA,2007,21,Unemployed,0,429,355,162,32,978,0,51,7,2,1,61,0,480,362,164,33,1039
MAHARASHTRA,2007,21,Professional Activity,0,168,291,165,57,681,0,27,18,12,9,66,0,195,309,177,66,747
MAHARASHTRA,2007,21,Agriculture (Total),0,908,1498,1038,524,3968,0,131,73,37,29,270,0,1039,1571,1075,553,4238
MAHARASHTRA,2007,21,Retired Persons,0,0,1,27,118,146,0,0,7,3,7,17,0,0,8,30,125,163
MAHARASHTRA,2008,21,House Wife,0,0,0,0,0,0,7,1744,1017,369,247,3384,7,1744,1017,369,247,3384
MAHARASHTRA,2008,21,Service (Government),0,28,61,58,0,147,0,6,4,0,0,10,0,34,65,58,0,157
MAHARASHTRA,2008,21,Service (Private),0,476,693,360,31,1560,0,65,23,5,0,93,0,541,716,365,31,1653
MAHARASHTRA,2008,21,Public Sector Undertaking,0,59,66,44,9,178,1,13,4,0,0,18,1,72,70,44,9,196
MAHARASHTRA,2008,21,Students,44,355,8,0,0,407,57,290,3,0,0,350,101,645,11,0,0,757
MAHARASHTRA,2008,21,Unemployed,2,353,284,134,23,796,0,56,19,1,1,77,2,409,303,135,24,873
MAHARASHTRA,2008,21,Professional Activity,0,136,183,111,51,481,0,27,24,6,2,59,0,163,207,117,53,540
MAHARASHTRA,2008,21,Agriculture (Total),0,856,1392,935,390,3573,2,89,92,31,15,229,2,945,1484,966,405,3802
MAHARASHTRA,2008,21,Retired Persons,0,0,0,20,100,120,0,0,1,2,10,13,0,0,1,22,110,133
MAHARASHTRA,2009,21,House Wife,0,0,0,0,0,0,0,1656,1097,399,231,3383,0,1656,1097,399,231,3383
MAHARASHTRA,2009,21,Service (Government),0,20,61,57,1,139,0,8,3,4,0,15,0,28,64,61,1,154
MAHARASHTRA,2009,21,Service (Private),0,496,724,345,45,1610,0,78,33,8,1,120,0,574,757,353,46,1730
MAHARASHTRA,2009,21,Public Sector Undertaking,0,37,74,38,2,151,0,7,3,2,0,12,0,44,77,40,2,163
MAHARASHTRA,2009,21,Students,42,358,3,0,0,403,48,353,8,0,0,409,90,711,11,0,0,812
MAHARASHTRA,2009,21,Unemployed,0,356,313,119,33,821,0,33,10,9,0,52,0,389,323,128,33,873
MAHARASHTRA,2009,21,Professional Activity,0,162,219,157,53,591,0,13,14,9,3,39,0,175,233,166,56,630
MAHARASHTRA,2009,21,Agriculture (Total),0,557,1062,728,345,2692,2,89,36,40,13,180,2,646,1098,768,358,2872
MAHARASHTRA,2009,21,Retired Persons,0,0,2,14,117,133,0,0,0,1,2,3,0,0,2,15,119,136
MAHARASHTRA,2010,21,House Wife,0,0,0,0,0,0,0,1882,1098,405,254,3639,0,1882,1098,405,254,3639
MAHARASHTRA,2010,21,Service (Government),0,35,78,59,1,173,0,8,1,1,0,10,0,43,79,60,1,183
MAHARASHTRA,2010,21,Service (Private),0,559,739,376,40,1714,1,93,34,15,0,143,1,652,773,391,40,1857
MAHARASHTRA,2010,21,Public Sector Undertaking,0,40,69,28,6,143,0,3,1,0,0,4,0,43,70,28,6,147
MAHARASHTRA,2010,21,Students,46,427,8,1,0,482,82,492,0,0,0,574,128,919,8,1,0,1056
MAHARASHTRA,2010,21,Unemployed,0,365,305,108,41,819,2,60,20,6,1,89,2,425,325,114,42,908
MAHARASHTRA,2010,21,Professional Activity,0,265,376,270,129,1040,0,42,22,15,4,83,0,307,398,285,133,1123
MAHARASHTRA,2010,21,Agriculture (Total),0,784,1094,743,326,2947,2,79,68,33,12,194,2,863,1162,776,338,3141
MAHARASHTRA,2010,21,Retired Persons,0,0,1,13,99,113,0,0,1,0,3,4,0,0,2,13,102,117
MAHARASHTRA,2011,21,House Wife,0,0,0,0,0,0,10,1863,1152,429,262,3716,10,1863,1152,429,262,3716
MAHARASHTRA,2011,21,Service (Government),0,35,74,59,2,170,0,13,10,2,0,25,0,48,84,61,2,195
MAHARASHTRA,2011,21,Service (Private),1,633,738,363,62,1797,0,82,46,8,1,137,1,715,784,371,63,1934
MAHARASHTRA,2011,21,Public Sector Undertaking,0,19,33,21,3,76,0,5,4,1,0,10,0,24,37,22,3,86
MAHARASHTRA,2011,21,Students,33,441,7,0,0,481,60,437,10,0,0,507,93,878,17,0,0,988
MAHARASHTRA,2011,21,Unemployed,0,299,203,71,18,591,3,50,7,6,1,67,3,349,210,77,19,658
MAHARASHTRA,2011,21,Professional Activity,0,209,288,185,68,750,0,20,7,8,1,36,0,229,295,193,69,786
MAHARASHTRA,2011,21,Agriculture (Total),2,727,1186,808,370,3093,1,123,92,19,9,244,3,850,1278,827,379,3337
MAHARASHTRA,2011,21,Retired Persons,0,4,6,16,118,144,0,0,0,1,2,3,0,4,6,17,120,147
MAHARASHTRA,2012,21,House Wife,0,0,0,0,0,0,3,1637,1010,438,262,3350,3,1637,1010,438,262,3350
MAHARASHTRA,2012,21,Service (Government),0,32,70,58,1,161,0,19,8,1,0,28,0,51,78,59,1,189
MAHARASHTRA,2012,21,Service (Private),0,721,826,477,77,2101,0,108,41,12,2,163,0,829,867,489,79,2264
MAHARASHTRA,2012,21,Public Sector Undertaking,0,60,77,66,6,209,0,8,4,1,0,13,0,68,81,67,6,222
MAHARASHTRA,2012,21,Students,64,376,9,0,0,449,68,401,3,0,0,472,132,777,12,0,0,921
MAHARASHTRA,2012,21,Unemployed,0,370,296,143,23,832,0,91,27,14,0,132,0,461,323,157,23,964
MAHARASHTRA,2012,21,Professional Activity,0,116,156,98,33,403,0,13,6,5,2,26,0,129,162,103,35,429
MAHARASHTRA,2012,21,Agriculture (Total),0,804,1267,980,432,3483,0,100,131,55,17,303,0,904,1398,1035,449,3786
MAHARASHTRA,2012,21,Retired Persons,0,0,0,22,121,143,0,0,0,0,3,3,0,0,0,22,124,146
MAHARASHTRA,2013,21,House Wife,0,0,0,0,0,0,0,1539,1110,415,284,3348,0,1539,1110,415,284,3348
MAHARASHTRA,2013,21,Service (Government),0,37,87,76,2,202,0,17,11,1,0,29,0,54,98,77,2,231
MAHARASHTRA,2013,21,Service (Private),0,720,850,481,99,2150,0,81,34,19,0,134,0,801,884,500,99,2284
MAHARASHTRA,2013,21,Public Sector Undertaking,0,34,61,45,11,151,0,4,2,2,0,8,0,38,63,47,11,159
MAHARASHTRA,2013,21,Students,75,474,16,1,0,566,92,479,2,2,0,575,167,953,18,3,0,1141
MAHARASHTRA,2013,21,Unemployed,1,397,369,144,36,947,0,60,6,2,1,69,1,457,375,146,37,1016
MAHARASHTRA,2013,21,Professional Activity,0,117,156,101,35,409,0,4,9,5,3,21,0,121,165,106,38,430
MAHARASHTRA,2013,21,Agriculture (Total),1,629,1157,841,392,3020,0,38,41,34,13,126,1,667,1198,875,405,3146
MAHARASHTRA,2013,21,Retired Persons,0,0,0,13,127,140,0,0,0,0,2,2,0,0,0,13,129,142
MAHARASHTRA,2014,21,House Wife,0,0,0,0,0,0,5,1454,896,359,207,2921,5,1454,896,359,207,2921
MAHARASHTRA,2014,21,Service (Government),0,100,155,73,5,333,0,24,32,6,5,67,0,124,187,79,10,400
MAHARASHTRA,2014,21,Service (Private),0,429,464,204,12,1109,0,45,22,6,1,74,0,474,486,210,13,1183
MAHARASHTRA,2014,21,Public Sector Undertaking,0,99,99,58,6,262,0,16,2,3,0,21,0,115,101,61,6,283
MAHARASHTRA,2014,21,Students,36,523,10,0,0,569,57,561,2,1,1,622,93,1084,12,1,1,1191
MAHARASHTRA,2014,21,Unemployed,3,429,342,145,61,980,1,55,10,4,7,77,4,484,352,149,68,1057
MAHARASHTRA,2014,21,Agriculture (Total),0,863,1511,954,398,3726,0,82,124,38,34,278,0,945,1635,992,432,4004
MAHARASHTRA,2014,21,Retired Persons,0,0,1,39,143,183,0,0,0,4,4,8,0,0,1,43,147,191
MANIPUR,2001,22,House Wife,0,0,0,0,0,0,0,3,5,1,0,9,0,3,5,1,0,9
MANIPUR,2001,22,Service (Government),0,0,0,0,0,0,0,0,0,0,0,0,0,0,0,0,0,0
MANIPUR,2001,22,Service (Private),0,0,0,0,0,0,0,0,0,0,0,0,0,0,0,0,0,0
MANIPUR,2001,22,Public Sector Undertaking,0,3,0,0,0,3,0,0,0,0,0,0,0,3,0,0,0,3
MANIPUR,2001,22,Students,1,5,0,0,0,6,0,1,0,0,0,1,1,6,0,0,0,7
MANIPUR,2001,22,Unemployed,0,0,0,2,0,2,0,0,0,0,0,0,0,0,0,2,0,2
MANIPUR,2001,22,Professional Activity,0,0,0,0,0,0,0,0,0,0,0,0,0,0,0,0,0,0
MANIPUR,2001,22,Agriculture (Total),0,0,0,0,0,0,0,0,0,0,0,0,0,0,0,0,0,0
MANIPUR,2001,22,Retired Persons,0,0,0,0,0,0,0,0,0,0,0,0,0,0,0,0,0,0
MANIPUR,2002,22,House Wife,0,0,0,0,0,0,0,3,0,0,0,3,0,3,0,0,0,3
MANIPUR,2002,22,Service (Government),0,0,3,1,0,4,0,0,0,0,0,0,0,0,3,1,0,4
MANIPUR,2002,22,Service (Private),0,0,0,0,0,0,0,0,0,0,0,0,0,0,0,0,0,0
MANIPUR,2002,22,Public Sector Undertaking,0,0,2,1,1,4,0,0,0,0,0,0,0,0,2,1,1,4
MANIPUR,2002,22,Students,0,7,0,0,0,7,0,3,0,0,0,3,0,10,0,0,0,10
MANIPUR,2002,22,Unemployed,0,2,2,6,1,11,0,1,1,0,0,2,0,3,3,6,1,13
MANIPUR,2002,22,Professional Activity,0,0,0,0,0,0,0,0,0,0,0,0,0,0,0,0,0,0
MANIPUR,2002,22,Agriculture (Total),0,0,1,0,2,3,0,0,0,0,0,0,0,0,1,0,2,3
MANIPUR,2002,22,Retired Persons,0,0,0,0,0,0,0,0,0,0,0,0,0,0,0,0,0,0
MANIPUR,2003,22,House Wife,0,0,0,0,0,0,0,1,0,0,1,2,0,1,0,0,1,2
MANIPUR,2003,22,Service (Government),0,0,2,2,0,4,0,0,0,0,0,0,0,0,2,2,0,4
MANIPUR,2003,22,Service (Private),0,0,0,0,0,0,0,0,0,0,0,0,0,0,0,0,0,0
MANIPUR,2003,22,Public Sector Undertaking,0,0,0,0,0,0,0,0,0,0,0,0,0,0,0,0,0,0
MANIPUR,2003,22,Students,0,9,0,0,0,9,0,3,0,0,0,3,0,12,0,0,0,12
MANIPUR,2003,22,Unemployed,0,0,0,0,0,0,0,0,0,0,0,0,0,0,0,0,0,0
MANIPUR,2003,22,Professional Activity,0,0,0,0,0,0,0,0,0,0,0,0,0,0,0,0,0,0
MANIPUR,2003,22,Agriculture (Total),0,0,0,1,3,4,0,0,0,0,0,0,0,0,0,1,3,4
MANIPUR,2003,22,Retired Persons,0,0,0,0,0,0,0,0,0,0,0,0,0,0,0,0,0,0
MANIPUR,2004,22,House Wife,0,0,0,0,0,0,0,0,1,0,0,1,0,0,1,0,0,1
MANIPUR,2004,22,Service (Government),0,4,7,1,0,12,0,0,0,0,0,0,0,4,7,1,0,12
MANIPUR,2004,22,Service (Private),0,0,1,0,0,1,0,0,0,0,0,0,0,0,1,0,0,1
MANIPUR,2004,22,Public Sector Undertaking,0,0,0,0,0,0,0,0,0,0,0,0,0,0,0,0,0,0
MANIPUR,2004,22,Students,0,4,0,0,0,4,1,5,0,0,0,6,1,9,0,0,0,10
MANIPUR,2004,22,Unemployed,0,5,1,1,0,7,0,0,2,0,0,2,0,5,3,1,0,9
MANIPUR,2004,22,Professional Activity,0,0,0,0,0,0,0,0,0,0,0,0,0,0,0,0,0,0
MANIPUR,2004,22,Agriculture (Total),0,0,1,1,0,2,0,0,0,0,0,0,0,0,1,1,0,2
MANIPUR,2004,22,Retired Persons,0,0,0,0,0,0,0,0,0,0,0,0,0,0,0,0,0,0
MANIPUR,2005,22,House Wife,0,0,0,0,0,0,0,0,2,0,0,2,0,0,2,0,0,2
MANIPUR,2005,22,Service (Government),0,1,7,0,0,8,0,0,0,0,0,0,0,1,7,0,0,8
MANIPUR,2005,22,Service (Private),0,0,0,0,0,0,0,0,0,0,0,0,0,0,0,0,0,0
MANIPUR,2005,22,Public Sector Undertaking,0,0,0,0,0,0,0,0,0,0,0,0,0,0,0,0,0,0
MANIPUR,2005,22,Students,0,1,0,0,0,1,0,1,0,0,0,1,0,2,0,0,0,2
MANIPUR,2005,22,Unemployed,0,0,0,0,0,0,0,0,0,0,0,0,0,0,0,0,0,0
MANIPUR,2005,22,Professional Activity,0,0,0,0,0,0,0,0,0,0,0,0,0,0,0,0,0,0
MANIPUR,2005,22,Agriculture (Total),0,0,2,0,0,2,0,0,0,0,0,0,0,0,2,0,0,2
MANIPUR,2005,22,Retired Persons,0,0,0,0,0,0,0,0,0,0,0,0,0,0,0,0,0,0
MANIPUR,2006,22,House Wife,0,0,0,0,0,0,0,2,1,0,0,3,0,2,1,0,0,3
MANIPUR,2006,22,Service (Government),0,3,8,2,0,13,0,0,0,0,0,0,0,3,8,2,0,13
MANIPUR,2006,22,Service (Private),0,0,0,0,0,0,0,0,0,0,0,0,0,0,0,0,0,0
MANIPUR,2006,22,Public Sector Undertaking,0,0,0,0,0,0,0,0,0,0,0,0,0,0,0,0,0,0
MANIPUR,2006,22,Students,0,4,0,0,0,4,0,9,0,0,0,9,0,13,0,0,0,13
MANIPUR,2006,22,Unemployed,0,0,2,2,1,5,0,0,0,0,0,0,0,0,2,2,1,5
MANIPUR,2006,22,Professional Activity,0,0,0,0,0,0,0,0,0,0,0,0,0,0,0,0,0,0
MANIPUR,2006,22,Agriculture (Total),0,0,0,0,0,0,0,0,0,0,0,0,0,0,0,0,0,0
MANIPUR,2006,22,Retired Persons,0,0,0,0,0,0,0,0,0,0,0,0,0,0,0,0,0,0
MANIPUR,2007,22,House Wife,0,0,0,0,0,0,0,3,5,1,0,9,0,3,5,1,0,9
MANIPUR,2007,22,Service (Government),0,0,8,2,0,10,0,0,0,0,0,0,0,0,8,2,0,10
MANIPUR,2007,22,Service (Private),0,0,0,0,0,0,0,0,0,0,0,0,0,0,0,0,0,0
MANIPUR,2007,22,Public Sector Undertaking,0,0,0,0,0,0,0,0,0,0,0,0,0,0,0,0,0,0
MANIPUR,2007,22,Students,1,4,0,0,0,5,0,1,0,0,0,1,1,5,0,0,0,6
MANIPUR,2007,22,Unemployed,0,2,6,1,0,9,0,0,1,0,0,1,0,2,7,1,0,10
MANIPUR,2007,22,Professional Activity,0,0,0,0,0,0,0,0,0,0,0,0,0,0,0,0,0,0
MANIPUR,2007,22,Agriculture (Total),0,0,0,0,0,0,0,0,0,0,0,0,0,0,0,0,0,0
MANIPUR,2007,22,Retired Persons,0,0,0,0,0,0,0,0,0,0,0,0,0,0,0,0,0,0
MANIPUR,2008,22,House Wife,0,0,0,0,0,0,0,3,1,1,0,5,0,3,1,1,0,5
MANIPUR,2008,22,Service (Government),0,3,4,0,0,7,0,0,0,0,0,0,0,3,4,0,0,7
MANIPUR,2008,22,Service (Private),0,0,0,0,0,0,0,0,0,0,0,0,0,0,0,0,0,0
MANIPUR,2008,22,Public Sector Undertaking,0,0,0,0,0,0,0,0,0,0,0,0,0,0,0,0,0,0
MANIPUR,2008,22,Students,0,2,0,0,0,2,1,1,0,0,0,2,1,3,0,0,0,4
MANIPUR,2008,22,Unemployed,0,5,2,0,0,7,0,2,1,0,0,3,0,7,3,0,0,10
MANIPUR,2008,22,Professional Activity,0,0,0,0,0,0,0,0,0,0,0,0,0,0,0,0,0,0
MANIPUR,2008,22,Agriculture (Total),0,0,2,0,0,2,0,0,0,0,0,0,0,0,2,0,0,2
MANIPUR,2008,22,Retired Persons,0,0,0,0,0,0,0,0,0,0,0,0,0,0,0,0,0,0
MANIPUR,2009,22,House Wife,0,0,0,0,0,0,0,3,2,0,0,5,0,3,2,0,0,5
MANIPUR,2009,22,Service (Government),0,3,2,1,0,6,0,0,0,0,0,0,0,3,2,1,0,6
MANIPUR,2009,22,Service (Private),0,0,0,0,0,0,0,0,0,0,0,0,0,0,0,0,0,0
MANIPUR,2009,22,Public Sector Undertaking,0,0,0,0,0,0,0,0,0,0,0,0,0,0,0,0,0,0
MANIPUR,2009,22,Students,0,0,0,0,0,0,0,0,0,0,0,0,0,0,0,0,0,0
MANIPUR,2009,22,Unemployed,0,3,4,0,0,7,0,0,1,0,0,1,0,3,5,0,0,8
MANIPUR,2009,22,Professional Activity,0,0,0,0,0,0,0,0,0,0,0,0,0,0,0,0,0,0
MANIPUR,2009,22,Agriculture (Total),0,0,0,0,0,0,0,1,0,0,0,1,0,1,0,0,0,1
MANIPUR,2009,22,Retired Persons,0,0,0,0,0,0,0,0,0,0,0,0,0,0,0,0,0,0
MANIPUR,2010,22,House Wife,0,0,0,0,0,0,0,6,1,1,0,8,0,6,1,1,0,8
MANIPUR,2010,22,Service (Government),0,1,3,2,0,6,0,0,0,0,0,0,0,1,3,2,0,6
MANIPUR,2010,22,Service (Private),0,0,0,0,0,0,0,0,0,0,0,0,0,0,0,0,0,0
MANIPUR,2010,22,Public Sector Undertaking,0,0,0,0,0,0,0,0,0,0,0,0,0,0,0,0,0,0
MANIPUR,2010,22,Students,0,1,0,0,0,1,0,0,0,0,0,0,0,1,0,0,0,1
MANIPUR,2010,22,Unemployed,0,4,7,1,0,12,0,0,0,0,0,0,0,4,7,1,0,12
MANIPUR,2010,22,Professional Activity,0,0,0,0,0,0,0,0,0,0,0,0,0,0,0,0,0,0
MANIPUR,2010,22,Agriculture (Total),0,0,0,0,0,0,0,1,3,0,0,4,0,1,3,0,0,4
MANIPUR,2010,22,Retired Persons,0,0,0,0,0,0,0,0,0,0,0,0,0,0,0,0,0,0
MANIPUR,2011,22,House Wife,0,0,0,0,0,0,0,6,2,1,0,9,0,6,2,1,0,9
MANIPUR,2011,22,Service (Government),0,0,4,1,0,5,0,0,0,0,0,0,0,0,4,1,0,5
MANIPUR,2011,22,Service (Private),0,0,1,0,0,1,0,0,0,0,0,0,0,0,1,0,0,1
MANIPUR,2011,22,Public Sector Undertaking,0,0,0,0,0,0,0,0,0,0,0,0,0,0,0,0,0,0
MANIPUR,2011,22,Students,0,4,0,0,0,4,0,0,0,0,0,0,0,4,0,0,0,4
MANIPUR,2011,22,Unemployed,0,1,4,1,0,6,0,0,0,0,0,0,0,1,4,1,0,6
MANIPUR,2011,22,Professional Activity,0,0,0,0,0,0,0,0,0,0,0,0,0,0,0,0,0,0
MANIPUR,2011,22,Agriculture (Total),0,0,0,0,0,0,0,0,0,0,0,0,0,0,0,0,0,0
MANIPUR,2011,22,Retired Persons,0,0,0,0,0,0,0,0,0,0,0,0,0,0,0,0,0,0
MANIPUR,2012,22,House Wife,0,0,0,0,0,0,0,3,4,1,1,9,0,3,4,1,1,9
MANIPUR,2012,22,Service (Government),0,1,4,0,0,5,0,0,0,0,0,0,0,1,4,0,0,5
MANIPUR,2012,22,Service (Private),0,0,0,0,0,0,0,0,0,0,0,0,0,0,0,0,0,0
MANIPUR,2012,22,Public Sector Undertaking,0,0,0,0,0,0,0,0,0,0,0,0,0,0,0,0,0,0
MANIPUR,2012,22,Students,0,8,0,0,0,8,1,5,0,0,0,6,1,13,0,0,0,14
MANIPUR,2012,22,Unemployed,0,0,0,0,0,0,0,0,0,0,0,0,0,0,0,0,0,0
MANIPUR,2012,22,Professional Activity,0,0,0,0,0,0,0,0,0,0,0,0,0,0,0,0,0,0
MANIPUR,2012,22,Agriculture (Total),0,0,0,0,0,0,0,0,0,0,0,0,0,0,0,0,0,0
MANIPUR,2012,22,Retired Persons,0,0,0,0,0,0,0,0,0,0,0,0,0,0,0,0,0,0
MANIPUR,2013,22,House Wife,0,0,0,0,0,0,0,7,1,1,0,9,0,7,1,1,0,9
MANIPUR,2013,22,Service (Government),0,1,4,0,0,5,0,1,0,0,0,1,0,2,4,0,0,6
MANIPUR,2013,22,Service (Private),0,0,0,0,0,0,0,0,0,0,0,0,0,0,0,0,0,0
MANIPUR,2013,22,Public Sector Undertaking,0,0,0,0,0,0,0,0,0,0,0,0,0,0,0,0,0,0
MANIPUR,2013,22,Students,1,0,0,0,0,1,1,2,0,0,0,3,2,2,0,0,0,4
MANIPUR,2013,22,Unemployed,0,0,2,1,1,4,0,0,0,0,0,0,0,0,2,1,1,4
MANIPUR,2013,22,Professional Activity,0,0,0,0,0,0,0,0,0,0,0,0,0,0,0,0,0,0
MANIPUR,2013,22,Agriculture (Total),0,0,1,0,0,1,0,0,0,0,0,0,0,0,1,0,0,1
MANIPUR,2013,22,Retired Persons,0,0,0,0,0,0,0,0,0,0,0,0,0,0,0,0,0,0
MANIPUR,2014,22,House Wife,0,0,0,0,0,0,0,8,4,0,0,12,0,8,4,0,0,12
MANIPUR,2014,22,Service (Government),0,2,3,3,0,8,0,0,0,0,0,0,0,2,3,3,0,8
MANIPUR,2014,22,Service (Private),0,0,0,0,0,0,0,0,0,0,0,0,0,0,0,0,0,0
MANIPUR,2014,22,Public Sector Undertaking,0,0,0,0,0,0,0,0,0,0,0,0,0,0,0,0,0,0
MANIPUR,2014,22,Students,2,5,0,0,0,7,1,5,0,0,0,6,3,10,0,0,0,13
MANIPUR,2014,22,Unemployed,0,0,0,1,0,1,0,0,1,0,0,1,0,0,1,1,0,2
MANIPUR,2014,22,Agriculture (Total),0,0,0,0,0,0,0,0,0,0,0,0,0,0,0,0,0,0
MANIPUR,2014,22,Retired Persons,0,0,0,0,0,0,0,0,0,0,0,0,0,0,0,0,0,0
MEGHALAYA,2001,23,House Wife,0,0,0,0,0,0,0,3,1,0,0,4,0,3,1,0,0,4
MEGHALAYA,2001,23,Service (Government),0,1,6,0,1,8,0,1,1,0,0,2,0,2,7,0,1,10
MEGHALAYA,2001,23,Service (Private),0,0,2,0,0,2,0,0,0,0,0,0,0,0,2,0,0,2
MEGHALAYA,2001,23,Public Sector Undertaking,0,0,0,0,0,0,0,0,0,0,0,0,0,0,0,0,0,0
MEGHALAYA,2001,23,Students,1,4,2,0,0,7,0,0,0,0,0,0,1,4,2,0,0,7
MEGHALAYA,2001,23,Unemployed,0,7,3,0,2,12,0,2,0,0,0,2,0,9,3,0,2,14
MEGHALAYA,2001,23,Professional Activity,0,0,1,1,0,2,0,0,0,0,0,0,0,0,1,1,0,2
MEGHALAYA,2001,23,Agriculture (Total),0,0,2,0,0,2,0,2,0,0,0,2,0,2,2,0,0,4
MEGHALAYA,2001,23,Retired Persons,0,0,2,0,1,3,0,0,0,0,1,1,0,0,2,0,2,4
MEGHALAYA,2002,23,House Wife,0,0,0,0,0,0,0,6,3,2,0,11,0,6,3,2,0,11
MEGHALAYA,2002,23,Service (Government),0,0,4,0,0,4,0,0,0,0,0,0,0,0,4,0,0,4
MEGHALAYA,2002,23,Service (Private),0,1,3,0,0,4,0,0,0,0,0,0,0,1,3,0,0,4
MEGHALAYA,2002,23,Public Sector Undertaking,0,0,0,0,0,0,0,0,0,0,0,0,0,0,0,0,0,0
MEGHALAYA,2002,23,Students,2,0,0,0,0,2,1,0,0,0,0,1,3,0,0,0,0,3
MEGHALAYA,2002,23,Unemployed,0,3,5,2,0,10,0,2,2,0,0,4,0,5,7,2,0,14
MEGHALAYA,2002,23,Professional Activity,0,0,0,0,0,0,0,0,0,0,0,0,0,0,0,0,0,0
MEGHALAYA,2002,23,Agriculture (Total),1,2,2,3,0,8,0,0,0,0,0,0,1,2,2,3,0,8
MEGHALAYA,2002,23,Retired Persons,0,0,0,0,0,0,0,0,0,0,0,0,0,0,0,0,0,0
MEGHALAYA,2003,23,House Wife,0,0,0,0,0,0,0,0,0,0,1,1,0,0,0,0,1,1
MEGHALAYA,2003,23,Service (Government),0,1,2,1,0,4,0,0,0,0,0,0,0,1,2,1,0,4
MEGHALAYA,2003,23,Service (Private),0,2,3,1,0,6,0,0,0,0,0,0,0,2,3,1,0,6
MEGHALAYA,2003,23,Public Sector Undertaking,0,0,0,0,0,0,0,0,0,0,0,0,0,0,0,0,0,0
MEGHALAYA,2003,23,Students,2,0,0,0,0,2,1,0,0,0,0,1,3,0,0,0,0,3
MEGHALAYA,2003,23,Unemployed,0,2,4,0,0,6,0,0,0,0,0,0,0,2,4,0,0,6
MEGHALAYA,2003,23,Professional Activity,0,0,0,0,0,0,0,0,0,0,0,0,0,0,0,0,0,0
MEGHALAYA,2003,23,Agriculture (Total),0,0,0,3,1,4,0,0,0,0,0,0,0,0,0,3,1,4
MEGHALAYA,2003,23,Retired Persons,0,0,0,0,0,0,0,0,0,0,0,0,0,0,0,0,0,0
MEGHALAYA,2004,23,House Wife,0,0,0,0,0,0,0,5,2,0,0,7,0,5,2,0,0,7
MEGHALAYA,2004,23,Service (Government),0,0,8,2,0,10,0,1,0,0,0,1,0,1,8,2,0,11
MEGHALAYA,2004,23,Service (Private),0,3,3,0,0,6,0,0,0,0,0,0,0,3,3,0,0,6
MEGHALAYA,2004,23,Public Sector Undertaking,0,1,1,0,0,2,0,0,0,0,0,0,0,1,1,0,0,2
MEGHALAYA,2004,23,Students,0,6,0,0,0,6,0,6,0,0,0,6,0,12,0,0,0,12
MEGHALAYA,2004,23,Unemployed,0,1,3,0,0,4,0,2,0,0,0,2,0,3,3,0,0,6
MEGHALAYA,2004,23,Professional Activity,0,0,0,0,0,0,0,0,0,0,0,0,0,0,0,0,0,0
MEGHALAYA,2004,23,Agriculture (Total),0,0,3,6,2,11,0,0,0,0,0,0,0,0,3,6,2,11
MEGHALAYA,2004,23,Retired Persons,0,0,0,0,0,0,0,0,0,0,0,0,0,0,0,0,0,0
MEGHALAYA,2005,23,House Wife,0,0,0,0,0,0,0,6,3,2,0,11,0,6,3,2,0,11
MEGHALAYA,2005,23,Service (Government),0,0,1,0,0,1,0,0,0,0,0,0,0,0,1,0,0,1
MEGHALAYA,2005,23,Service (Private),0,0,2,1,0,3,0,0,0,0,0,0,0,0,2,1,0,3
MEGHALAYA,2005,23,Public Sector Undertaking,0,0,0,1,0,1,0,0,0,0,0,0,0,0,0,1,0,1
MEGHALAYA,2005,23,Students,2,4,0,0,0,6,0,5,0,0,0,5,2,9,0,0,0,11
MEGHALAYA,2005,23,Unemployed,1,6,5,2,1,15,0,2,2,0,0,4,1,8,7,2,1,19
MEGHALAYA,2005,23,Professional Activity,0,0,0,0,0,0,0,0,0,0,0,0,0,0,0,0,0,0
MEGHALAYA,2005,23,Agriculture (Total),0,1,2,0,1,4,0,0,0,0,0,0,0,1,2,0,1,4
MEGHALAYA,2005,23,Retired Persons,0,0,0,1,4,5,0,0,0,0,0,0,0,0,0,1,4,5
MEGHALAYA,2006,23,House Wife,0,0,0,0,0,0,0,6,5,0,0,11,0,6,5,0,0,11
MEGHALAYA,2006,23,Service (Government),0,3,5,0,0,8,0,0,0,0,0,0,0,3,5,0,0,8
MEGHALAYA,2006,23,Service (Private),0,1,2,2,0,5,0,0,0,0,0,0,0,1,2,2,0,5
MEGHALAYA,2006,23,Public Sector Undertaking,0,0,1,0,0,1,0,0,0,0,0,0,0,0,1,0,0,1
MEGHALAYA,2006,23,Students,1,3,0,0,0,4,1,5,0,0,0,6,2,8,0,0,0,10
MEGHALAYA,2006,23,Unemployed,0,9,1,0,0,10,0,2,0,0,0,2,0,11,1,0,0,12
MEGHALAYA,2006,23,Professional Activity,0,0,0,0,0,0,0,0,0,0,0,0,0,0,0,0,0,0
MEGHALAYA,2006,23,Agriculture (Total),0,1,1,1,0,3,0,0,0,0,0,0,0,1,1,1,0,3
MEGHALAYA,2006,23,Retired Persons,0,0,0,0,0,0,0,0,0,0,0,0,0,0,0,0,0,0
MEGHALAYA,2007,23,House Wife,0,0,0,0,0,0,0,2,4,0,0,6,0,2,4,0,0,6
MEGHALAYA,2007,23,Service (Government),0,3,2,1,0,6,0,1,0,0,0,1,0,4,2,1,0,7
MEGHALAYA,2007,23,Service (Private),0,0,0,0,0,0,0,0,0,0,0,0,0,0,0,0,0,0
MEGHALAYA,2007,23,Public Sector Undertaking,0,0,0,1,0,1,0,0,0,0,0,0,0,0,0,1,0,1
MEGHALAYA,2007,23,Students,1,9,0,0,0,10,0,5,2,0,0,7,1,14,2,0,0,17
MEGHALAYA,2007,23,Unemployed,0,3,6,0,1,10,0,2,0,0,0,2,0,5,6,0,1,12
MEGHALAYA,2007,23,Professional Activity,0,0,0,0,0,0,0,0,0,0,0,0,0,0,0,0,0,0
MEGHALAYA,2007,23,Agriculture (Total),0,7,4,1,2,14,0,2,2,0,0,4,0,9,6,1,2,18
MEGHALAYA,2007,23,Retired Persons,0,0,0,0,0,0,0,0,0,0,0,0,0,0,0,0,0,0
MEGHALAYA,2008,23,House Wife,0,0,0,0,0,0,0,3,4,2,0,9,0,3,4,2,0,9
MEGHALAYA,2008,23,Service (Government),0,0,5,2,0,7,0,0,1,0,0,1,0,0,6,2,0,8
MEGHALAYA,2008,23,Service (Private),0,0,1,0,0,1,0,0,0,0,0,0,0,0,1,0,0,1
MEGHALAYA,2008,23,Public Sector Undertaking,0,0,0,0,0,0,0,0,0,0,0,0,0,0,0,0,0,0
MEGHALAYA,2008,23,Students,0,4,1,0,0,5,1,3,0,0,0,4,1,7,1,0,0,9
MEGHALAYA,2008,23,Unemployed,0,7,5,4,0,16,0,2,1,0,1,4,0,9,6,4,1,20
MEGHALAYA,2008,23,Professional Activity,0,0,0,0,0,0,0,1,0,0,0,1,0,1,0,0,0,1
MEGHALAYA,2008,23,Agriculture (Total),0,4,3,2,0,9,0,0,0,0,0,0,0,4,3,2,0,9
MEGHALAYA,2008,23,Retired Persons,0,0,0,0,0,0,0,0,0,0,0,0,0,0,0,0,0,0
MEGHALAYA,2009,23,House Wife,0,0,0,0,0,0,0,4,2,5,0,11,0,4,2,5,0,11
MEGHALAYA,2009,23,Service (Government),0,0,0,1,0,1,0,0,0,0,0,0,0,0,0,1,0,1
MEGHALAYA,2009,23,Service (Private),0,0,0,1,0,1,0,0,0,0,0,0,0,0,0,1,0,1
MEGHALAYA,2009,23,Public Sector Undertaking,0,0,1,0,1,2,0,0,0,0,0,0,0,0,1,0,1,2
MEGHALAYA,2009,23,Students,1,6,0,0,0,7,0,2,0,0,0,2,1,8,0,0,0,9
MEGHALAYA,2009,23,Unemployed,0,2,4,0,0,6,0,1,0,0,0,1,0,3,4,0,0,7
MEGHALAYA,2009,23,Professional Activity,0,0,0,0,0,0,0,0,3,0,0,3,0,0,3,0,0,3
MEGHALAYA,2009,23,Agriculture (Total),0,3,2,10,1,16,0,5,0,0,0,5,0,8,2,10,1,21
MEGHALAYA,2009,23,Retired Persons,0,0,0,1,1,2,0,0,0,0,0,0,0,0,0,1,1,2
MEGHALAYA,2010,23,House Wife,0,0,0,0,0,0,0,7,5,1,1,14,0,7,5,1,1,14
MEGHALAYA,2010,23,Service (Government),0,2,4,2,0,8,0,0,0,0,0,0,0,2,4,2,0,8
MEGHALAYA,2010,23,Service (Private),0,6,1,4,0,11,0,0,0,0,0,0,0,6,1,4,0,11
MEGHALAYA,2010,23,Public Sector Undertaking,0,1,0,0,0,1,0,0,0,0,0,0,0,1,0,0,0,1
MEGHALAYA,2010,23,Students,2,10,2,0,0,14,1,5,1,0,0,7,3,15,3,0,0,21
MEGHALAYA,2010,23,Unemployed,0,5,8,2,0,15,0,1,1,0,0,2,0,6,9,2,0,17
MEGHALAYA,2010,23,Professional Activity,0,0,1,0,0,1,0,0,0,0,0,0,0,0,1,0,0,1
MEGHALAYA,2010,23,Agriculture (Total),0,5,5,3,2,15,0,0,0,1,0,1,0,5,5,4,2,16
MEGHALAYA,2010,23,Retired Persons,0,0,0,0,1,1,0,0,0,0,0,0,0,0,0,0,1,1
MEGHALAYA,2011,23,House Wife,0,0,0,0,0,0,0,5,8,2,0,15,0,5,8,2,0,15
MEGHALAYA,2011,23,Service (Government),0,2,3,1,0,6,0,0,0,0,0,0,0,2,3,1,0,6
MEGHALAYA,2011,23,Service (Private),0,6,1,0,0,7,0,0,1,0,0,1,0,6,2,0,0,8
MEGHALAYA,2011,23,Public Sector Undertaking,0,0,1,0,1,2,0,0,0,0,0,0,0,0,1,0,1,2
MEGHALAYA,2011,23,Students,3,25,0,0,0,28,0,9,0,0,0,9,3,34,0,0,0,37
MEGHALAYA,2011,23,Unemployed,0,12,6,0,0,18,0,1,2,0,0,3,0,13,8,0,0,21
MEGHALAYA,2011,23,Professional Activity,0,4,0,0,0,4,0,0,0,2,0,2,0,4,0,2,0,6
MEGHALAYA,2011,23,Agriculture (Total),0,6,6,3,1,16,0,4,2,0,0,6,0,10,8,3,1,22
MEGHALAYA,2011,23,Retired Persons,0,0,0,0,0,0,0,0,0,0,0,0,0,0,0,0,0,0
MEGHALAYA,2012,23,House Wife,0,0,0,0,0,0,0,6,6,2,0,14,0,6,6,2,0,14
MEGHALAYA,2012,23,Service (Government),0,2,1,1,0,4,0,0,0,0,0,0,0,2,1,1,0,4
MEGHALAYA,2012,23,Service (Private),1,2,1,1,0,5,0,0,0,0,0,0,1,2,1,1,0,5
MEGHALAYA,2012,23,Public Sector Undertaking,0,0,1,0,0,1,0,0,0,0,0,0,0,0,1,0,0,1
MEGHALAYA,2012,23,Students,2,12,0,0,0,14,1,10,0,0,0,11,3,22,0,0,0,25
MEGHALAYA,2012,23,Unemployed,0,8,5,4,0,17,0,5,1,0,0,6,0,13,6,4,0,23
MEGHALAYA,2012,23,Professional Activity,0,1,2,0,0,3,0,0,0,0,0,0,0,1,2,0,0,3
MEGHALAYA,2012,23,Agriculture (Total),0,3,3,3,0,9,0,1,0,0,0,1,0,4,3,3,0,10
MEGHALAYA,2012,23,Retired Persons,0,0,0,0,0,0,0,0,0,0,0,0,0,0,0,0,0,0
MEGHALAYA,2013,23,House Wife,0,0,0,0,0,0,0,7,9,1,0,17,0,7,9,1,0,17
MEGHALAYA,2013,23,Service (Government),0,0,5,2,0,7,0,0,0,0,0,0,0,0,5,2,0,7
MEGHALAYA,2013,23,Service (Private),0,5,3,2,0,10,0,0,0,0,0,0,0,5,3,2,0,10
MEGHALAYA,2013,23,Public Sector Undertaking,0,0,0,0,2,2,0,0,0,0,0,0,0,0,0,0,2,2
MEGHALAYA,2013,23,Students,1,13,0,0,0,14,6,10,0,0,0,16,7,23,0,0,0,30
MEGHALAYA,2013,23,Unemployed,0,20,9,1,1,31,0,2,0,0,0,2,0,22,9,1,1,33
MEGHALAYA,2013,23,Professional Activity,0,0,0,0,0,0,0,0,0,0,0,0,0,0,0,0,0,0
MEGHALAYA,2013,23,Agriculture (Total),0,0,3,1,0,4,0,1,0,0,0,1,0,1,3,1,0,5
MEGHALAYA,2013,23,Retired Persons,0,0,0,0,0,0,0,0,0,0,0,0,0,0,0,0,0,0
MEGHALAYA,2014,23,House Wife,0,0,0,0,0,0,0,5,4,0,1,10,0,5,4,0,1,10
MEGHALAYA,2014,23,Service (Government),0,1,3,0,0,4,0,0,0,0,0,0,0,1,3,0,0,4
MEGHALAYA,2014,23,Service (Private),0,0,0,0,0,0,0,0,0,0,0,0,0,0,0,0,0,0
MEGHALAYA,2014,23,Public Sector Undertaking,0,0,0,0,0,0,0,0,0,0,0,0,0,0,0,0,0,0
MEGHALAYA,2014,23,Students,2,10,0,0,0,12,2,8,0,0,0,10,4,18,0,0,0,22
MEGHALAYA,2014,23,Unemployed,0,3,3,1,0,7,0,2,0,0,0,2,0,5,3,1,0,9
MEGHALAYA,2014,23,Agriculture (Total),0,1,0,1,0,2,0,0,0,0,0,0,0,1,0,1,0,2
MEGHALAYA,2014,23,Retired Persons,0,0,0,0,0,0,0,0,0,0,0,0,0,0,0,0,0,0
MIZORAM,2001,24,House Wife,0,0,0,0,0,0,0,0,0,0,0,0,0,0,0,0,0,0
MIZORAM,2001,24,Service (Government),0,2,1,0,0,3,0,0,0,0,0,0,0,2,1,0,0,3
MIZORAM,2001,24,Service (Private),0,2,0,0,0,2,0,0,0,0,0,0,0,2,0,0,0,2
MIZORAM,2001,24,Public Sector Undertaking,0,0,0,0,0,0,0,0,0,0,0,0,0,0,0,0,0,0
MIZORAM,2001,24,Students,1,11,0,0,0,12,0,1,0,0,0,1,1,12,0,0,0,13
MIZORAM,2001,24,Unemployed,2,2,4,1,0,9,0,2,1,2,0,5,2,4,5,3,0,14
MIZORAM,2001,24,Professional Activity,0,0,0,0,0,0,0,0,0,0,0,0,0,0,0,0,0,0
MIZORAM,2001,24,Agriculture (Total),0,0,0,0,0,0,0,0,0,0,0,0,0,0,0,0,0,0
MIZORAM,2001,24,Retired Persons,0,0,0,0,1,1,0,0,0,0,0,0,0,0,0,0,1,1
MIZORAM,2002,24,House Wife,0,0,0,0,0,0,0,2,1,2,0,5,0,2,1,2,0,5
MIZORAM,2002,24,Service (Government),0,3,2,3,0,8,0,0,0,0,0,0,0,3,2,3,0,8
MIZORAM,2002,24,Service (Private),0,0,0,0,0,0,0,0,0,0,0,0,0,0,0,0,0,0
MIZORAM,2002,24,Public Sector Undertaking,0,0,3,1,0,4,0,0,0,0,0,0,0,0,3,1,0,4
MIZORAM,2002,24,Students,0,1,0,0,0,1,0,0,0,0,0,0,0,1,0,0,0,1
MIZORAM,2002,24,Unemployed,0,14,3,2,0,19,0,1,0,0,0,1,0,15,3,2,0,20
MIZORAM,2002,24,Professional Activity,0,0,0,0,0,0,0,0,0,0,0,0,0,0,0,0,0,0
MIZORAM,2002,24,Agriculture (Total),0,0,2,1,0,3,0,0,0,0,0,0,0,0,2,1,0,3
MIZORAM,2002,24,Retired Persons,0,0,0,0,0,0,0,0,0,0,0,0,0,0,0,0,0,0
MIZORAM,2003,24,House Wife,0,0,0,0,0,0,0,0,0,0,0,0,0,0,0,0,0,0
MIZORAM,2003,24,Service (Government),0,1,2,1,0,4,0,0,0,0,0,0,0,1,2,1,0,4
MIZORAM,2003,24,Service (Private),0,4,1,0,0,5,0,0,0,0,0,0,0,4,1,0,0,5
MIZORAM,2003,24,Public Sector Undertaking,0,0,0,0,0,0,0,0,0,0,0,0,0,0,0,0,0,0
MIZORAM,2003,24,Students,0,1,0,0,0,1,0,0,0,0,0,0,0,1,0,0,0,1
MIZORAM,2003,24,Unemployed,0,4,5,0,0,9,0,0,0,0,0,0,0,4,5,0,0,9
MIZORAM,2003,24,Professional Activity,0,0,0,0,0,0,0,0,0,0,0,0,0,0,0,0,0,0
MIZORAM,2003,24,Agriculture (Total),0,0,0,0,0,0,0,0,0,0,0,0,0,0,0,0,0,0
MIZORAM,2003,24,Retired Persons,0,0,0,0,0,0,0,0,0,0,0,0,0,0,0,0,0,0
MIZORAM,2004,24,House Wife,0,0,0,0,0,0,0,0,0,0,0,0,0,0,0,0,0,0
MIZORAM,2004,24,Service (Government),0,3,1,0,0,4,0,0,0,0,0,0,0,3,1,0,0,4
MIZORAM,2004,24,Service (Private),0,0,0,0,0,0,0,0,0,0,0,0,0,0,0,0,0,0
MIZORAM,2004,24,Public Sector Undertaking,0,0,4,1,0,5,0,0,0,0,0,0,0,0,4,1,0,5
MIZORAM,2004,24,Students,0,1,0,0,0,1,0,0,0,0,0,0,0,1,0,0,0,1
MIZORAM,2004,24,Unemployed,0,11,5,2,0,18,0,3,0,0,0,3,0,14,5,2,0,21
MIZORAM,2004,24,Professional Activity,0,0,0,0,0,0,0,0,0,0,0,0,0,0,0,0,0,0
MIZORAM,2004,24,Agriculture (Total),0,0,1,1,0,2,0,0,0,0,0,0,0,0,1,1,0,2
MIZORAM,2004,24,Retired Persons,0,0,0,0,0,0,0,0,0,0,0,0,0,0,0,0,0,0
MIZORAM,2005,24,House Wife,0,0,0,0,0,0,0,0,2,1,0,3,0,0,2,1,0,3
MIZORAM,2005,24,Service (Government),0,1,3,0,0,4,0,0,0,0,0,0,0,1,3,0,0,4
MIZORAM,2005,24,Service (Private),0,0,1,0,0,1,0,0,0,0,0,0,0,0,1,0,0,1
MIZORAM,2005,24,Public Sector Undertaking,0,0,0,0,0,0,0,0,0,0,0,0,0,0,0,0,0,0
MIZORAM,2005,24,Students,0,0,0,0,0,0,0,0,0,0,0,0,0,0,0,0,0,0
MIZORAM,2005,24,Unemployed,0,8,5,0,0,13,0,1,1,0,0,2,0,9,6,0,0,15
MIZORAM,2005,24,Professional Activity,0,0,0,0,0,0,0,0,0,0,0,0,0,0,0,0,0,0
MIZORAM,2005,24,Agriculture (Total),0,0,0,0,0,0,0,0,0,0,0,0,0,0,0,0,0,0
MIZORAM,2005,24,Retired Persons,0,0,0,0,0,0,0,0,0,0,0,0,0,0,0,0,0,0
MIZORAM,2006,24,House Wife,0,0,0,0,0,0,0,1,0,3,0,4,0,1,0,3,0,4
MIZORAM,2006,24,Service (Government),0,2,2,1,0,5,0,0,0,0,0,0,0,2,2,1,0,5
MIZORAM,2006,24,Service (Private),0,3,0,0,0,3,0,0,0,0,0,0,0,3,0,0,0,3
MIZORAM,2006,24,Public Sector Undertaking,0,3,0,0,0,3,0,0,0,0,0,0,0,3,0,0,0,3
MIZORAM,2006,24,Students,0,2,2,0,0,4,0,0,0,0,0,0,0,2,2,0,0,4
MIZORAM,2006,24,Unemployed,0,5,0,1,0,6,0,0,0,0,0,0,0,5,0,1,0,6
MIZORAM,2006,24,Professional Activity,0,0,0,0,0,0,0,0,0,0,0,0,0,0,0,0,0,0
MIZORAM,2006,24,Agriculture (Total),0,0,1,0,0,1,0,0,0,0,0,0,0,0,1,0,0,1
MIZORAM,2006,24,Retired Persons,0,0,0,0,0,0,0,0,0,0,0,0,0,0,0,0,0,0
MIZORAM,2007,24,House Wife,0,0,0,0,0,0,0,0,1,2,0,3,0,0,1,2,0,3
MIZORAM,2007,24,Service (Government),0,0,0,0,0,0,0,0,0,0,0,0,0,0,0,0,0,0
MIZORAM,2007,24,Service (Private),0,0,0,0,0,0,0,0,0,0,0,0,0,0,0,0,0,0
MIZORAM,2007,24,Public Sector Undertaking,0,0,0,0,0,0,0,0,0,0,0,0,0,0,0,0,0,0
MIZORAM,2007,24,Students,0,0,0,0,0,0,0,0,0,0,0,0,0,0,0,0,0,0
MIZORAM,2007,24,Unemployed,0,0,0,0,0,0,0,0,0,0,0,0,0,0,0,0,0,0
MIZORAM,2007,24,Professional Activity,0,0,0,0,0,0,0,0,0,0,0,0,0,0,0,0,0,0
MIZORAM,2007,24,Agriculture (Total),0,0,0,0,0,0,0,0,0,0,0,0,0,0,0,0,0,0
MIZORAM,2007,24,Retired Persons,0,0,0,0,0,0,0,0,0,0,0,0,0,0,0,0,0,0
MIZORAM,2008,24,House Wife,0,0,0,0,0,0,0,0,0,0,0,0,0,0,0,0,0,0
MIZORAM,2008,24,Service (Government),0,0,0,0,0,0,0,0,0,0,0,0,0,0,0,0,0,0
MIZORAM,2008,24,Service (Private),0,0,0,0,0,0,0,0,0,0,0,0,0,0,0,0,0,0
MIZORAM,2008,24,Public Sector Undertaking,0,0,0,0,0,0,0,0,0,0,0,0,0,0,0,0,0,0
MIZORAM,2008,24,Students,0,3,0,0,0,3,0,0,2,0,0,2,0,3,2,0,0,5
MIZORAM,2008,24,Unemployed,0,0,0,0,0,0,0,0,0,0,0,0,0,0,0,0,0,0
MIZORAM,2008,24,Professional Activity,0,0,0,0,0,0,0,0,0,0,0,0,0,0,0,0,0,0
MIZORAM,2008,24,Agriculture (Total),0,0,0,0,0,0,0,0,0,0,0,0,0,0,0,0,0,0
MIZORAM,2008,24,Retired Persons,0,0,0,0,0,0,0,0,0,0,0,0,0,0,0,0,0,0
MIZORAM,2009,24,House Wife,0,0,0,0,0,0,0,0,1,0,0,1,0,0,1,0,0,1
MIZORAM,2009,24,Service (Government),0,0,1,0,0,1,0,0,0,0,0,0,0,0,1,0,0,1
MIZORAM,2009,24,Service (Private),0,1,1,0,0,2,0,0,0,0,0,0,0,1,1,0,0,2
MIZORAM,2009,24,Public Sector Undertaking,0,0,0,0,0,0,0,0,0,0,0,0,0,0,0,0,0,0
MIZORAM,2009,24,Students,0,1,0,0,0,1,0,0,0,0,0,0,0,1,0,0,0,1
MIZORAM,2009,24,Unemployed,0,1,5,0,0,6,0,0,0,0,0,0,0,1,5,0,0,6
MIZORAM,2009,24,Professional Activity,0,0,0,0,0,0,0,0,0,0,0,0,0,0,0,0,0,0
MIZORAM,2009,24,Agriculture (Total),1,16,14,1,1,33,0,2,1,2,0,5,1,18,15,3,1,38
MIZORAM,2009,24,Retired Persons,0,0,0,1,0,1,0,0,0,0,0,0,0,0,0,1,0,1
MIZORAM,2010,24,House Wife,0,0,0,0,0,0,0,0,0,0,0,0,0,0,0,0,0,0
MIZORAM,2010,24,Service (Government),0,10,10,2,1,23,0,4,0,0,0,4,0,14,10,2,1,27
MIZORAM,2010,24,Service (Private),2,0,0,0,0,2,0,0,1,0,0,1,2,0,1,0,0,3
MIZORAM,2010,24,Public Sector Undertaking,0,0,0,0,0,0,0,0,0,0,0,0,0,0,0,0,0,0
MIZORAM,2010,24,Students,2,0,0,0,0,2,0,0,0,0,0,0,2,0,0,0,0,2
MIZORAM,2010,24,Unemployed,0,10,5,3,1,19,0,2,0,0,0,2,0,12,5,3,1,21
MIZORAM,2010,24,Professional Activity,0,0,0,0,0,0,0,0,0,0,0,0,0,0,0,0,0,0
MIZORAM,2010,24,Agriculture (Total),0,4,0,1,0,5,0,0,0,0,0,0,0,4,0,1,0,5
MIZORAM,2010,24,Retired Persons,0,0,0,0,0,0,0,0,0,0,0,0,0,0,0,0,0,0
MIZORAM,2011,24,House Wife,0,0,0,0,0,0,0,0,5,1,0,6,0,0,5,1,0,6
MIZORAM,2011,24,Service (Government),0,0,1,3,0,4,0,0,0,0,0,0,0,0,1,3,0,4
MIZORAM,2011,24,Service (Private),0,0,3,0,0,3,0,0,0,0,0,0,0,0,3,0,0,3
MIZORAM,2011,24,Public Sector Undertaking,0,0,0,0,0,0,0,1,0,0,0,1,0,1,0,0,0,1
MIZORAM,2011,24,Students,2,10,0,0,0,12,0,1,0,0,0,1,2,11,0,0,0,13
MIZORAM,2011,24,Unemployed,0,15,11,0,0,26,0,1,0,0,0,1,0,16,11,0,0,27
MIZORAM,2011,24,Professional Activity,0,0,0,0,0,0,0,0,0,0,0,0,0,0,0,0,0,0
MIZORAM,2011,24,Agriculture (Total),0,3,5,4,1,13,0,0,1,0,0,1,0,3,6,4,1,14
MIZORAM,2011,24,Retired Persons,0,0,0,0,1,1,0,0,0,0,0,0,0,0,0,0,1,1
MIZORAM,2012,24,House Wife,0,0,0,0,0,0,0,0,1,0,0,1,0,0,1,0,0,1
MIZORAM,2012,24,Service (Government),0,0,1,1,0,2,0,0,0,0,0,0,0,0,1,1,0,2
MIZORAM,2012,24,Service (Private),3,0,13,0,0,16,0,4,0,0,0,4,3,4,13,0,0,20
MIZORAM,2012,24,Public Sector Undertaking,0,0,0,0,0,0,0,0,0,0,0,0,0,0,0,0,0,0
MIZORAM,2012,24,Students,0,1,5,0,0,6,0,1,0,0,0,1,0,2,5,0,0,7
MIZORAM,2012,24,Unemployed,2,28,17,10,6,63,3,0,0,0,0,3,5,28,17,10,6,66
MIZORAM,2012,24,Professional Activity,0,0,0,0,0,0,0,0,0,0,0,0,0,0,0,0,0,0
MIZORAM,2012,24,Agriculture (Total),0,3,5,1,0,9,0,0,0,1,0,1,0,3,5,2,0,10
MIZORAM,2012,24,Retired Persons,0,0,0,0,2,2,0,2,0,0,0,2,0,2,0,0,2,4
MIZORAM,2013,24,House Wife,0,0,0,0,0,0,0,1,3,1,0,5,0,1,3,1,0,5
MIZORAM,2013,24,Service (Government),0,3,2,1,0,6,0,0,0,0,0,0,0,3,2,1,0,6
MIZORAM,2013,24,Service (Private),0,4,1,2,0,7,0,0,0,0,0,0,0,4,1,2,0,7
MIZORAM,2013,24,Public Sector Undertaking,0,0,0,0,0,0,0,0,0,0,0,0,0,0,0,0,0,0
MIZORAM,2013,24,Students,1,5,0,0,0,6,0,2,0,0,0,2,1,7,0,0,0,8
MIZORAM,2013,24,Unemployed,0,23,11,4,0,38,0,1,1,0,0,2,0,24,12,4,0,40
MIZORAM,2013,24,Professional Activity,0,0,0,1,0,1,0,0,0,0,0,0,0,0,0,1,0,1
MIZORAM,2013,24,Agriculture (Total),0,1,4,1,0,6,0,0,0,0,0,0,0,1,4,1,0,6
MIZORAM,2013,24,Retired Persons,0,0,0,0,1,1,0,0,0,0,0,0,0,0,0,0,1,1
MIZORAM,2014,24,House Wife,0,0,0,0,0,0,0,3,1,1,0,5,0,3,1,1,0,5
MIZORAM,2014,24,Service (Government),0,4,4,0,0,8,0,0,0,0,0,0,0,4,4,0,0,8
MIZORAM,2014,24,Service (Private),0,0,0,0,0,0,0,0,0,0,0,0,0,0,0,0,0,0
MIZORAM,2014,24,Public Sector Undertaking,0,3,0,2,0,5,0,0,0,0,0,0,0,3,0,2,0,5
MIZORAM,2014,24,Students,4,7,0,0,0,11,0,4,0,0,0,4,4,11,0,0,0,15
MIZORAM,2014,24,Unemployed,0,14,6,3,1,24,0,0,0,0,0,0,0,14,6,3,1,24
MIZORAM,2014,24,Agriculture (Total),0,0,2,2,0,4,0,0,0,0,1,1,0,0,2,2,1,5
MIZORAM,2014,24,Retired Persons,0,0,0,0,0,0,0,0,0,0,0,0,0,0,0,0,0,0
NAGALAND,2001,25,House Wife,0,0,0,0,0,0,0,2,4,0,0,6,0,2,4,0,0,6
NAGALAND,2001,25,Service (Government),0,1,3,1,0,5,0,0,1,0,0,1,0,1,4,1,0,6
NAGALAND,2001,25,Service (Private),0,1,3,0,0,4,0,1,0,0,0,1,0,2,3,0,0,5
NAGALAND,2001,25,Public Sector Undertaking,0,0,0,0,0,0,0,0,0,0,0,0,0,0,0,0,0,0
NAGALAND,2001,25,Students,0,0,0,0,0,0,0,0,0,1,0,1,0,0,0,1,0,1
NAGALAND,2001,25,Unemployed,0,5,7,1,0,13,0,4,0,2,0,6,0,9,7,3,0,19
NAGALAND,2001,25,Professional Activity,0,0,0,0,0,0,0,0,0,0,0,0,0,0,0,0,0,0
NAGALAND,2001,25,Agriculture (Total),0,0,0,0,0,0,0,0,0,0,0,0,0,0,0,0,0,0
NAGALAND,2001,25,Retired Persons,0,0,0,0,0,0,0,0,0,0,0,0,0,0,0,0,0,0
NAGALAND,2002,25,House Wife,0,0,0,0,0,0,0,2,1,0,0,3,0,2,1,0,0,3
NAGALAND,2002,25,Service (Government),0,2,8,0,0,10,0,0,0,0,0,0,0,2,8,0,0,10
NAGALAND,2002,25,Service (Private),0,0,1,0,0,1,0,0,0,0,0,0,0,0,1,0,0,1
NAGALAND,2002,25,Public Sector Undertaking,0,0,0,0,0,0,0,0,0,0,0,0,0,0,0,0,0,0
NAGALAND,2002,25,Students,1,0,0,0,0,1,1,1,1,0,0,3,2,1,1,0,0,4
NAGALAND,2002,25,Unemployed,0,0,3,0,0,3,0,0,1,0,0,1,0,0,4,0,0,4
NAGALAND,2002,25,Professional Activity,0,0,0,0,0,0,0,0,0,0,0,0,0,0,0,0,0,0
NAGALAND,2002,25,Agriculture (Total),0,0,0,0,0,0,0,0,0,0,0,0,0,0,0,0,0,0
NAGALAND,2002,25,Retired Persons,0,0,0,0,0,0,0,0,0,0,0,0,0,0,0,0,0,0
NAGALAND,2003,25,House Wife,0,0,0,0,0,0,0,4,0,0,0,4,0,4,0,0,0,4
NAGALAND,2003,25,Service (Government),0,0,7,0,0,7,0,0,0,0,0,0,0,0,7,0,0,7
NAGALAND,2003,25,Service (Private),0,0,0,0,0,0,0,0,0,0,0,0,0,0,0,0,0,0
NAGALAND,2003,25,Public Sector Undertaking,0,0,0,0,0,0,0,0,0,0,0,0,0,0,0,0,0,0
NAGALAND,2003,25,Students,0,1,0,0,0,1,0,1,0,0,0,1,0,2,0,0,0,2
NAGALAND,2003,25,Unemployed,0,3,1,0,0,4,0,0,0,0,0,0,0,3,1,0,0,4
NAGALAND,2003,25,Professional Activity,0,0,0,0,0,0,0,0,0,0,0,0,0,0,0,0,0,0
NAGALAND,2003,25,Agriculture (Total),0,0,0,0,0,0,0,0,0,0,0,0,0,0,0,0,0,0
NAGALAND,2003,25,Retired Persons,0,0,0,0,0,0,0,0,0,0,0,0,0,0,0,0,0,0
NAGALAND,2004,25,House Wife,0,0,0,0,0,0,0,0,0,0,0,0,0,0,0,0,0,0
NAGALAND,2004,25,Service (Government),0,1,5,0,0,6,0,0,0,0,0,0,0,1,5,0,0,6
NAGALAND,2004,25,Service (Private),0,0,0,0,0,0,0,0,0,0,0,0,0,0,0,0,0,0
NAGALAND,2004,25,Public Sector Undertaking,0,2,0,0,0,2,0,0,0,0,0,0,0,2,0,0,0,2
NAGALAND,2004,25,Students,0,1,0,0,0,1,0,0,0,0,0,0,0,1,0,0,0,1
NAGALAND,2004,25,Unemployed,0,2,3,0,0,5,0,0,0,0,0,0,0,2,3,0,0,5
NAGALAND,2004,25,Professional Activity,0,0,0,0,0,0,0,0,0,0,0,0,0,0,0,0,0,0
NAGALAND,2004,25,Agriculture (Total),0,0,0,0,0,0,0,0,0,0,0,0,0,0,0,0,0,0
NAGALAND,2004,25,Retired Persons,0,0,0,0,0,0,0,0,0,0,0,0,0,0,0,0,0,0
NAGALAND,2005,25,House Wife,0,0,0,0,0,0,0,0,1,0,0,1,0,0,1,0,0,1
NAGALAND,2005,25,Service (Government),0,0,7,2,0,9,0,0,1,0,0,1,0,0,8,2,0,10
NAGALAND,2005,25,Service (Private),0,0,0,0,0,0,0,0,0,0,0,0,0,0,0,0,0,0
NAGALAND,2005,25,Public Sector Undertaking,0,0,0,0,0,0,0,0,0,0,0,0,0,0,0,0,0,0
NAGALAND,2005,25,Students,0,3,0,0,0,3,0,2,0,0,0,2,0,5,0,0,0,5
NAGALAND,2005,25,Unemployed,0,0,1,0,0,1,0,0,0,0,0,0,0,0,1,0,0,1
NAGALAND,2005,25,Professional Activity,0,0,1,0,0,1,0,0,0,0,0,0,0,0,1,0,0,1
NAGALAND,2005,25,Agriculture (Total),0,0,0,0,0,0,0,0,0,0,0,0,0,0,0,0,0,0
NAGALAND,2005,25,Retired Persons,0,0,0,0,0,0,0,0,0,0,0,0,0,0,0,0,0,0
NAGALAND,2006,25,House Wife,0,0,0,0,0,0,0,0,4,1,0,5,0,0,4,1,0,5
NAGALAND,2006,25,Service (Government),0,3,2,0,0,5,0,0,0,0,0,0,0,3,2,0,0,5
NAGALAND,2006,25,Service (Private),0,0,0,0,0,0,0,0,0,0,0,0,0,0,0,0,0,0
NAGALAND,2006,25,Public Sector Undertaking,0,0,0,0,0,0,0,0,0,0,0,0,0,0,0,0,0,0
NAGALAND,2006,25,Students,0,1,1,0,0,2,0,0,0,0,0,0,0,1,1,0,0,2
NAGALAND,2006,25,Unemployed,1,4,2,0,0,7,0,0,0,0,0,0,1,4,2,0,0,7
NAGALAND,2006,25,Professional Activity,0,0,0,0,0,0,0,0,0,0,0,0,0,0,0,0,0,0
NAGALAND,2006,25,Agriculture (Total),0,0,0,1,0,1,0,1,0,0,0,1,0,1,0,1,0,2
NAGALAND,2006,25,Retired Persons,0,0,0,0,0,0,0,0,0,0,0,0,0,0,0,0,0,0
NAGALAND,2007,25,House Wife,0,0,0,0,0,0,0,1,4,0,0,5,0,1,4,0,0,5
NAGALAND,2007,25,Service (Government),0,1,0,4,0,5,0,0,0,0,0,0,0,1,0,4,0,5
NAGALAND,2007,25,Service (Private),0,0,0,0,0,0,0,0,0,0,0,0,0,0,0,0,0,0
NAGALAND,2007,25,Public Sector Undertaking,0,0,0,0,0,0,0,0,0,0,0,0,0,0,0,0,0,0
NAGALAND,2007,25,Students,0,0,0,0,0,0,0,0,0,0,0,0,0,0,0,0,0,0
NAGALAND,2007,25,Unemployed,0,0,2,0,0,2,0,0,0,0,0,0,0,0,2,0,0,2
NAGALAND,2007,25,Professional Activity,0,0,0,0,0,0,0,0,0,0,0,0,0,0,0,0,0,0
NAGALAND,2007,25,Agriculture (Total),0,0,0,0,0,0,0,0,0,0,0,0,0,0,0,0,0,0
NAGALAND,2007,25,Retired Persons,0,0,0,0,0,0,0,0,0,0,0,0,0,0,0,0,0,0
NAGALAND,2008,25,House Wife,0,0,0,0,0,0,0,4,0,0,0,4,0,4,0,0,0,4
NAGALAND,2008,25,Service (Government),0,0,4,0,0,4,0,1,0,0,0,1,0,1,4,0,0,5
NAGALAND,2008,25,Service (Private),0,0,0,0,0,0,0,0,0,0,0,0,0,0,0,0,0,0
NAGALAND,2008,25,Public Sector Undertaking,0,0,0,0,0,0,0,0,0,0,0,0,0,0,0,0,0,0
NAGALAND,2008,25,Students,0,0,0,0,0,0,0,3,0,0,0,3,0,3,0,0,0,3
NAGALAND,2008,25,Unemployed,0,0,0,0,0,0,0,0,0,0,0,0,0,0,0,0,0,0
NAGALAND,2008,25,Professional Activity,0,0,0,0,0,0,0,0,0,0,0,0,0,0,0,0,0,0
NAGALAND,2008,25,Agriculture (Total),0,0,0,2,0,2,0,0,0,0,0,0,0,0,0,2,0,2
NAGALAND,2008,25,Retired Persons,0,0,0,0,0,0,0,0,0,0,0,0,0,0,0,0,0,0
NAGALAND,2009,25,House Wife,0,0,0,0,0,0,0,1,1,0,0,2,0,1,1,0,0,2
NAGALAND,2009,25,Service (Government),0,1,2,2,0,5,0,0,0,0,0,0,0,1,2,2,0,5
NAGALAND,2009,25,Service (Private),0,0,0,0,0,0,0,0,0,0,0,0,0,0,0,0,0,0
NAGALAND,2009,25,Public Sector Undertaking,0,0,0,0,0,0,0,0,0,0,0,0,0,0,0,0,0,0
NAGALAND,2009,25,Students,0,2,0,0,0,2,0,0,0,0,0,0,0,2,0,0,0,2
NAGALAND,2009,25,Unemployed,0,0,0,0,0,0,0,0,0,0,0,0,0,0,0,0,0,0
NAGALAND,2009,25,Professional Activity,0,0,0,0,0,0,0,0,0,0,0,0,0,0,0,0,0,0
NAGALAND,2009,25,Agriculture (Total),0,0,0,0,0,0,0,1,0,0,0,1,0,1,0,0,0,1
NAGALAND,2009,25,Retired Persons,0,0,0,0,0,0,0,0,0,0,0,0,0,0,0,0,0,0
NAGALAND,2010,25,House Wife,0,0,0,0,0,0,0,1,0,0,0,1,0,1,0,0,0,1
NAGALAND,2010,25,Service (Government),0,1,0,1,0,2,0,0,0,0,0,0,0,1,0,1,0,2
NAGALAND,2010,25,Service (Private),0,0,0,0,0,0,0,0,0,0,0,0,0,0,0,0,0,0
NAGALAND,2010,25,Public Sector Undertaking,0,0,0,0,0,0,0,0,0,0,0,0,0,0,0,0,0,0
NAGALAND,2010,25,Students,0,0,2,0,0,2,0,0,0,0,0,0,0,0,2,0,0,2
NAGALAND,2010,25,Unemployed,0,2,2,0,0,4,0,0,0,0,0,0,0,2,2,0,0,4
NAGALAND,2010,25,Professional Activity,0,1,2,0,0,3,0,0,0,0,0,0,0,1,2,0,0,3
NAGALAND,2010,25,Agriculture (Total),0,0,0,0,0,0,0,0,0,0,0,0,0,0,0,0,0,0
NAGALAND,2010,25,Retired Persons,0,0,0,0,0,0,0,0,0,0,0,0,0,0,0,0,0,0
NAGALAND,2011,25,House Wife,0,0,0,0,0,0,0,2,2,0,0,4,0,2,2,0,0,4
NAGALAND,2011,25,Service (Government),0,1,6,0,0,7,0,0,0,0,0,0,0,1,6,0,0,7
NAGALAND,2011,25,Service (Private),0,0,0,0,0,0,0,0,0,0,0,0,0,0,0,0,0,0
NAGALAND,2011,25,Public Sector Undertaking,0,0,0,0,0,0,0,0,0,0,0,0,0,0,0,0,0,0
NAGALAND,2011,25,Students,0,0,0,0,0,0,0,2,0,0,0,2,0,2,0,0,0,2
NAGALAND,2011,25,Unemployed,0,0,1,0,0,1,0,0,0,0,0,0,0,0,1,0,0,1
NAGALAND,2011,25,Professional Activity,0,1,3,5,0,9,0,0,0,0,0,0,0,1,3,5,0,9
NAGALAND,2011,25,Agriculture (Total),0,1,0,1,0,2,0,0,0,0,0,0,0,1,0,1,0,2
NAGALAND,2011,25,Retired Persons,0,0,0,0,0,0,0,0,0,0,0,0,0,0,0,0,0,0
NAGALAND,2012,25,House Wife,0,0,0,0,0,0,0,2,1,0,0,3,0,2,1,0,0,3
NAGALAND,2012,25,Service (Government),0,3,2,1,0,6,0,0,0,0,0,0,0,3,2,1,0,6
NAGALAND,2012,25,Service (Private),0,0,0,0,0,0,0,0,0,0,0,0,0,0,0,0,0,0
NAGALAND,2012,25,Public Sector Undertaking,0,0,0,0,0,0,0,0,0,0,0,0,0,0,0,0,0,0
NAGALAND,2012,25,Students,0,2,0,0,0,2,1,1,0,0,0,2,1,3,0,0,0,4
NAGALAND,2012,25,Unemployed,0,0,1,0,0,1,0,0,0,0,0,0,0,0,1,0,0,1
NAGALAND,2012,25,Professional Activity,0,0,2,1,0,3,0,0,0,0,0,0,0,0,2,1,0,3
NAGALAND,2012,25,Agriculture (Total),0,4,2,2,0,8,0,1,0,0,0,1,0,5,2,2,0,9
NAGALAND,2012,25,Retired Persons,0,0,0,0,0,0,0,0,0,0,0,0,0,0,0,0,0,0
NAGALAND,2013,25,House Wife,0,0,0,0,0,0,0,3,0,1,2,6,0,3,0,1,2,6
NAGALAND,2013,25,Service (Government),0,0,4,0,0,4,0,0,0,0,0,0,0,0,4,0,0,4
NAGALAND,2013,25,Service (Private),0,0,0,0,0,0,0,0,0,0,0,0,0,0,0,0,0,0
NAGALAND,2013,25,Public Sector Undertaking,0,0,0,0,0,0,0,0,0,0,0,0,0,0,0,0,0,0
NAGALAND,2013,25,Students,1,2,0,0,0,3,0,3,0,0,0,3,1,5,0,0,0,6
NAGALAND,2013,25,Unemployed,0,0,2,0,0,2,0,0,0,0,0,0,0,0,2,0,0,2
NAGALAND,2013,25,Professional Activity,0,2,0,0,0,2,0,0,0,0,0,0,0,2,0,0,0,2
NAGALAND,2013,25,Agriculture (Total),0,0,1,0,1,2,0,0,0,0,0,0,0,0,1,0,1,2
NAGALAND,2013,25,Retired Persons,0,0,0,0,0,0,0,0,0,0,0,0,0,0,0,0,0,0
NAGALAND,2014,25,House Wife,0,0,0,0,0,0,0,1,0,0,0,1,0,1,0,0,0,1
NAGALAND,2014,25,Service (Government),0,0,2,0,0,2,0,0,0,0,0,0,0,0,2,0,0,2
NAGALAND,2014,25,Service (Private),0,0,0,0,0,0,0,0,0,0,0,0,0,0,0,0,0,0
NAGALAND,2014,25,Public Sector Undertaking,0,0,0,0,0,0,0,0,0,0,0,0,0,0,0,0,0,0
NAGALAND,2014,25,Students,0,1,0,0,0,1,0,1,0,0,0,1,0,2,0,0,0,2
NAGALAND,2014,25,Unemployed,0,2,0,0,0,2,0,1,1,0,0,2,0,3,1,0,0,4
NAGALAND,2014,25,Agriculture (Total),0,0,0,0,0,0,0,0,0,0,0,0,0,0,0,0,0,0
NAGALAND,2014,25,Retired Persons,0,0,0,0,0,0,0,0,0,0,0,0,0,0,0,0,0,0
ODISHA,2001,26,House Wife,0,0,0,0,0,0,2,347,330,135,26,840,2,347,330,135,26,840
ODISHA,2001,26,Service (Government),0,23,25,8,0,56,0,13,6,1,0,20,0,36,31,9,0,76
ODISHA,2001,26,Service (Private),0,58,52,32,8,150,0,49,27,7,0,83,0,107,79,39,8,233
ODISHA,2001,26,Public Sector Undertaking,0,16,20,5,0,41,0,13,17,2,2,34,0,29,37,7,2,75
ODISHA,2001,26,Students,24,111,9,0,0,144,27,94,0,1,2,124,51,205,9,1,2,268
ODISHA,2001,26,Unemployed,0,87,100,26,7,220,0,67,33,1,0,101,0,154,133,27,7,321
ODISHA,2001,26,Professional Activity,0,10,13,6,2,31,0,4,0,0,2,6,0,14,13,6,4,37
ODISHA,2001,26,Agriculture (Total),0,56,87,47,17,207,0,22,18,8,1,49,0,78,105,55,18,256
ODISHA,2001,26,Retired Persons,0,2,0,13,11,26,0,0,0,0,2,2,0,2,0,13,13,28
ODISHA,2002,26,House Wife,0,0,0,0,0,0,0,328,274,125,43,770,0,328,274,125,43,770
ODISHA,2002,26,Service (Government),0,13,14,20,0,47,0,18,22,10,1,51,0,31,36,30,1,98
ODISHA,2002,26,Service (Private),6,105,123,93,16,343,0,24,19,8,0,51,6,129,142,101,16,394
ODISHA,2002,26,Public Sector Undertaking,0,21,44,55,4,124,0,10,16,14,0,40,0,31,60,69,4,164
ODISHA,2002,26,Students,19,112,20,8,0,159,27,90,2,1,0,120,46,202,22,9,0,279
ODISHA,2002,26,Unemployed,2,135,151,59,5,352,1,73,76,8,1,159,3,208,227,67,6,511
ODISHA,2002,26,Professional Activity,0,11,20,21,4,56,0,3,1,0,0,4,0,14,21,21,4,60
ODISHA,2002,26,Agriculture (Total),0,79,123,69,38,309,0,9,14,10,3,36,0,88,137,79,41,345
ODISHA,2002,26,Retired Persons,0,0,0,3,11,14,0,0,4,2,0,6,0,0,4,5,11,20
ODISHA,2003,26,House Wife,0,0,0,0,0,0,0,306,205,110,26,647,0,306,205,110,26,647
ODISHA,2003,26,Service (Government),1,20,17,24,0,62,0,43,36,12,0,91,1,63,53,36,0,153
ODISHA,2003,26,Service (Private),5,149,102,107,14,377,0,30,30,21,3,84,5,179,132,128,17,461
ODISHA,2003,26,Public Sector Undertaking,0,21,29,56,0,106,0,10,4,0,0,14,0,31,33,56,0,120
ODISHA,2003,26,Students,16,101,17,13,0,147,22,86,3,1,0,112,38,187,20,14,0,259
ODISHA,2003,26,Unemployed,0,145,116,33,3,297,2,75,47,8,0,132,2,220,163,41,3,429
ODISHA,2003,26,Professional Activity,0,26,17,12,0,55,0,6,9,7,0,22,0,32,26,19,0,77
ODISHA,2003,26,Agriculture (Total),1,101,136,69,17,324,0,21,10,10,0,41,1,122,146,79,17,365
ODISHA,2003,26,Retired Persons,0,3,1,0,37,41,0,0,4,4,1,9,0,3,5,4,38,50
ODISHA,2004,26,House Wife,0,0,0,0,0,0,0,291,214,103,12,620,0,291,214,103,12,620
ODISHA,2004,26,Service (Government),0,9,16,10,0,35,0,1,3,2,0,6,0,10,19,12,0,41
ODISHA,2004,26,Service (Private),0,30,75,52,5,162,0,25,20,4,10,59,0,55,95,56,15,221
ODISHA,2004,26,Public Sector Undertaking,0,22,24,24,0,70,0,9,9,3,0,21,0,31,33,27,0,91
ODISHA,2004,26,Students,36,91,18,0,0,145,28,87,6,0,0,121,64,178,24,0,0,266
ODISHA,2004,26,Unemployed,8,99,102,37,1,247,13,46,29,15,1,104,21,145,131,52,2,351
ODISHA,2004,26,Professional Activity,0,10,27,20,4,61,0,0,7,0,4,11,0,10,34,20,8,72
ODISHA,2004,26,Agriculture (Total),0,88,109,75,27,299,1,34,33,10,2,80,1,122,142,85,29,379
ODISHA,2004,26,Retired Persons,0,0,0,1,29,30,0,0,0,7,0,7,0,0,0,8,29,37
ODISHA,2005,26,House Wife,0,0,0,0,0,0,0,247,237,89,14,587,0,247,237,89,14,587
ODISHA,2005,26,Service (Government),0,16,26,12,0,54,0,7,18,1,0,26,0,23,44,13,0,80
ODISHA,2005,26,Service (Private),0,31,25,31,1,88,0,33,32,20,3,88,0,64,57,51,4,176
ODISHA,2005,26,Public Sector Undertaking,0,29,34,25,1,89,0,7,8,8,0,23,0,36,42,33,1,112
ODISHA,2005,26,Students,28,111,10,0,0,149,26,85,2,0,0,113,54,196,12,0,0,262
ODISHA,2005,26,Unemployed,0,101,136,35,6,278,2,44,49,9,6,110,2,145,185,44,12,388
ODISHA,2005,26,Professional Activity,0,19,27,32,2,80,0,8,8,7,2,25,0,27,35,39,4,105
ODISHA,2005,26,Agriculture (Total),0,38,86,61,19,204,0,13,22,15,0,50,0,51,108,76,19,254
ODISHA,2005,26,Retired Persons,0,0,0,0,10,10,0,0,0,0,2,2,0,0,0,0,12,12
ODISHA,2006,26,House Wife,0,0,0,0,0,0,0,254,191,64,22,531,0,254,191,64,22,531
ODISHA,2006,26,Service (Government),0,6,8,4,0,18,0,4,1,0,0,5,0,10,9,4,0,23
ODISHA,2006,26,Service (Private),0,45,51,30,7,133,0,37,32,23,0,92,0,82,83,53,7,225
ODISHA,2006,26,Public Sector Undertaking,0,8,16,8,0,32,0,8,9,0,0,17,0,16,25,8,0,49
ODISHA,2006,26,Students,18,80,14,0,0,112,29,98,32,0,0,159,47,178,46,0,0,271
ODISHA,2006,26,Unemployed,0,128,136,32,11,307,0,57,33,10,0,100,0,185,169,42,11,407
ODISHA,2006,26,Professional Activity,2,23,29,26,3,83,1,12,2,2,0,17,3,35,31,28,3,100
ODISHA,2006,26,Agriculture (Total),2,76,79,53,31,241,0,7,12,15,8,42,2,83,91,68,39,283
ODISHA,2006,26,Retired Persons,0,0,0,2,16,18,0,0,0,0,1,1,0,0,0,2,17,19
ODISHA,2007,26,House Wife,0,0,0,0,0,0,0,322,212,66,14,614,0,322,212,66,14,614
ODISHA,2007,26,Service (Government),0,6,8,12,0,26,0,1,5,0,0,6,0,7,13,12,0,32
ODISHA,2007,26,Service (Private),0,82,82,48,2,214,0,26,31,29,3,89,0,108,113,77,5,303
ODISHA,2007,26,Public Sector Undertaking,0,34,48,26,4,112,0,17,3,8,0,28,0,51,51,34,4,140
ODISHA,2007,26,Students,26,109,0,0,0,135,24,75,0,0,0,99,50,184,0,0,0,234
ODISHA,2007,26,Unemployed,12,98,62,40,12,224,5,93,73,5,1,177,17,191,135,45,13,401
ODISHA,2007,26,Professional Activity,0,29,29,21,3,82,0,6,16,3,0,25,0,35,45,24,3,107
ODISHA,2007,26,Agriculture (Total),2,42,61,48,17,170,3,17,21,16,13,70,5,59,82,64,30,240
ODISHA,2007,26,Retired Persons,0,0,0,6,25,31,0,0,0,0,5,5,0,0,0,6,30,36
ODISHA,2008,26,House Wife,0,0,0,0,0,0,0,250,259,113,57,679,0,250,259,113,57,679
ODISHA,2008,26,Service (Government),0,0,2,7,0,9,0,9,2,2,0,13,0,9,4,9,0,22
ODISHA,2008,26,Service (Private),2,77,117,68,8,272,3,43,35,4,2,87,5,120,152,72,10,359
ODISHA,2008,26,Public Sector Undertaking,0,53,42,11,2,108,0,19,9,0,0,28,0,72,51,11,2,136
ODISHA,2008,26,Students,27,95,9,0,0,131,23,60,3,0,0,86,50,155,12,0,0,217
ODISHA,2008,26,Unemployed,26,201,124,91,8,450,3,71,28,8,0,110,29,272,152,99,8,560
ODISHA,2008,26,Professional Activity,1,19,84,19,8,131,0,8,6,2,2,18,1,27,90,21,10,149
ODISHA,2008,26,Agriculture (Total),7,77,101,41,19,245,0,1,10,3,1,15,7,78,111,44,20,260
ODISHA,2008,26,Retired Persons,0,0,0,13,23,36,0,0,0,1,6,7,0,0,0,14,29,43
ODISHA,2009,26,House Wife,0,0,0,0,0,0,0,254,261,92,20,627,0,254,261,92,20,627
ODISHA,2009,26,Service (Government),0,9,6,17,1,33,0,8,2,1,0,11,0,17,8,18,1,44
ODISHA,2009,26,Service (Private),0,83,93,45,17,238,0,53,35,13,0,101,0,136,128,58,17,339
ODISHA,2009,26,Public Sector Undertaking,0,52,39,17,11,119,0,12,27,17,0,56,0,64,66,34,11,175
ODISHA,2009,26,Students,20,140,1,0,0,161,26,105,1,0,0,132,46,245,2,0,0,293
ODISHA,2009,26,Unemployed,16,133,139,75,11,374,10,66,19,17,2,114,26,199,158,92,13,488
ODISHA,2009,26,Professional Activity,0,11,17,9,0,37,0,5,3,0,3,11,0,16,20,9,3,48
ODISHA,2009,26,Agriculture (Total),0,35,56,40,12,143,0,6,1,4,0,11,0,41,57,44,12,154
ODISHA,2009,26,Retired Persons,0,0,0,17,28,45,0,0,0,0,12,12,0,0,0,17,40,57
ODISHA,2010,26,House Wife,0,0,0,0,0,0,1,362,232,111,24,730,1,362,232,111,24,730
ODISHA,2010,26,Service (Government),0,2,7,2,0,11,0,2,1,1,0,4,0,4,8,3,0,15
ODISHA,2010,26,Service (Private),0,74,114,70,11,269,0,30,25,4,4,63,0,104,139,74,15,332
ODISHA,2010,26,Public Sector Undertaking,0,57,39,14,0,110,0,13,16,6,0,35,0,70,55,20,0,145
ODISHA,2010,26,Students,30,138,5,0,0,173,22,104,2,0,0,128,52,242,7,0,0,301
ODISHA,2010,26,Unemployed,11,142,103,36,2,294,7,47,25,7,4,90,18,189,128,43,6,384
ODISHA,2010,26,Professional Activity,0,15,34,15,10,74,0,2,3,2,2,9,0,17,37,17,12,83
ODISHA,2010,26,Agriculture (Total),0,17,77,36,15,145,0,0,12,5,0,17,0,17,89,41,15,162
ODISHA,2010,26,Retired Persons,0,0,0,1,23,24,0,0,0,1,2,3,0,0,0,2,25,27
ODISHA,2011,26,House Wife,0,0,0,0,0,0,0,352,314,132,31,829,0,352,314,132,31,829
ODISHA,2011,26,Service (Government),0,5,13,16,0,34,0,2,3,3,0,8,0,7,16,19,0,42
ODISHA,2011,26,Service (Private),4,96,154,69,11,334,0,37,41,14,3,95,4,133,195,83,14,429
ODISHA,2011,26,Public Sector Undertaking,0,54,65,23,1,143,0,15,13,5,0,33,0,69,78,28,1,176
ODISHA,2011,26,Students,36,163,9,0,0,208,37,117,6,0,0,160,73,280,15,0,0,368
ODISHA,2011,26,Unemployed,32,149,149,49,2,381,11,65,48,19,6,149,43,214,197,68,8,530
ODISHA,2011,26,Professional Activity,0,29,64,17,2,112,0,5,4,0,0,9,0,34,68,17,2,121
ODISHA,2011,26,Agriculture (Total),0,35,44,52,7,138,0,0,3,3,0,6,0,35,47,55,7,144
ODISHA,2011,26,Retired Persons,0,0,0,4,31,35,0,0,0,4,6,10,0,0,0,8,37,45
ODISHA,2012,26,House Wife,0,0,0,0,0,0,0,363,362,124,21,870,0,363,362,124,21,870
ODISHA,2012,26,Service (Government),0,12,11,4,1,28,1,8,18,6,3,36,1,20,29,10,4,64
ODISHA,2012,26,Service (Private),5,109,141,84,7,346,2,43,69,22,5,141,7,152,210,106,12,487
ODISHA,2012,26,Public Sector Undertaking,0,34,34,21,0,89,8,7,13,10,0,38,8,41,47,31,0,127
ODISHA,2012,26,Students,28,165,24,16,0,233,49,115,26,0,0,190,77,280,50,16,0,423
ODISHA,2012,26,Unemployed,10,158,186,68,2,424,7,49,50,22,2,130,17,207,236,90,4,554
ODISHA,2012,26,Professional Activity,0,8,97,35,10,150,0,2,9,2,0,13,0,10,106,37,10,163
ODISHA,2012,26,Agriculture (Total),0,14,45,53,9,121,1,10,6,8,0,25,1,24,51,61,9,146
ODISHA,2012,26,Retired Persons,0,5,5,16,19,45,2,4,0,3,6,15,2,9,5,19,25,60
ODISHA,2013,26,House Wife,0,0,0,0,0,0,0,236,261,137,51,685,0,236,261,137,51,685
ODISHA,2013,26,Service (Government),0,13,41,16,3,73,0,5,8,7,0,20,0,18,49,23,3,93
ODISHA,2013,26,Service (Private),0,98,148,80,32,358,2,32,47,15,8,104,2,130,195,95,40,462
ODISHA,2013,26,Public Sector Undertaking,0,35,42,36,5,118,0,9,17,8,0,34,0,44,59,44,5,152
ODISHA,2013,26,Students,30,143,0,0,0,173,30,110,0,0,0,140,60,253,0,0,0,313
ODISHA,2013,26,Unemployed,0,129,139,58,21,347,0,54,31,8,0,93,0,183,170,66,21,440
ODISHA,2013,26,Professional Activity,0,5,12,18,1,36,0,0,2,1,0,3,0,5,14,19,1,39
ODISHA,2013,26,Agriculture (Total),0,18,58,51,16,143,0,2,1,2,2,7,0,20,59,53,18,150
ODISHA,2013,26,Retired Persons,0,0,0,0,13,13,0,0,0,0,4,4,0,0,0,0,17,17
ODISHA,2014,26,House Wife,0,0,0,0,0,0,0,242,252,104,15,613,0,242,252,104,15,613
ODISHA,2014,26,Service (Government),0,27,41,16,0,84,0,62,33,8,0,103,0,89,74,24,0,187
ODISHA,2014,26,Service (Private),0,57,29,23,0,109,0,61,49,51,0,161,0,118,78,74,0,270
ODISHA,2014,26,Public Sector Undertaking,0,12,20,19,0,51,0,1,2,3,0,6,0,13,22,22,0,57
ODISHA,2014,26,Students,7,159,5,0,0,171,11,135,6,0,2,154,18,294,11,0,2,325
ODISHA,2014,26,Unemployed,0,132,118,21,15,286,0,42,24,3,5,74,0,174,142,24,20,360
ODISHA,2014,26,Agriculture (Total),0,13,37,35,13,98,0,0,4,0,0,4,0,13,41,35,13,102
ODISHA,2014,26,Retired Persons,0,0,0,0,4,4,0,0,0,0,0,0,0,0,0,0,4,4
PUDUCHERRY,2001,27,House Wife,0,0,0,0,0,0,0,63,46,18,7,134,0,63,46,18,7,134
PUDUCHERRY,2001,27,Service (Government),0,0,5,0,0,5,0,0,0,1,0,1,0,0,5,1,0,6
PUDUCHERRY,2001,27,Service (Private),0,26,44,22,2,94,0,5,1,0,0,6,0,31,45,22,2,100
PUDUCHERRY,2001,27,Public Sector Undertaking,0,0,1,3,0,4,0,0,0,1,0,1,0,0,1,4,0,5
PUDUCHERRY,2001,27,Students,2,7,0,0,0,9,4,18,0,0,0,22,6,25,0,0,0,31
PUDUCHERRY,2001,27,Unemployed,0,14,6,5,26,51,2,27,3,0,0,32,2,41,9,5,26,83
PUDUCHERRY,2001,27,Professional Activity,0,0,0,0,0,0,0,0,0,0,0,0,0,0,0,0,0,0
PUDUCHERRY,2001,27,Agriculture (Total),0,10,28,35,10,83,0,5,1,2,0,8,0,15,29,37,10,91
PUDUCHERRY,2001,27,Retired Persons,0,0,0,0,0,0,0,0,0,0,0,0,0,0,0,0,0,0
PUDUCHERRY,2002,27,House Wife,0,0,0,0,0,0,0,35,34,22,12,103,0,35,34,22,12,103
PUDUCHERRY,2002,27,Service (Government),0,3,5,9,1,18,0,0,1,0,0,1,0,3,6,9,1,19
PUDUCHERRY,2002,27,Service (Private),0,48,84,54,17,203,0,7,2,0,1,10,0,55,86,54,18,213
PUDUCHERRY,2002,27,Public Sector Undertaking,0,0,5,2,0,7,0,0,0,0,0,0,0,0,5,2,0,7
PUDUCHERRY,2002,27,Students,5,8,0,0,0,13,3,12,0,0,0,15,8,20,0,0,0,28
PUDUCHERRY,2002,27,Unemployed,0,18,11,2,9,40,0,19,1,0,0,20,0,37,12,2,9,60
PUDUCHERRY,2002,27,Professional Activity,0,0,0,0,0,0,0,0,0,0,0,0,0,0,0,0,0,0
PUDUCHERRY,2002,27,Agriculture (Total),0,14,35,26,8,83,0,1,3,0,1,5,0,15,38,26,9,88
PUDUCHERRY,2002,27,Retired Persons,0,0,2,2,0,4,0,0,0,1,2,3,0,0,2,3,2,7
PUDUCHERRY,2003,27,House Wife,0,0,0,0,0,0,0,49,28,14,17,108,0,49,28,14,17,108
PUDUCHERRY,2003,27,Service (Government),0,1,3,4,0,8,0,1,1,0,0,2,0,2,4,4,0,10
PUDUCHERRY,2003,27,Service (Private),0,9,5,2,1,17,0,10,0,0,0,10,0,19,5,2,1,27
PUDUCHERRY,2003,27,Public Sector Undertaking,0,1,5,4,1,11,0,0,0,0,0,0,0,1,5,4,1,11
PUDUCHERRY,2003,27,Students,3,12,0,0,0,15,0,15,0,0,0,15,3,27,0,0,0,30
PUDUCHERRY,2003,27,Unemployed,0,18,10,9,8,45,0,40,1,0,1,42,0,58,11,9,9,87
PUDUCHERRY,2003,27,Professional Activity,1,21,33,17,1,73,0,1,0,0,0,1,1,22,33,17,1,74
PUDUCHERRY,2003,27,Agriculture (Total),0,1,10,7,3,21,0,2,0,0,0,2,0,3,10,7,3,23
PUDUCHERRY,2003,27,Retired Persons,0,0,0,0,0,0,0,0,0,0,0,0,0,0,0,0,0,0
PUDUCHERRY,2004,27,House Wife,0,0,0,0,0,0,0,38,45,14,8,105,0,38,45,14,8,105
PUDUCHERRY,2004,27,Service (Government),0,1,7,11,0,19,0,2,0,2,0,4,0,3,7,13,0,23
PUDUCHERRY,2004,27,Service (Private),0,13,10,5,0,28,0,3,0,0,0,3,0,16,10,5,0,31
PUDUCHERRY,2004,27,Public Sector Undertaking,0,0,0,0,0,0,0,0,0,0,0,0,0,0,0,0,0,0
PUDUCHERRY,2004,27,Students,1,7,0,0,0,8,4,17,0,0,0,21,5,24,0,0,0,29
PUDUCHERRY,2004,27,Unemployed,0,21,9,9,19,58,0,26,6,2,5,39,0,47,15,11,24,97
PUDUCHERRY,2004,27,Professional Activity,0,7,13,3,2,25,0,0,0,0,0,0,0,7,13,3,2,25
PUDUCHERRY,2004,27,Agriculture (Total),0,21,44,48,6,119,0,11,11,2,2,26,0,32,55,50,8,145
PUDUCHERRY,2004,27,Retired Persons,0,0,0,2,2,4,0,0,0,0,0,0,0,0,0,2,2,4
PUDUCHERRY,2005,27,House Wife,0,0,0,0,0,0,0,48,51,18,9,126,0,48,51,18,9,126
PUDUCHERRY,2005,27,Service (Government),0,1,5,6,0,12,0,0,0,1,0,1,0,1,5,7,0,13
PUDUCHERRY,2005,27,Service (Private),0,16,33,25,1,75,0,10,1,0,0,11,0,26,34,25,1,86
PUDUCHERRY,2005,27,Public Sector Undertaking,0,0,1,0,1,2,0,0,0,0,0,0,0,0,1,0,1,2
PUDUCHERRY,2005,27,Students,1,5,1,0,0,7,2,14,0,0,0,16,3,19,1,0,0,23
PUDUCHERRY,2005,27,Unemployed,0,22,12,21,16,71,0,28,2,0,11,41,0,50,14,21,27,112
PUDUCHERRY,2005,27,Professional Activity,0,1,5,2,0,8,0,0,0,0,0,0,0,1,5,2,0,8
PUDUCHERRY,2005,27,Agriculture (Total),0,28,65,45,6,144,0,1,2,0,0,3,0,29,67,45,6,147
PUDUCHERRY,2005,27,Retired Persons,0,0,0,1,3,4,0,0,0,0,0,0,0,0,0,1,3,4
PUDUCHERRY,2006,27,House Wife,0,0,0,0,0,0,0,47,31,10,8,96,0,47,31,10,8,96
PUDUCHERRY,2006,27,Service (Government),0,1,9,7,0,17,0,1,2,0,0,3,0,2,11,7,0,20
PUDUCHERRY,2006,27,Service (Private),0,18,29,15,2,64,0,5,2,0,0,7,0,23,31,15,2,71
PUDUCHERRY,2006,27,Public Sector Undertaking,0,0,1,2,1,4,0,0,0,0,0,0,0,0,1,2,1,4
PUDUCHERRY,2006,27,Students,5,10,0,0,0,15,8,29,0,0,0,37,13,39,0,0,0,52
PUDUCHERRY,2006,27,Unemployed,0,14,8,9,14,45,0,20,1,2,5,28,0,34,9,11,19,73
PUDUCHERRY,2006,27,Professional Activity,0,0,0,0,0,0,0,0,0,0,0,0,0,0,0,0,0,0
PUDUCHERRY,2006,27,Agriculture (Total),0,35,76,50,8,169,0,1,2,3,0,6,0,36,78,53,8,175
PUDUCHERRY,2006,27,Retired Persons,0,0,0,0,2,2,0,0,0,0,0,0,0,0,0,0,2,2
PUDUCHERRY,2007,27,House Wife,0,0,0,0,0,0,0,48,20,4,6,78,0,48,20,4,6,78
PUDUCHERRY,2007,27,Service (Government),0,0,4,6,0,10,0,3,1,0,0,4,0,3,5,6,0,14
PUDUCHERRY,2007,27,Service (Private),0,6,10,4,0,20,0,3,4,1,0,8,0,9,14,5,0,28
PUDUCHERRY,2007,27,Public Sector Undertaking,0,0,0,0,0,0,0,0,0,0,0,0,0,0,0,0,0,0
PUDUCHERRY,2007,27,Students,1,8,0,0,0,9,5,14,4,0,1,24,6,22,4,0,1,33
PUDUCHERRY,2007,27,Unemployed,0,22,28,9,9,68,0,39,17,2,5,63,0,61,45,11,14,131
PUDUCHERRY,2007,27,Professional Activity,0,0,0,0,0,0,0,0,0,0,0,0,0,0,0,0,0,0
PUDUCHERRY,2007,27,Agriculture (Total),0,33,82,54,12,181,0,9,6,1,0,16,0,42,88,55,12,197
PUDUCHERRY,2007,27,Retired Persons,0,0,0,0,0,0,0,0,0,0,0,0,0,0,0,0,0,0
PUDUCHERRY,2008,27,House Wife,0,0,0,0,0,0,0,45,32,8,12,97,0,45,32,8,12,97
PUDUCHERRY,2008,27,Service (Government),0,3,2,4,0,9,0,2,3,0,1,6,0,5,5,4,1,15
PUDUCHERRY,2008,27,Service (Private),0,2,3,3,1,9,0,2,0,0,0,2,0,4,3,3,1,11
PUDUCHERRY,2008,27,Public Sector Undertaking,0,0,0,0,0,0,0,3,0,0,0,3,0,3,0,0,0,3
PUDUCHERRY,2008,27,Students,2,10,3,0,0,15,0,9,0,0,0,9,2,19,3,0,0,24
PUDUCHERRY,2008,27,Unemployed,0,22,18,9,13,62,0,33,8,0,0,41,0,55,26,9,13,103
PUDUCHERRY,2008,27,Professional Activity,0,0,0,0,0,0,0,0,0,0,0,0,0,0,0,0,0,0
PUDUCHERRY,2008,27,Agriculture (Total),0,2,9,3,0,14,0,2,1,0,0,3,0,4,10,3,0,17
PUDUCHERRY,2008,27,Retired Persons,0,1,0,0,0,1,0,0,0,0,0,0,0,1,0,0,0,1
PUDUCHERRY,2009,27,House Wife,0,0,0,0,0,0,0,50,32,23,6,111,0,50,32,23,6,111
PUDUCHERRY,2009,27,Service (Government),0,2,3,6,0,11,0,0,1,0,0,1,0,2,4,6,0,12
PUDUCHERRY,2009,27,Service (Private),0,7,10,1,1,19,0,12,1,0,0,13,0,19,11,1,1,32
PUDUCHERRY,2009,27,Public Sector Undertaking,0,1,0,3,0,4,0,0,0,0,0,0,0,1,0,3,0,4
PUDUCHERRY,2009,27,Students,2,7,0,0,0,9,4,13,0,0,0,17,6,20,0,0,0,26
PUDUCHERRY,2009,27,Unemployed,0,16,14,20,26,76,0,24,4,2,7,37,0,40,18,22,33,113
PUDUCHERRY,2009,27,Professional Activity,0,18,18,13,0,49,0,2,2,1,0,5,0,20,20,14,0,54
PUDUCHERRY,2009,27,Agriculture (Total),0,38,43,56,9,146,0,2,5,1,0,8,0,40,48,57,9,154
PUDUCHERRY,2009,27,Retired Persons,0,0,0,0,1,1,0,0,0,0,0,0,0,0,0,0,1,1
PUDUCHERRY,2010,27,House Wife,0,0,0,0,0,0,0,44,30,10,11,95,0,44,30,10,11,95
PUDUCHERRY,2010,27,Service (Government),0,1,4,2,1,8,0,2,1,0,0,3,0,3,5,2,1,11
PUDUCHERRY,2010,27,Service (Private),0,10,9,2,0,21,0,12,5,0,0,17,0,22,14,2,0,38
PUDUCHERRY,2010,27,Public Sector Undertaking,0,0,2,2,0,4,0,0,2,0,0,2,0,0,4,2,0,6
PUDUCHERRY,2010,27,Students,2,4,0,0,0,6,2,10,0,0,0,12,4,14,0,0,0,18
PUDUCHERRY,2010,27,Unemployed,0,17,14,13,16,60,0,29,4,0,7,40,0,46,18,13,23,100
PUDUCHERRY,2010,27,Professional Activity,0,34,98,68,5,205,0,2,0,2,1,5,0,36,98,70,6,210
PUDUCHERRY,2010,27,Agriculture (Total),0,0,1,3,0,4,0,0,0,0,0,0,0,0,1,3,0,4
PUDUCHERRY,2010,27,Retired Persons,0,0,0,0,3,3,0,0,0,0,0,0,0,0,0,0,3,3
PUDUCHERRY,2011,27,House Wife,0,0,0,0,0,0,0,45,30,15,7,97,0,45,30,15,7,97
PUDUCHERRY,2011,27,Service (Government),0,1,4,5,0,10,0,1,0,0,0,1,0,2,4,5,0,11
PUDUCHERRY,2011,27,Service (Private),0,15,12,13,2,42,0,6,2,0,0,8,0,21,14,13,2,50
PUDUCHERRY,2011,27,Public Sector Undertaking,0,2,1,2,0,5,0,1,0,1,0,2,0,3,1,3,0,7
PUDUCHERRY,2011,27,Students,2,14,0,0,0,16,7,13,0,0,0,20,9,27,0,0,0,36
PUDUCHERRY,2011,27,Unemployed,0,13,15,19,25,72,0,19,2,1,10,32,0,32,17,20,35,104
PUDUCHERRY,2011,27,Professional Activity,0,32,79,54,5,170,0,0,0,0,0,0,0,32,79,54,5,170
PUDUCHERRY,2011,27,Agriculture (Total),0,0,0,0,0,0,0,0,0,0,0,0,0,0,0,0,0,0
PUDUCHERRY,2011,27,Retired Persons,0,0,0,0,0,0,0,0,0,0,0,0,0,0,0,0,0,0
PUDUCHERRY,2012,27,House Wife,0,0,0,0,0,0,0,32,42,17,12,103,0,32,42,17,12,103
PUDUCHERRY,2012,27,Service (Government),0,5,5,5,1,16,0,2,1,1,0,4,0,7,6,6,1,20
PUDUCHERRY,2012,27,Service (Private),0,4,5,2,0,11,0,9,0,0,0,9,0,13,5,2,0,20
PUDUCHERRY,2012,27,Public Sector Undertaking,0,0,0,0,0,0,0,2,0,0,0,2,0,2,0,0,0,2
PUDUCHERRY,2012,27,Students,0,23,0,0,0,23,4,17,1,0,0,22,4,40,1,0,0,45
PUDUCHERRY,2012,27,Unemployed,0,14,11,13,26,64,0,10,2,1,6,19,0,24,13,14,32,83
PUDUCHERRY,2012,27,Professional Activity,0,23,47,29,6,105,0,0,1,0,0,1,0,23,48,29,6,106
PUDUCHERRY,2012,27,Agriculture (Total),0,0,0,0,0,0,0,0,0,0,0,0,0,0,0,0,0,0
PUDUCHERRY,2012,27,Retired Persons,0,0,0,0,6,6,0,0,0,0,0,0,0,0,0,0,6,6
PUDUCHERRY,2013,27,House Wife,0,0,0,0,0,0,0,26,34,10,18,88,0,26,34,10,18,88
PUDUCHERRY,2013,27,Service (Government),0,5,4,15,0,24,0,0,0,1,0,1,0,5,4,16,0,25
PUDUCHERRY,2013,27,Service (Private),0,14,12,4,4,34,0,10,2,0,0,12,0,24,14,4,4,46
PUDUCHERRY,2013,27,Public Sector Undertaking,0,0,1,0,0,1,0,0,0,0,0,0,0,0,1,0,0,1
PUDUCHERRY,2013,27,Students,3,9,0,0,0,12,2,23,1,0,0,26,5,32,1,0,0,38
PUDUCHERRY,2013,27,Unemployed,0,13,11,22,20,66,0,4,0,1,0,5,0,17,11,23,20,71
PUDUCHERRY,2013,27,Professional Activity,0,0,0,0,0,0,0,0,0,0,0,0,0,0,0,0,0,0
PUDUCHERRY,2013,27,Agriculture (Total),0,0,0,0,0,0,0,0,0,0,0,0,0,0,0,0,0,0
PUDUCHERRY,2013,27,Retired Persons,0,0,0,2,4,6,0,0,0,0,0,0,0,0,0,2,4,6
PUDUCHERRY,2014,27,House Wife,0,0,0,0,0,0,0,21,21,11,6,59,0,21,21,11,6,59
PUDUCHERRY,2014,27,Service (Government),0,0,1,0,0,1,0,0,0,0,0,0,0,0,1,0,0,1
PUDUCHERRY,2014,27,Service (Private),0,6,7,7,1,21,0,0,4,0,0,4,0,6,11,7,1,25
PUDUCHERRY,2014,27,Public Sector Undertaking,0,0,0,0,0,0,0,0,0,0,0,0,0,0,0,0,0,0
PUDUCHERRY,2014,27,Students,2,13,0,0,0,15,1,6,0,0,0,7,3,19,0,0,0,22
PUDUCHERRY,2014,27,Unemployed,0,4,16,9,5,34,0,4,3,0,0,7,0,8,19,9,5,41
PUDUCHERRY,2014,27,Agriculture (Total),0,4,7,5,0,16,0,0,0,0,0,0,0,4,7,5,0,16
PUDUCHERRY,2014,27,Retired Persons,0,0,0,1,8,9,0,0,0,0,0,0,0,0,0,1,8,9
PUNJAB,2001,28,House Wife,0,0,0,0,0,0,0,55,28,6,9,98,0,55,28,6,9,98
PUNJAB,2001,28,Service (Government),0,5,5,3,1,14,0,3,0,0,0,3,0,8,5,3,1,17
PUNJAB,2001,28,Service (Private),0,17,9,4,2,32,0,3,2,1,0,6,0,20,11,5,2,38
PUNJAB,2001,28,Public Sector Undertaking,0,4,2,1,1,8,0,2,1,0,0,3,0,6,3,1,1,11
PUNJAB,2001,28,Students,0,5,0,0,0,5,0,3,0,0,0,3,0,8,0,0,0,8
PUNJAB,2001,28,Unemployed,0,24,15,3,19,61,0,6,4,0,0,10,0,30,19,3,19,71
PUNJAB,2001,28,Professional Activity,1,3,0,1,2,7,0,0,0,0,0,0,1,3,0,1,2,7
PUNJAB,2001,28,Agriculture (Total),0,14,0,9,19,42,0,3,0,0,0,3,0,17,0,9,19,45
PUNJAB,2001,28,Retired Persons,0,0,0,0,6,6,0,0,0,0,0,0,0,0,0,0,6,6
PUNJAB,2002,28,House Wife,0,0,0,0,0,0,0,49,30,6,2,87,0,49,30,6,2,87
PUNJAB,2002,28,Service (Government),0,8,8,3,0,19,0,0,0,0,0,0,0,8,8,3,0,19
PUNJAB,2002,28,Service (Private),0,10,8,5,0,23,0,1,0,0,0,1,0,11,8,5,0,24
PUNJAB,2002,28,Public Sector Undertaking,0,0,7,4,0,11,0,0,0,0,0,0,0,0,7,4,0,11
PUNJAB,2002,28,Students,1,10,0,0,0,11,2,6,0,0,0,8,3,16,0,0,0,19
PUNJAB,2002,28,Unemployed,0,19,13,8,1,41,0,4,0,0,0,4,0,23,13,8,1,45
PUNJAB,2002,28,Professional Activity,0,10,11,1,0,22,0,0,0,0,0,0,0,10,11,1,0,22
PUNJAB,2002,28,Agriculture (Total),0,16,14,1,9,40,0,0,0,0,0,0,0,16,14,1,9,40
PUNJAB,2002,28,Retired Persons,0,0,0,1,2,3,0,0,0,0,0,0,0,0,0,1,2,3
PUNJAB,2003,28,House Wife,0,0,0,0,0,0,0,33,34,5,2,74,0,33,34,5,2,74
PUNJAB,2003,28,Service (Government),0,3,4,3,0,10,0,0,1,1,0,2,0,3,5,4,0,12
PUNJAB,2003,28,Service (Private),0,16,13,2,3,34,0,2,2,0,1,5,0,18,15,2,4,39
PUNJAB,2003,28,Public Sector Undertaking,0,0,2,0,0,2,0,0,0,0,0,0,0,0,2,0,0,2
PUNJAB,2003,28,Students,0,13,1,0,0,14,3,6,0,0,0,9,3,19,1,0,0,23
PUNJAB,2003,28,Unemployed,0,26,17,11,1,55,1,1,1,0,0,3,1,27,18,11,1,58
PUNJAB,2003,28,Professional Activity,0,1,1,0,0,2,0,0,0,0,0,0,0,1,1,0,0,2
PUNJAB,2003,28,Agriculture (Total),0,11,8,6,0,25,0,0,0,1,0,1,0,11,8,7,0,26
PUNJAB,2003,28,Retired Persons,0,0,0,1,6,7,0,0,0,0,0,0,0,0,0,1,6,7
PUNJAB,2004,28,House Wife,0,0,0,0,0,0,0,29,25,3,5,62,0,29,25,3,5,62
PUNJAB,2004,28,Service (Government),0,4,11,1,0,16,0,0,0,0,0,0,0,4,11,1,0,16
PUNJAB,2004,28,Service (Private),0,14,11,6,0,31,2,6,2,0,0,10,2,20,13,6,0,41
PUNJAB,2004,28,Public Sector Undertaking,0,4,12,2,0,18,0,3,0,0,0,3,0,7,12,2,0,21
PUNJAB,2004,28,Students,4,5,0,0,0,9,11,6,0,0,0,17,15,11,0,0,0,26
PUNJAB,2004,28,Unemployed,0,13,10,23,0,46,0,6,4,0,0,10,0,19,14,23,0,56
PUNJAB,2004,28,Professional Activity,0,11,8,5,2,26,0,0,0,0,0,0,0,11,8,5,2,26
PUNJAB,2004,28,Agriculture (Total),0,21,29,18,5,73,0,1,0,0,0,1,0,22,29,18,5,74
PUNJAB,2004,28,Retired Persons,0,0,0,5,3,8,0,0,0,0,0,0,0,0,0,5,3,8
PUNJAB,2005,28,House Wife,0,0,0,0,0,0,0,33,28,15,1,77,0,33,28,15,1,77
PUNJAB,2005,28,Service (Government),0,2,6,6,1,15,0,1,0,0,0,1,0,3,6,6,1,16
PUNJAB,2005,28,Service (Private),0,19,16,0,0,35,0,0,0,0,0,0,0,19,16,0,0,35
PUNJAB,2005,28,Public Sector Undertaking,0,0,2,0,0,2,0,0,0,0,0,0,0,0,2,0,0,2
PUNJAB,2005,28,Students,0,16,0,1,0,17,0,4,0,0,0,4,0,20,0,1,0,21
PUNJAB,2005,28,Unemployed,0,25,13,8,1,47,1,1,3,0,0,5,1,26,16,8,1,52
PUNJAB,2005,28,Professional Activity,0,4,4,5,1,14,0,0,0,0,0,0,0,4,4,5,1,14
PUNJAB,2005,28,Agriculture (Total),0,24,0,17,6,47,0,0,0,0,0,0,0,24,0,17,6,47
PUNJAB,2005,28,Retired Persons,0,0,0,3,5,8,0,0,0,0,0,0,0,0,0,3,5,8
PUNJAB,2006,28,House Wife,0,0,0,0,0,0,1,49,45,15,0,110,1,49,45,15,0,110
PUNJAB,2006,28,Service (Government),0,5,7,4,0,16,0,0,0,0,0,0,0,5,7,4,0,16
PUNJAB,2006,28,Service (Private),0,23,25,7,1,56,0,3,1,0,0,4,0,26,26,7,1,60
PUNJAB,2006,28,Public Sector Undertaking,0,1,2,2,0,5,0,1,0,0,0,1,0,2,2,2,0,6
PUNJAB,2006,28,Students,2,15,1,0,0,18,2,11,0,0,0,13,4,26,1,0,0,31
PUNJAB,2006,28,Unemployed,0,29,22,8,7,66,0,2,0,0,0,2,0,31,22,8,7,68
PUNJAB,2006,28,Professional Activity,0,18,10,12,7,47,0,0,0,0,0,0,0,18,10,12,7,47
PUNJAB,2006,28,Agriculture (Total),0,27,28,22,8,85,0,0,0,0,0,0,0,27,28,22,8,85
PUNJAB,2006,28,Retired Persons,0,0,0,0,1,1,0,0,0,0,0,0,0,0,0,0,1,1
PUNJAB,2007,28,House Wife,0,0,0,0,0,0,0,62,53,13,4,132,0,62,53,13,4,132
PUNJAB,2007,28,Service (Government),0,9,9,9,0,27,0,1,1,1,0,3,0,10,10,10,0,30
PUNJAB,2007,28,Service (Private),0,22,28,13,0,63,0,3,0,0,0,3,0,25,28,13,0,66
PUNJAB,2007,28,Public Sector Undertaking,0,0,0,0,0,0,0,0,0,0,0,0,0,0,0,0,0,0
PUNJAB,2007,28,Students,2,12,1,0,0,15,6,9,0,0,0,15,8,21,1,0,0,30
PUNJAB,2007,28,Unemployed,0,22,7,7,6,42,0,7,2,0,0,9,0,29,9,7,6,51
PUNJAB,2007,28,Professional Activity,0,9,9,4,1,23,0,1,0,0,0,1,0,10,9,4,1,24
PUNJAB,2007,28,Agriculture (Total),0,21,32,19,14,86,0,0,1,1,0,2,0,21,33,20,14,88
PUNJAB,2007,28,Retired Persons,0,0,0,4,2,6,0,0,0,0,0,0,0,0,0,4,2,6
PUNJAB,2008,28,House Wife,0,0,0,0,0,0,1,66,66,15,8,156,1,66,66,15,8,156
PUNJAB,2008,28,Service (Government),0,4,16,9,0,29,0,0,0,0,0,0,0,4,16,9,0,29
PUNJAB,2008,28,Service (Private),0,35,36,12,0,83,0,2,3,0,0,5,0,37,39,12,0,88
PUNJAB,2008,28,Public Sector Undertaking,0,1,1,0,0,2,0,0,0,0,0,0,0,1,1,0,0,2
PUNJAB,2008,28,Students,2,23,0,1,0,26,3,19,0,0,0,22,5,42,0,1,0,48
PUNJAB,2008,28,Unemployed,0,24,20,7,3,54,0,1,0,0,0,1,0,25,20,7,3,55
PUNJAB,2008,28,Professional Activity,0,4,4,3,2,13,0,0,0,0,0,0,0,4,4,3,2,13
PUNJAB,2008,28,Agriculture (Total),1,18,32,9,6,66,0,0,0,0,0,0,1,18,32,9,6,66
PUNJAB,2008,28,Retired Persons,0,0,0,0,2,2,0,0,0,0,0,0,0,0,0,0,2,2
PUNJAB,2009,28,House Wife,0,0,0,0,0,0,0,64,49,12,5,130,0,64,49,12,5,130
PUNJAB,2009,28,Service (Government),0,1,13,1,0,15,0,0,0,0,0,0,0,1,13,1,0,15
PUNJAB,2009,28,Service (Private),1,20,22,5,6,54,0,3,4,0,0,7,1,23,26,5,6,61
PUNJAB,2009,28,Public Sector Undertaking,0,1,3,0,2,6,0,0,2,0,0,2,0,1,5,0,2,8
PUNJAB,2009,28,Students,7,18,4,0,0,29,4,22,0,0,0,26,11,40,4,0,0,55
PUNJAB,2009,28,Unemployed,0,20,20,2,1,43,0,3,2,0,0,5,0,23,22,2,1,48
PUNJAB,2009,28,Professional Activity,0,5,11,15,0,31,0,0,1,0,0,1,0,5,12,15,0,32
PUNJAB,2009,28,Agriculture (Total),0,38,35,14,6,93,0,2,0,2,0,4,0,40,35,16,6,97
PUNJAB,2009,28,Retired Persons,0,2,5,4,1,12,0,0,0,4,4,8,0,2,5,8,5,20
PUNJAB,2010,28,House Wife,0,0,0,0,0,0,1,60,48,16,5,130,1,60,48,16,5,130
PUNJAB,2010,28,Service (Government),0,5,13,3,0,21,0,2,0,0,0,2,0,7,13,3,0,23
PUNJAB,2010,28,Service (Private),2,27,44,7,2,82,0,0,1,0,0,1,2,27,45,7,2,83
PUNJAB,2010,28,Public Sector Undertaking,0,0,0,0,0,0,0,0,0,0,0,0,0,0,0,0,0,0
PUNJAB,2010,28,Students,4,21,6,0,0,31,1,23,0,0,0,24,5,44,6,0,0,55
PUNJAB,2010,28,Unemployed,3,25,23,5,3,59,0,3,1,0,4,8,3,28,24,5,7,67
PUNJAB,2010,28,Professional Activity,0,13,5,3,0,21,0,0,0,0,0,0,0,13,5,3,0,21
PUNJAB,2010,28,Agriculture (Total),0,27,31,12,10,80,0,0,0,0,0,0,0,27,31,12,10,80
PUNJAB,2010,28,Retired Persons,0,0,0,1,7,8,0,0,0,0,0,0,0,0,0,1,7,8
PUNJAB,2011,28,House Wife,0,0,0,0,0,0,0,72,61,10,5,148,0,72,61,10,5,148
PUNJAB,2011,28,Service (Government),0,13,20,10,0,43,0,0,0,0,0,0,0,13,20,10,0,43
PUNJAB,2011,28,Service (Private),0,52,58,31,7,148,0,6,0,0,0,6,0,58,58,31,7,154
PUNJAB,2011,28,Public Sector Undertaking,0,5,2,1,0,8,0,6,2,0,0,8,0,11,4,1,0,16
PUNJAB,2011,28,Students,0,20,1,0,0,21,0,17,0,0,0,17,0,37,1,0,0,38
PUNJAB,2011,28,Unemployed,0,48,26,12,8,94,0,4,2,0,0,6,0,52,28,12,8,100
PUNJAB,2011,28,Professional Activity,0,3,11,2,1,17,0,0,0,0,0,0,0,3,11,2,1,17
PUNJAB,2011,28,Agriculture (Total),0,33,34,14,13,94,0,0,1,3,0,4,0,33,35,17,13,98
PUNJAB,2011,28,Retired Persons,0,0,2,2,5,9,0,0,0,0,0,0,0,0,2,2,5,9
PUNJAB,2012,28,House Wife,0,0,0,0,0,0,1,71,84,15,2,173,1,71,84,15,2,173
PUNJAB,2012,28,Service (Government),0,6,5,2,0,13,0,1,0,0,0,1,0,7,5,2,0,14
PUNJAB,2012,28,Service (Private),0,68,69,26,6,169,0,2,8,2,0,12,0,70,77,28,6,181
PUNJAB,2012,28,Public Sector Undertaking,0,6,6,1,0,13,0,4,0,0,0,4,0,10,6,1,0,17
PUNJAB,2012,28,Students,5,25,0,0,0,30,1,26,0,0,0,27,6,51,0,0,0,57
PUNJAB,2012,28,Unemployed,0,50,19,10,4,83,0,4,1,2,0,7,0,54,20,12,4,90
PUNJAB,2012,28,Professional Activity,0,6,15,4,0,25,0,0,0,0,0,0,0,6,15,4,0,25
PUNJAB,2012,28,Agriculture (Total),0,23,34,8,10,75,0,0,0,0,0,0,0,23,34,8,10,75
PUNJAB,2012,28,Retired Persons,0,0,1,2,4,7,0,0,0,1,0,1,0,0,1,3,4,8
PUNJAB,2013,28,House Wife,0,0,0,0,0,0,0,73,50,22,11,156,0,73,50,22,11,156
PUNJAB,2013,28,Service (Government),0,5,13,5,0,23,0,1,3,0,0,4,0,6,16,5,0,27
PUNJAB,2013,28,Service (Private),0,55,40,24,6,125,0,11,0,0,0,11,0,66,40,24,6,136
PUNJAB,2013,28,Public Sector Undertaking,0,5,2,0,0,7,0,1,0,0,0,1,0,6,2,0,0,8
PUNJAB,2013,28,Students,4,37,1,0,0,42,2,31,0,0,0,33,6,68,1,0,0,75
PUNJAB,2013,28,Unemployed,0,44,24,6,6,80,0,9,1,2,0,12,0,53,25,8,6,92
PUNJAB,2013,28,Professional Activity,0,7,8,9,0,24,0,1,0,0,0,1,0,8,8,9,0,25
PUNJAB,2013,28,Agriculture (Total),0,33,30,15,5,83,0,0,0,0,0,0,0,33,30,15,5,83
PUNJAB,2013,28,Retired Persons,0,0,1,3,7,11,0,2,0,1,0,3,0,2,1,4,7,14
PUNJAB,2014,28,House Wife,0,0,0,0,0,0,0,73,50,19,4,146,0,73,50,19,4,146
PUNJAB,2014,28,Service (Government),0,12,7,5,4,28,0,0,2,0,0,2,0,12,9,5,4,30
PUNJAB,2014,28,Service (Private),0,14,14,4,0,32,0,2,2,0,0,4,0,16,16,4,0,36
PUNJAB,2014,28,Public Sector Undertaking,0,1,1,0,0,2,0,2,0,0,0,2,0,3,1,0,0,4
PUNJAB,2014,28,Students,2,33,0,0,0,35,1,12,3,0,1,17,3,45,3,0,1,52
PUNJAB,2014,28,Unemployed,0,35,22,10,2,69,0,7,6,0,0,13,0,42,28,10,2,82
PUNJAB,2014,28,Agriculture (Total),1,22,23,12,3,61,0,1,1,1,0,3,1,23,24,13,3,64
PUNJAB,2014,28,Retired Persons,0,0,3,3,1,7,0,0,0,0,0,0,0,0,3,3,1,7
RAJASTHAN,2001,29,House Wife,0,0,0,0,0,0,2,391,265,101,24,783,2,391,265,101,24,783
RAJASTHAN,2001,29,Service (Government),0,14,33,12,0,59,0,2,0,1,0,3,0,16,33,13,0,62
RAJASTHAN,2001,29,Service (Private),0,88,84,36,10,218,0,14,11,2,0,27,0,102,95,38,10,245
RAJASTHAN,2001,29,Public Sector Undertaking,0,24,41,7,0,72,0,4,6,1,0,11,0,28,47,8,0,83
RAJASTHAN,2001,29,Students,34,68,14,5,0,121,30,53,0,0,0,83,64,121,14,5,0,204
RAJASTHAN,2001,29,Unemployed,0,89,70,18,2,179,0,19,2,0,0,21,0,108,72,18,2,200
RAJASTHAN,2001,29,Professional Activity,1,13,14,11,1,40,0,0,0,0,0,0,1,13,14,11,1,40
RAJASTHAN,2001,29,Agriculture (Total),1,156,173,78,16,424,1,38,33,5,4,81,2,194,206,83,20,505
RAJASTHAN,2001,29,Retired Persons,0,0,0,0,8,8,0,0,0,0,0,0,0,0,0,0,8,8
RAJASTHAN,2002,29,House Wife,0,0,0,0,0,0,1,387,248,113,18,767,1,387,248,113,18,767
RAJASTHAN,2002,29,Service (Government),0,12,36,14,0,62,0,0,2,0,0,2,0,12,38,14,0,64
RAJASTHAN,2002,29,Service (Private),0,75,73,71,2,221,0,15,13,2,0,30,0,90,86,73,2,251
RAJASTHAN,2002,29,Public Sector Undertaking,0,20,26,11,2,59,0,1,3,4,0,8,0,21,29,15,2,67
RAJASTHAN,2002,29,Students,22,56,9,0,0,87,6,46,0,0,0,52,28,102,9,0,0,139
RAJASTHAN,2002,29,Unemployed,1,58,41,26,2,128,0,9,6,1,0,16,1,67,47,27,2,144
RAJASTHAN,2002,29,Professional Activity,0,10,9,5,1,25,0,1,0,0,0,1,0,11,9,5,1,26
RAJASTHAN,2002,29,Agriculture (Total),1,154,174,128,36,493,0,35,39,17,3,94,1,189,213,145,39,587
RAJASTHAN,2002,29,Retired Persons,0,0,0,8,9,17,0,0,0,0,2,2,0,0,0,8,11,19
RAJASTHAN,2003,29,House Wife,0,0,0,0,0,0,2,417,336,137,46,938,2,417,336,137,46,938
RAJASTHAN,2003,29,Service (Government),0,3,25,14,0,42,0,2,1,0,0,3,0,5,26,14,0,45
RAJASTHAN,2003,29,Service (Private),0,63,124,61,10,258,0,14,11,2,0,27,0,77,135,63,10,285
RAJASTHAN,2003,29,Public Sector Undertaking,0,22,35,16,0,73,0,11,6,1,0,18,0,33,41,17,0,91
RAJASTHAN,2003,29,Students,24,110,4,0,0,138,13,51,3,0,0,67,37,161,7,0,0,205
RAJASTHAN,2003,29,Unemployed,0,70,66,22,0,158,0,3,0,0,0,3,0,73,66,22,0,161
RAJASTHAN,2003,29,Professional Activity,0,12,22,10,2,46,0,0,0,0,0,0,0,12,22,10,2,46
RAJASTHAN,2003,29,Agriculture (Total),0,195,218,111,38,562,0,34,27,12,1,74,0,229,245,123,39,636
RAJASTHAN,2003,29,Retired Persons,0,0,0,10,8,18,0,0,0,0,0,0,0,0,0,10,8,18
RAJASTHAN,2004,29,House Wife,0,0,0,0,0,0,10,370,333,123,32,868,10,370,333,123,32,868
RAJASTHAN,2004,29,Service (Government),0,4,13,7,0,24,0,1,1,0,0,2,0,5,14,7,0,26
RAJASTHAN,2004,29,Service (Private),0,103,126,47,2,278,0,12,6,6,0,24,0,115,132,53,2,302
RAJASTHAN,2004,29,Public Sector Undertaking,0,19,13,5,0,37,0,2,2,0,0,4,0,21,15,5,0,41
RAJASTHAN,2004,29,Students,30,60,8,0,0,98,10,36,3,0,0,49,40,96,11,0,0,147
RAJASTHAN,2004,29,Unemployed,0,85,79,14,4,182,0,3,1,1,0,5,0,88,80,15,4,187
RAJASTHAN,2004,29,Professional Activity,0,11,11,7,3,32,0,0,0,0,0,0,0,11,11,7,3,32
RAJASTHAN,2004,29,Agriculture (Total),1,207,286,154,27,675,0,27,29,14,4,74,1,234,315,168,31,749
RAJASTHAN,2004,29,Retired Persons,0,0,0,2,0,2,0,0,0,0,0,0,0,0,0,2,0,2
RAJASTHAN,2005,29,House Wife,0,0,0,0,0,0,13,459,408,201,19,1100,13,459,408,201,19,1100
RAJASTHAN,2005,29,Service (Government),0,9,19,10,0,38,0,0,0,0,0,0,0,9,19,10,0,38
RAJASTHAN,2005,29,Service (Private),0,108,107,58,2,275,0,8,3,0,0,11,0,116,110,58,2,286
RAJASTHAN,2005,29,Public Sector Undertaking,0,15,9,6,0,30,0,2,2,0,0,4,0,17,11,6,0,34
RAJASTHAN,2005,29,Students,19,56,0,0,0,75,13,22,2,0,0,37,32,78,2,0,0,112
RAJASTHAN,2005,29,Unemployed,3,57,32,6,2,100,0,2,0,0,0,2,3,59,32,6,2,102
RAJASTHAN,2005,29,Professional Activity,0,12,13,2,0,27,0,0,0,0,0,0,0,12,13,2,0,27
RAJASTHAN,2005,29,Agriculture (Total),11,138,210,65,12,436,0,6,14,5,0,25,11,144,224,70,12,461
RAJASTHAN,2005,29,Retired Persons,0,0,0,2,2,4,0,0,0,0,0,0,0,0,0,2,2,4
RAJASTHAN,2006,29,House Wife,0,0,0,0,0,0,9,487,415,151,31,1093,9,487,415,151,31,1093
RAJASTHAN,2006,29,Service (Government),0,5,21,14,0,40,0,0,0,0,0,0,0,5,21,14,0,40
RAJASTHAN,2006,29,Service (Private),0,119,153,65,1,338,0,6,5,0,0,11,0,125,158,65,1,349
RAJASTHAN,2006,29,Public Sector Undertaking,0,13,11,5,0,29,0,2,2,0,0,4,0,15,13,5,0,33
RAJASTHAN,2006,29,Students,15,53,2,0,0,70,15,49,0,0,0,64,30,102,2,0,0,134
RAJASTHAN,2006,29,Unemployed,0,59,23,14,1,97,0,0,0,0,0,0,0,59,23,14,1,97
RAJASTHAN,2006,29,Professional Activity,0,8,8,3,0,19,0,0,0,0,0,0,0,8,8,3,0,19
RAJASTHAN,2006,29,Agriculture (Total),2,85,147,101,21,356,0,16,18,4,1,39,2,101,165,105,22,395
RAJASTHAN,2006,29,Retired Persons,0,0,0,2,0,2,0,0,1,0,0,1,0,0,1,2,0,3
RAJASTHAN,2007,29,House Wife,0,0,0,0,0,0,9,398,410,177,29,1023,9,398,410,177,29,1023
RAJASTHAN,2007,29,Service (Government),0,5,22,12,0,39,0,10,17,1,1,29,0,15,39,13,1,68
RAJASTHAN,2007,29,Service (Private),6,102,150,82,1,341,0,9,1,0,0,10,6,111,151,82,1,351
RAJASTHAN,2007,29,Public Sector Undertaking,0,11,7,6,0,24,0,5,0,0,0,5,0,16,7,6,0,29
RAJASTHAN,2007,29,Students,28,86,1,0,0,115,13,47,10,0,0,70,41,133,11,0,0,185
RAJASTHAN,2007,29,Unemployed,1,48,86,20,2,157,0,1,2,2,0,5,1,49,88,22,2,162
RAJASTHAN,2007,29,Professional Activity,0,18,16,2,0,36,0,0,3,0,0,3,0,18,19,2,0,39
RAJASTHAN,2007,29,Agriculture (Total),2,153,229,176,29,589,0,9,9,10,1,29,2,162,238,186,30,618
RAJASTHAN,2007,29,Retired Persons,0,0,0,0,0,0,0,0,0,0,0,0,0,0,0,0,0,0
RAJASTHAN,2008,29,House Wife,0,0,0,0,0,0,18,360,389,147,44,958,18,360,389,147,44,958
RAJASTHAN,2008,29,Service (Government),0,13,31,18,1,63,0,13,7,6,0,26,0,26,38,24,1,89
RAJASTHAN,2008,29,Service (Private),0,136,206,86,3,431,0,27,5,3,0,35,0,163,211,89,3,466
RAJASTHAN,2008,29,Public Sector Undertaking,0,6,6,4,1,17,0,1,1,0,0,2,0,7,7,4,1,19
RAJASTHAN,2008,29,Students,29,101,43,0,0,173,13,53,3,0,0,69,42,154,46,0,0,242
RAJASTHAN,2008,29,Unemployed,0,81,65,22,8,176,0,15,12,4,0,31,0,96,77,26,8,207
RAJASTHAN,2008,29,Professional Activity,0,18,24,8,3,53,0,0,0,0,0,0,0,18,24,8,3,53
RAJASTHAN,2008,29,Agriculture (Total),0,156,287,212,40,695,2,33,56,7,3,101,2,189,343,219,43,796
RAJASTHAN,2008,29,Retired Persons,0,5,5,2,1,13,0,0,0,0,0,0,0,5,5,2,1,13
RAJASTHAN,2009,29,House Wife,0,0,0,0,0,0,23,466,410,142,29,1070,23,466,410,142,29,1070
RAJASTHAN,2009,29,Service (Government),0,5,19,11,1,36,0,7,3,0,0,10,0,12,22,11,1,46
RAJASTHAN,2009,29,Service (Private),0,188,217,91,26,522,0,12,2,0,0,14,0,200,219,91,26,536
RAJASTHAN,2009,29,Public Sector Undertaking,0,2,5,9,4,20,0,1,1,1,0,3,0,3,6,10,4,23
RAJASTHAN,2009,29,Students,37,108,1,0,0,146,20,55,2,0,0,77,57,163,3,0,0,223
RAJASTHAN,2009,29,Unemployed,0,77,47,14,1,139,0,5,3,8,1,17,0,82,50,22,2,156
RAJASTHAN,2009,29,Professional Activity,0,8,35,9,0,52,0,0,1,0,0,1,0,8,36,9,0,53
RAJASTHAN,2009,29,Agriculture (Total),7,196,337,190,45,775,0,33,28,12,3,76,7,229,365,202,48,851
RAJASTHAN,2009,29,Retired Persons,0,0,1,1,3,5,0,0,0,0,1,1,0,0,1,1,4,6
RAJASTHAN,2010,29,House Wife,0,0,0,0,0,0,19,426,403,161,25,1034,19,426,403,161,25,1034
RAJASTHAN,2010,29,Service (Government),0,5,20,11,0,36,0,0,6,0,0,6,0,5,26,11,0,42
RAJASTHAN,2010,29,Service (Private),0,135,149,97,22,403,0,16,7,5,0,28,0,151,156,102,22,431
RAJASTHAN,2010,29,Public Sector Undertaking,0,8,10,13,3,34,0,3,3,0,0,6,0,11,13,13,3,40
RAJASTHAN,2010,29,Students,19,118,7,0,0,144,12,75,1,1,0,89,31,193,8,1,0,233
RAJASTHAN,2010,29,Unemployed,0,78,66,24,4,172,0,9,11,7,0,27,0,87,77,31,4,199
RAJASTHAN,2010,29,Professional Activity,0,14,39,2,6,61,0,2,1,1,0,4,0,16,40,3,6,65
RAJASTHAN,2010,29,Agriculture (Total),2,114,146,66,23,351,0,20,13,6,0,39,2,134,159,72,23,390
RAJASTHAN,2010,29,Retired Persons,0,14,7,9,5,35,0,6,0,0,0,6,0,20,7,9,5,41
RAJASTHAN,2011,29,House Wife,0,0,0,0,0,0,9,341,306,101,27,784,9,341,306,101,27,784
RAJASTHAN,2011,29,Service (Government),0,5,16,13,1,35,0,1,6,1,0,8,0,6,22,14,1,43
RAJASTHAN,2011,29,Service (Private),0,196,142,68,7,413,0,21,17,5,2,45,0,217,159,73,9,458
RAJASTHAN,2011,29,Public Sector Undertaking,0,7,8,8,2,25,0,2,3,0,0,5,0,9,11,8,2,30
RAJASTHAN,2011,29,Students,23,128,6,0,0,157,8,68,3,0,0,79,31,196,9,0,0,236
RAJASTHAN,2011,29,Unemployed,0,63,42,9,0,114,0,9,4,1,0,14,0,72,46,10,0,128
RAJASTHAN,2011,29,Professional Activity,0,31,51,20,2,104,0,1,0,0,0,1,0,32,51,20,2,105
RAJASTHAN,2011,29,Agriculture (Total),0,77,77,59,11,224,0,20,15,8,1,44,0,97,92,67,12,268
RAJASTHAN,2011,29,Retired Persons,0,0,1,3,4,8,0,0,0,0,0,0,0,0,1,3,4,8
RAJASTHAN,2012,29,House Wife,0,0,0,0,0,0,1,413,337,106,37,894,1,413,337,106,37,894
RAJASTHAN,2012,29,Service (Government),0,12,19,16,1,48,0,2,3,0,0,5,0,14,22,16,1,53
RAJASTHAN,2012,29,Service (Private),0,153,148,62,7,370,0,12,12,2,2,28,0,165,160,64,9,398
RAJASTHAN,2012,29,Public Sector Undertaking,0,7,8,20,6,41,0,1,2,0,0,3,0,8,10,20,6,44
RAJASTHAN,2012,29,Students,15,119,4,0,0,138,14,84,3,0,1,102,29,203,7,0,1,240
RAJASTHAN,2012,29,Unemployed,0,56,47,21,8,132,1,9,27,6,0,43,1,65,74,27,8,175
RAJASTHAN,2012,29,Professional Activity,0,23,47,26,0,96,0,0,0,1,0,1,0,23,47,27,0,97
RAJASTHAN,2012,29,Agriculture (Total),0,68,88,66,20,242,1,16,7,4,0,28,1,84,95,70,20,270
RAJASTHAN,2012,29,Retired Persons,0,0,1,2,8,11,0,0,0,0,0,0,0,0,1,2,8,11
RAJASTHAN,2013,29,House Wife,0,0,0,0,0,0,2,353,281,109,42,787,2,353,281,109,42,787
RAJASTHAN,2013,29,Service (Government),0,13,16,10,1,40,0,3,1,0,1,5,0,16,17,10,2,45
RAJASTHAN,2013,29,Service (Private),0,162,166,83,5,416,0,11,13,4,2,30,0,173,179,87,7,446
RAJASTHAN,2013,29,Public Sector Undertaking,0,7,5,3,0,15,0,1,3,0,0,4,0,8,8,3,0,19
RAJASTHAN,2013,29,Students,20,117,9,0,0,146,10,88,12,0,0,110,30,205,21,0,0,256
RAJASTHAN,2013,29,Unemployed,0,58,83,33,7,181,0,11,14,7,2,34,0,69,97,40,9,215
RAJASTHAN,2013,29,Professional Activity,0,11,40,29,1,81,0,0,1,0,0,1,0,11,41,29,1,82
RAJASTHAN,2013,29,Agriculture (Total),0,96,99,56,16,267,0,14,9,2,0,25,0,110,108,58,16,292
RAJASTHAN,2013,29,Retired Persons,0,0,1,3,6,10,0,0,0,0,0,0,0,0,1,3,6,10
RAJASTHAN,2014,29,House Wife,0,0,0,0,0,0,2,327,267,74,14,684,2,327,267,74,14,684
RAJASTHAN,2014,29,Service (Government),0,14,20,14,0,48,0,4,7,1,0,12,0,18,27,15,0,60
RAJASTHAN,2014,29,Service (Private),0,36,33,12,1,82,0,7,5,4,0,16,0,43,38,16,1,98
RAJASTHAN,2014,29,Public Sector Undertaking,0,7,5,1,0,13,0,1,0,0,0,1,0,8,5,1,0,14
RAJASTHAN,2014,29,Students,8,111,1,0,0,120,7,73,0,0,0,80,15,184,1,0,0,200
RAJASTHAN,2014,29,Unemployed,1,63,47,33,12,156,0,5,0,1,0,6,1,68,47,34,12,162
RAJASTHAN,2014,29,Agriculture (Total),0,129,140,81,7,357,0,9,6,1,0,16,0,138,146,82,7,373
RAJASTHAN,2014,29,Retired Persons,0,2,3,1,5,11,0,0,0,0,0,0,0,2,3,1,5,11
SIKKIM,2001,30,House Wife,0,0,0,0,0,0,0,2,10,0,0,12,0,2,10,0,0,12
SIKKIM,2001,30,Service (Government),0,1,1,0,0,2,0,2,1,0,0,3,0,3,2,0,0,5
SIKKIM,2001,30,Service (Private),0,3,4,0,0,7,0,0,0,0,0,0,0,3,4,0,0,7
SIKKIM,2001,30,Public Sector Undertaking,0,1,0,0,0,1,0,0,0,0,0,0,0,1,0,0,0,1
SIKKIM,2001,30,Students,0,1,0,0,0,1,2,2,0,0,0,4,2,3,0,0,0,5
SIKKIM,2001,30,Unemployed,0,4,3,0,1,8,0,3,1,0,0,4,0,7,4,0,1,12
SIKKIM,2001,30,Professional Activity,0,2,6,0,0,8,0,3,4,0,0,7,0,5,10,0,0,15
SIKKIM,2001,30,Agriculture (Total),0,6,4,4,2,16,0,2,0,0,0,2,0,8,4,4,2,18
SIKKIM,2001,30,Retired Persons,0,0,0,0,0,0,0,0,0,0,0,0,0,0,0,0,0,0
SIKKIM,2002,30,House Wife,0,0,0,0,0,0,0,1,0,0,0,1,0,1,0,0,0,1
SIKKIM,2002,30,Service (Government),0,0,0,0,0,0,0,0,0,0,0,0,0,0,0,0,0,0
SIKKIM,2002,30,Service (Private),0,0,0,0,0,0,0,0,0,0,0,0,0,0,0,0,0,0
SIKKIM,2002,30,Public Sector Undertaking,0,0,0,0,0,0,0,0,0,0,0,0,0,0,0,0,0,0
SIKKIM,2002,30,Students,1,2,0,0,0,3,0,2,0,0,0,2,1,4,0,0,0,5
SIKKIM,2002,30,Unemployed,0,4,3,2,1,10,1,3,4,2,2,12,1,7,7,4,3,22
SIKKIM,2002,30,Professional Activity,0,0,0,0,0,0,0,0,0,0,0,0,0,0,0,0,0,0
SIKKIM,2002,30,Agriculture (Total),0,2,2,1,0,5,0,2,0,1,0,3,0,4,2,2,0,8
SIKKIM,2002,30,Retired Persons,0,3,0,0,0,3,0,0,0,0,0,0,0,3,0,0,0,3
SIKKIM,2003,30,House Wife,0,0,0,0,0,0,0,7,5,4,5,21,0,7,5,4,5,21
SIKKIM,2003,30,Service (Government),0,0,3,2,1,6,0,0,3,0,0,3,0,0,6,2,1,9
SIKKIM,2003,30,Service (Private),0,4,2,4,3,13,0,0,0,0,0,0,0,4,2,4,3,13
SIKKIM,2003,30,Public Sector Undertaking,0,0,0,0,0,0,0,0,0,0,0,0,0,0,0,0,0,0
SIKKIM,2003,30,Students,1,7,0,0,1,9,0,1,0,0,0,1,1,8,0,0,1,10
SIKKIM,2003,30,Unemployed,0,6,5,0,1,12,0,1,0,0,0,1,0,7,5,0,1,13
SIKKIM,2003,30,Professional Activity,0,0,0,0,0,0,0,0,0,0,0,0,0,0,0,0,0,0
SIKKIM,2003,30,Agriculture (Total),0,8,3,4,5,20,0,0,0,7,4,11,0,8,3,11,9,31
SIKKIM,2003,30,Retired Persons,0,0,0,0,0,0,0,0,0,0,0,0,0,0,0,0,0,0
SIKKIM,2004,30,House Wife,0,0,0,0,0,0,0,0,2,7,2,11,0,0,2,7,2,11
SIKKIM,2004,30,Service (Government),0,0,3,0,0,3,0,0,0,0,0,0,0,0,3,0,0,3
SIKKIM,2004,30,Service (Private),0,0,4,2,0,6,0,0,0,0,0,0,0,0,4,2,0,6
SIKKIM,2004,30,Public Sector Undertaking,0,0,0,0,0,0,0,0,0,0,0,0,0,0,0,0,0,0
SIKKIM,2004,30,Students,0,0,0,0,0,0,0,0,0,0,0,0,0,0,0,0,0,0
SIKKIM,2004,30,Unemployed,0,0,2,0,0,2,0,0,2,0,2,4,0,0,4,0,2,6
SIKKIM,2004,30,Professional Activity,0,0,3,1,2,6,0,0,0,1,1,2,0,0,3,2,3,8
SIKKIM,2004,30,Agriculture (Total),0,0,3,6,21,30,0,0,4,7,8,19,0,0,7,13,29,49
SIKKIM,2004,30,Retired Persons,0,0,0,0,0,0,0,0,0,0,0,0,0,0,0,0,0,0
SIKKIM,2005,30,House Wife,0,0,0,0,0,0,0,10,7,1,2,20,0,10,7,1,2,20
SIKKIM,2005,30,Service (Government),0,0,2,0,0,2,0,0,0,0,0,0,0,0,2,0,0,2
SIKKIM,2005,30,Service (Private),0,2,0,0,0,2,0,0,3,0,0,3,0,2,3,0,0,5
SIKKIM,2005,30,Public Sector Undertaking,0,0,0,0,0,0,0,0,0,0,0,0,0,0,0,0,0,0
SIKKIM,2005,30,Students,2,2,1,0,0,5,2,3,0,0,0,5,4,5,1,0,0,10
SIKKIM,2005,30,Unemployed,0,2,2,0,0,4,0,0,0,0,0,0,0,2,2,0,0,4
SIKKIM,2005,30,Professional Activity,0,0,0,0,0,0,0,0,0,0,0,0,0,0,0,0,0,0
SIKKIM,2005,30,Agriculture (Total),0,15,7,8,4,34,0,1,3,3,0,7,0,16,10,11,4,41
SIKKIM,2005,30,Retired Persons,0,0,0,0,0,0,0,0,0,0,0,0,0,0,0,0,0,0
SIKKIM,2006,30,House Wife,0,0,0,0,0,0,0,0,10,1,4,15,0,0,10,1,4,15
SIKKIM,2006,30,Service (Government),0,4,0,0,0,4,0,0,0,0,0,0,0,4,0,0,0,4
SIKKIM,2006,30,Service (Private),0,6,5,2,0,13,0,0,1,0,0,1,0,6,6,2,0,14
SIKKIM,2006,30,Public Sector Undertaking,0,0,0,0,0,0,0,0,0,0,0,0,0,0,0,0,0,0
SIKKIM,2006,30,Students,4,20,0,0,0,24,3,10,2,0,0,15,7,30,2,0,0,39
SIKKIM,2006,30,Unemployed,0,0,10,8,0,18,0,0,0,0,0,0,0,0,10,8,0,18
SIKKIM,2006,30,Professional Activity,0,0,0,0,0,0,0,0,0,0,0,0,0,0,0,0,0,0
SIKKIM,2006,30,Agriculture (Total),0,10,13,4,0,27,0,8,0,0,0,8,0,18,13,4,0,35
SIKKIM,2006,30,Retired Persons,0,0,0,0,0,0,0,0,0,0,0,0,0,0,0,0,0,0
SIKKIM,2007,30,House Wife,0,0,0,0,0,0,0,6,0,0,0,6,0,6,0,0,0,6
SIKKIM,2007,30,Service (Government),0,0,0,0,0,0,0,0,0,0,0,0,0,0,0,0,0,0
SIKKIM,2007,30,Service (Private),0,3,3,3,0,9,0,3,0,0,0,3,0,6,3,3,0,12
SIKKIM,2007,30,Public Sector Undertaking,0,0,0,0,0,0,0,1,0,0,0,1,0,1,0,0,0,1
SIKKIM,2007,30,Students,2,3,0,0,0,5,0,0,0,0,0,0,2,3,0,0,0,5
SIKKIM,2007,30,Unemployed,0,9,0,0,0,9,0,2,0,0,0,2,0,11,0,0,0,11
SIKKIM,2007,30,Professional Activity,0,0,0,0,0,0,0,0,0,0,0,0,0,0,0,0,0,0
SIKKIM,2007,30,Agriculture (Total),0,0,8,7,0,15,0,2,4,0,0,6,0,2,12,7,0,21
SIKKIM,2007,30,Retired Persons,0,0,0,0,0,0,0,0,0,0,0,0,0,0,0,0,0,0
SIKKIM,2008,30,House Wife,0,0,0,0,0,0,0,6,0,1,0,7,0,6,0,1,0,7
SIKKIM,2008,30,Service (Government),0,0,0,0,0,0,0,0,0,0,0,0,0,0,0,0,0,0
SIKKIM,2008,30,Service (Private),0,8,4,6,2,20,0,2,4,2,0,8,0,10,8,8,2,28
SIKKIM,2008,30,Public Sector Undertaking,0,0,0,0,0,0,0,3,1,2,0,6,0,3,1,2,0,6
SIKKIM,2008,30,Students,2,6,0,0,0,8,0,4,0,0,0,4,2,10,0,0,0,12
SIKKIM,2008,30,Unemployed,0,16,11,6,3,36,0,3,6,4,0,13,0,19,17,10,3,49
SIKKIM,2008,30,Professional Activity,0,0,0,0,0,0,0,0,0,0,0,0,0,0,0,0,0,0
SIKKIM,2008,30,Agriculture (Total),0,10,21,17,1,49,0,2,6,0,3,11,0,12,27,17,4,60
SIKKIM,2008,30,Retired Persons,0,0,0,0,0,0,0,0,0,0,0,0,0,0,0,0,0,0
SIKKIM,2009,30,House Wife,0,0,0,0,0,0,0,5,3,0,0,8,0,5,3,0,0,8
SIKKIM,2009,30,Service (Government),0,5,2,0,0,7,0,3,2,0,0,5,0,8,4,0,0,12
SIKKIM,2009,30,Service (Private),0,7,3,2,1,13,0,7,4,4,3,18,0,14,7,6,4,31
SIKKIM,2009,30,Public Sector Undertaking,0,3,5,3,0,11,0,8,5,3,0,16,0,11,10,6,0,27
SIKKIM,2009,30,Students,0,5,0,0,0,5,0,2,0,0,0,2,0,7,0,0,0,7
SIKKIM,2009,30,Unemployed,0,2,3,5,2,12,0,11,7,5,0,23,0,13,10,10,2,35
SIKKIM,2009,30,Professional Activity,0,7,0,2,0,9,0,6,3,5,0,14,0,13,3,7,0,23
SIKKIM,2009,30,Agriculture (Total),0,12,0,1,1,14,0,3,2,2,2,9,0,15,2,3,3,23
SIKKIM,2009,30,Retired Persons,0,0,0,2,2,4,0,0,0,1,2,3,0,0,0,3,4,7
SIKKIM,2010,30,House Wife,0,0,0,0,0,0,0,2,1,1,1,5,0,2,1,1,1,5
SIKKIM,2010,30,Service (Government),0,17,11,1,0,29,0,1,5,0,0,6,0,18,16,1,0,35
SIKKIM,2010,30,Service (Private),9,23,17,1,2,52,0,1,2,0,0,3,9,24,19,1,2,55
SIKKIM,2010,30,Public Sector Undertaking,0,11,7,3,0,21,0,5,5,0,0,10,0,16,12,3,0,31
SIKKIM,2010,30,Students,0,2,0,0,0,2,0,1,0,0,0,1,0,3,0,0,0,3
SIKKIM,2010,30,Unemployed,11,13,12,7,2,45,0,2,5,0,0,7,11,15,17,7,2,52
SIKKIM,2010,30,Professional Activity,0,9,9,0,3,21,0,0,0,1,0,1,0,9,9,1,3,22
SIKKIM,2010,30,Agriculture (Total),1,5,5,7,1,19,0,0,0,0,0,0,1,5,5,7,1,19
SIKKIM,2010,30,Retired Persons,0,0,0,0,3,3,0,0,0,0,2,2,0,0,0,0,5,5
SIKKIM,2011,30,House Wife,0,0,0,0,0,0,0,7,3,2,0,12,0,7,3,2,0,12
SIKKIM,2011,30,Service (Government),0,9,2,1,0,12,0,2,0,0,0,2,0,11,2,1,0,14
SIKKIM,2011,30,Service (Private),0,11,5,4,0,20,0,10,0,1,0,11,0,21,5,5,0,31
SIKKIM,2011,30,Public Sector Undertaking,0,6,8,0,0,14,0,2,0,2,0,4,0,8,8,2,0,18
SIKKIM,2011,30,Students,0,2,1,0,0,3,0,4,0,0,0,4,0,6,1,0,0,7
SIKKIM,2011,30,Unemployed,0,3,9,5,0,17,0,1,3,5,0,9,0,4,12,10,0,26
SIKKIM,2011,30,Professional Activity,0,0,1,0,0,1,0,0,2,2,0,4,0,0,3,2,0,5
SIKKIM,2011,30,Agriculture (Total),0,0,4,3,0,7,0,0,3,2,0,5,0,0,7,5,0,12
SIKKIM,2011,30,Retired Persons,0,0,0,2,0,2,0,0,0,0,0,0,0,0,0,2,0,2
SIKKIM,2012,30,House Wife,0,0,0,0,0,0,0,9,7,4,2,22,0,9,7,4,2,22
SIKKIM,2012,30,Service (Government),0,7,7,3,0,17,0,5,0,1,0,6,0,12,7,4,0,23
SIKKIM,2012,30,Service (Private),0,5,5,4,0,14,0,4,3,1,0,8,0,9,8,5,0,22
SIKKIM,2012,30,Public Sector Undertaking,0,2,2,4,0,8,0,0,2,0,0,2,0,2,4,4,0,10
SIKKIM,2012,30,Students,5,2,0,0,0,7,6,4,3,0,0,13,11,6,3,0,0,20
SIKKIM,2012,30,Unemployed,0,5,0,0,0,5,0,6,8,0,0,14,0,11,8,0,0,19
SIKKIM,2012,30,Professional Activity,0,2,2,5,2,11,0,0,0,0,0,0,0,2,2,5,2,11
SIKKIM,2012,30,Agriculture (Total),0,5,4,1,0,10,0,5,2,0,2,9,0,10,6,1,2,19
SIKKIM,2012,30,Retired Persons,0,0,0,0,0,0,0,0,0,0,0,0,0,0,0,0,0,0
SIKKIM,2013,30,House Wife,0,0,0,0,0,0,0,5,3,1,0,9,0,5,3,1,0,9
SIKKIM,2013,30,Service (Government),0,2,4,3,0,9,0,2,1,0,0,3,0,4,5,3,0,12
SIKKIM,2013,30,Service (Private),0,6,7,2,2,17,0,4,3,2,0,9,0,10,10,4,2,26
SIKKIM,2013,30,Public Sector Undertaking,0,3,11,2,0,16,0,0,2,0,0,2,0,3,13,2,0,18
SIKKIM,2013,30,Students,3,3,0,0,0,6,2,3,0,0,0,5,5,6,0,0,0,11
SIKKIM,2013,30,Unemployed,0,7,5,1,0,13,0,7,0,0,0,7,0,14,5,1,0,20
SIKKIM,2013,30,Professional Activity,0,0,2,1,0,3,0,2,0,0,0,2,0,2,2,1,0,5
SIKKIM,2013,30,Agriculture (Total),0,9,5,4,3,21,0,8,2,2,2,14,0,17,7,6,5,35
SIKKIM,2013,30,Retired Persons,0,0,0,0,2,2,0,0,0,0,1,1,0,0,0,0,3,3
SIKKIM,2014,30,House Wife,0,0,0,0,0,0,0,5,12,6,1,24,0,5,12,6,1,24
SIKKIM,2014,30,Service (Government),0,1,2,1,0,4,0,2,4,0,0,6,0,3,6,1,0,10
SIKKIM,2014,30,Service (Private),0,4,0,0,0,4,0,1,0,0,0,1,0,5,0,0,0,5
SIKKIM,2014,30,Public Sector Undertaking,0,0,0,0,0,0,0,2,0,0,0,2,0,2,0,0,0,2
SIKKIM,2014,30,Students,4,13,0,0,0,17,3,4,0,0,0,7,7,17,0,0,0,24
SIKKIM,2014,30,Unemployed,0,19,14,8,4,45,0,11,6,4,1,22,0,30,20,12,5,67
SIKKIM,2014,30,Agriculture (Total),0,2,19,9,3,33,0,0,0,1,1,2,0,2,19,10,4,35
SIKKIM,2014,30,Retired Persons,0,2,1,3,0,6,0,1,0,0,0,1,0,3,1,3,0,7
TAMIL NADU,2001,31,House Wife,0,0,0,0,0,0,0,822,632,226,75,1755,0,822,632,226,75,1755
TAMIL NADU,2001,31,Service (Government),0,21,63,79,3,166,0,23,33,10,1,67,0,44,96,89,4,233
TAMIL NADU,2001,31,Service (Private),2,221,375,207,45,850,3,89,89,48,5,234,5,310,464,255,50,1084
TAMIL NADU,2001,31,Public Sector Undertaking,0,75,78,50,4,207,0,45,42,9,2,98,0,120,120,59,6,305
TAMIL NADU,2001,31,Students,46,180,10,0,0,236,39,116,7,6,0,168,85,296,17,6,0,404
TAMIL NADU,2001,31,Unemployed,6,333,540,402,49,1330,21,178,238,76,15,528,27,511,778,478,64,1858
TAMIL NADU,2001,31,Professional Activity,3,83,141,58,9,294,0,14,27,23,0,64,3,97,168,81,9,358
TAMIL NADU,2001,31,Agriculture (Total),5,304,253,170,94,826,7,63,50,24,15,159,12,367,303,194,109,985
TAMIL NADU,2001,31,Retired Persons,0,0,0,9,35,44,0,0,0,0,6,6,0,0,0,9,41,50
TAMIL NADU,2002,31,House Wife,0,0,0,0,0,0,0,951,741,343,103,2138,0,951,741,343,103,2138
TAMIL NADU,2002,31,Service (Government),0,77,79,62,6,224,0,41,51,32,3,127,0,118,130,94,9,351
TAMIL NADU,2002,31,Service (Private),0,226,378,206,18,828,4,147,67,48,21,287,4,373,445,254,39,1115
TAMIL NADU,2002,31,Public Sector Undertaking,0,68,105,50,7,230,0,57,32,7,0,96,0,125,137,57,7,326
TAMIL NADU,2002,31,Students,42,176,41,0,0,259,37,158,20,0,0,215,79,334,61,0,0,474
TAMIL NADU,2002,31,Unemployed,8,342,381,277,58,1066,14,125,100,48,9,296,22,467,481,325,67,1362
TAMIL NADU,2002,31,Professional Activity,0,35,65,24,3,127,0,8,7,3,0,18,0,43,72,27,3,145
TAMIL NADU,2002,31,Agriculture (Total),1,371,420,370,95,1257,5,99,54,31,9,198,6,470,474,401,104,1455
TAMIL NADU,2002,31,Retired Persons,0,0,0,3,32,35,0,0,0,6,13,19,0,0,0,9,45,54
TAMIL NADU,2003,31,House Wife,0,0,0,0,0,0,0,779,777,409,103,2068,0,779,777,409,103,2068
TAMIL NADU,2003,31,Service (Government),0,36,74,74,5,189,0,31,22,24,0,77,0,67,96,98,5,266
TAMIL NADU,2003,31,Service (Private),0,208,321,223,42,794,0,179,155,93,10,437,0,387,476,316,52,1231
TAMIL NADU,2003,31,Public Sector Undertaking,0,78,141,78,11,308,0,32,44,24,1,101,0,110,185,102,12,409
TAMIL NADU,2003,31,Students,60,170,17,0,0,247,79,136,4,0,0,219,139,306,21,0,0,466
TAMIL NADU,2003,31,Unemployed,11,490,524,298,145,1468,7,200,147,123,29,506,18,690,671,421,174,1974
TAMIL NADU,2003,31,Professional Activity,0,127,159,95,36,417,0,20,23,33,3,79,0,147,182,128,39,496
TAMIL NADU,2003,31,Agriculture (Total),1,244,300,200,87,832,5,101,71,27,16,220,6,345,371,227,103,1052
TAMIL NADU,2003,31,Retired Persons,0,0,0,15,52,67,0,0,0,4,13,17,0,0,0,19,65,84
TAMIL NADU,2004,31,House Wife,0,0,0,0,0,0,0,698,766,485,163,2112,0,698,766,485,163,2112
TAMIL NADU,2004,31,Service (Government),0,34,67,54,0,155,0,3,18,23,0,44,0,37,85,77,0,199
TAMIL NADU,2004,31,Service (Private),0,215,301,268,48,832,3,83,102,57,6,251,3,298,403,325,54,1083
TAMIL NADU,2004,31,Public Sector Undertaking,0,60,94,63,10,227,0,13,30,23,7,73,0,73,124,86,17,300
TAMIL NADU,2004,31,Students,74,158,15,0,0,247,55,163,7,1,0,226,129,321,22,1,0,473
TAMIL NADU,2004,31,Unemployed,7,358,435,350,91,1241,3,207,137,93,18,458,10,565,572,443,109,1699
TAMIL NADU,2004,31,Professional Activity,2,77,102,75,19,275,0,26,22,8,1,57,2,103,124,83,20,332
TAMIL NADU,2004,31,Agriculture (Total),7,318,457,329,186,1297,13,124,98,45,22,302,20,442,555,374,208,1599
TAMIL NADU,2004,31,Retired Persons,0,0,0,5,84,89,0,0,0,2,15,17,0,0,0,7,99,106
TAMIL NADU,2005,31,House Wife,0,0,0,0,0,0,0,647,737,493,181,2058,0,647,737,493,181,2058
TAMIL NADU,2005,31,Service (Government),0,35,63,58,3,159,0,5,16,11,0,32,0,40,79,69,3,191
TAMIL NADU,2005,31,Service (Private),0,259,357,280,51,947,3,115,93,33,5,249,3,374,450,313,56,1196
TAMIL NADU,2005,31,Public Sector Undertaking,0,48,88,59,10,205,0,14,30,23,8,75,0,62,118,82,18,280
TAMIL NADU,2005,31,Students,73,173,15,0,0,261,59,203,7,1,0,270,132,376,22,1,0,531
TAMIL NADU,2005,31,Unemployed,7,390,426,267,84,1174,5,249,141,76,40,511,12,639,567,343,124,1685
TAMIL NADU,2005,31,Professional Activity,0,72,93,73,8,246,0,21,13,4,2,40,0,93,106,77,10,286
TAMIL NADU,2005,31,Agriculture (Total),11,217,369,263,142,1002,5,102,73,40,33,253,16,319,442,303,175,1255
TAMIL NADU,2005,31,Retired Persons,0,0,0,10,84,94,0,0,0,0,8,8,0,0,0,10,92,102
TAMIL NADU,2006,31,House Wife,0,0,0,0,0,0,0,830,947,451,126,2354,0,830,947,451,126,2354
TAMIL NADU,2006,31,Service (Government),0,20,89,45,1,155,0,10,8,7,5,30,0,30,97,52,6,185
TAMIL NADU,2006,31,Service (Private),0,279,449,291,73,1092,0,462,101,58,7,628,0,741,550,349,80,1720
TAMIL NADU,2006,31,Public Sector Undertaking,0,49,107,60,29,245,0,15,11,59,1,86,0,64,118,119,30,331
TAMIL NADU,2006,31,Students,26,65,8,0,0,99,36,84,7,0,0,127,62,149,15,0,0,226
TAMIL NADU,2006,31,Unemployed,0,364,116,170,96,746,0,240,122,86,33,481,0,604,238,256,129,1227
TAMIL NADU,2006,31,Professional Activity,0,0,0,0,0,0,0,0,0,0,0,0,0,0,0,0,0,0
TAMIL NADU,2006,31,Agriculture (Total),0,78,147,82,35,342,0,23,40,19,2,84,0,101,187,101,37,426
TAMIL NADU,2006,31,Retired Persons,0,0,0,10,77,87,0,0,0,0,15,15,0,0,0,10,92,102
TAMIL NADU,2007,31,House Wife,0,0,0,0,0,0,0,873,996,474,133,2476,0,873,996,474,133,2476
TAMIL NADU,2007,31,Service (Government),0,23,103,52,1,179,0,10,9,8,5,32,0,33,112,60,6,211
TAMIL NADU,2007,31,Service (Private),0,323,519,337,84,1263,0,486,106,61,7,660,0,809,625,398,91,1923
TAMIL NADU,2007,31,Public Sector Undertaking,0,57,124,69,33,283,0,19,11,59,1,90,0,76,135,128,34,373
TAMIL NADU,2007,31,Students,30,76,6,1,2,115,38,89,7,0,0,134,68,165,13,1,2,249
TAMIL NADU,2007,31,Unemployed,0,421,134,197,111,863,0,253,128,90,35,506,0,674,262,287,146,1369
TAMIL NADU,2007,31,Professional Activity,0,0,0,0,0,0,0,0,0,0,0,0,0,0,0,0,0,0
TAMIL NADU,2007,31,Agriculture (Total),0,90,170,95,41,396,0,25,42,19,2,88,0,115,212,114,43,484
TAMIL NADU,2007,31,Retired Persons,0,0,0,12,89,101,0,0,0,0,16,16,0,0,0,12,105,117
TAMIL NADU,2008,31,House Wife,0,0,0,0,0,0,0,841,986,470,133,2430,0,841,986,470,133,2430
TAMIL NADU,2008,31,Service (Government),0,31,153,83,2,269,0,20,11,9,6,46,0,51,164,92,8,315
TAMIL NADU,2008,31,Service (Private),0,357,520,385,71,1333,0,476,120,84,8,688,0,833,640,469,79,2021
TAMIL NADU,2008,31,Public Sector Undertaking,0,75,132,71,3,281,0,31,15,54,7,107,0,106,147,125,10,388
TAMIL NADU,2008,31,Students,30,84,0,0,0,114,43,97,4,0,0,144,73,181,4,0,0,258
TAMIL NADU,2008,31,Unemployed,0,431,134,197,111,873,0,263,145,75,10,493,0,694,279,272,121,1366
TAMIL NADU,2008,31,Professional Activity,0,110,170,95,41,416,0,55,49,28,10,142,0,165,219,123,51,558
TAMIL NADU,2008,31,Agriculture (Total),0,95,170,95,40,400,0,40,46,24,2,112,0,135,216,119,42,512
TAMIL NADU,2008,31,Retired Persons,0,0,0,12,89,101,0,0,0,0,16,16,0,0,0,12,105,117
TAMIL NADU,2009,31,House Wife,0,0,0,0,0,0,0,987,1017,492,267,2763,0,987,1017,492,267,2763
TAMIL NADU,2009,31,Service (Government),0,7,86,104,11,208,0,8,26,11,0,45,0,15,112,115,11,253
TAMIL NADU,2009,31,Service (Private),0,393,604,308,54,1359,0,138,125,98,19,380,0,531,729,406,73,1739
TAMIL NADU,2009,31,Public Sector Undertaking,0,152,136,48,9,345,0,4,12,11,0,27,0,156,148,59,9,372
TAMIL NADU,2009,31,Students,83,174,0,0,0,257,68,131,0,0,0,199,151,305,0,0,0,456
TAMIL NADU,2009,31,Unemployed,3,359,617,446,137,1562,6,171,83,140,24,424,9,530,700,586,161,1986
TAMIL NADU,2009,31,Professional Activity,0,97,84,23,38,242,0,38,23,16,9,86,0,135,107,39,47,328
TAMIL NADU,2009,31,Agriculture (Total),5,195,306,244,106,856,7,86,56,36,19,204,12,281,362,280,125,1060
TAMIL NADU,2009,31,Retired Persons,0,0,0,84,98,182,0,0,0,14,18,32,0,0,0,98,116,214
TAMIL NADU,2010,31,House Wife,0,0,0,0,0,0,3,935,984,520,225,2667,3,935,984,520,225,2667
TAMIL NADU,2010,31,Service (Government),0,21,40,61,0,122,0,18,23,16,1,58,0,39,63,77,1,180
TAMIL NADU,2010,31,Service (Private),1,383,609,384,53,1430,0,152,84,67,2,305,1,535,693,451,55,1735
TAMIL NADU,2010,31,Public Sector Undertaking,0,53,122,78,11,264,0,28,37,12,0,77,0,81,159,90,11,341
TAMIL NADU,2010,31,Students,99,254,6,0,0,359,65,208,5,0,0,278,164,462,11,0,0,637
TAMIL NADU,2010,31,Unemployed,3,418,577,360,169,1527,3,289,136,90,27,545,6,707,713,450,196,2072
TAMIL NADU,2010,31,Professional Activity,0,53,86,50,23,212,5,16,18,10,2,51,5,69,104,60,25,263
TAMIL NADU,2010,31,Agriculture (Total),13,137,131,103,58,442,0,65,25,6,3,99,13,202,156,109,61,541
TAMIL NADU,2010,31,Retired Persons,0,0,0,35,77,112,0,0,0,5,15,20,0,0,0,40,92,132
TAMIL NADU,2011,31,House Wife,0,0,0,0,0,0,5,915,888,407,218,2433,5,915,888,407,218,2433
TAMIL NADU,2011,31,Service (Government),0,11,52,53,4,120,0,11,18,5,3,37,0,22,70,58,7,157
TAMIL NADU,2011,31,Service (Private),0,287,449,257,45,1038,1,96,81,48,1,227,1,383,530,305,46,1265
TAMIL NADU,2011,31,Public Sector Undertaking,1,38,50,34,7,130,0,31,16,3,1,51,1,69,66,37,8,181
TAMIL NADU,2011,31,Students,95,324,61,0,0,480,78,273,18,0,0,369,173,597,79,0,0,849
TAMIL NADU,2011,31,Unemployed,14,408,596,599,146,1763,15,239,114,85,18,471,29,647,710,684,164,2234
TAMIL NADU,2011,31,Professional Activity,0,69,144,81,33,327,0,18,23,28,25,94,0,87,167,109,58,421
TAMIL NADU,2011,31,Agriculture (Total),3,99,161,157,62,482,2,61,43,23,12,141,5,160,204,180,74,623
TAMIL NADU,2011,31,Retired Persons,0,0,6,24,51,81,0,0,0,5,4,9,0,0,6,29,55,90
TAMIL NADU,2012,31,House Wife,0,0,0,0,0,0,3,1097,1031,575,205,2911,3,1097,1031,575,205,2911
TAMIL NADU,2012,31,Service (Government),0,39,101,93,4,237,0,17,22,8,0,47,0,56,123,101,4,284
TAMIL NADU,2012,31,Service (Private),0,202,381,244,34,861,0,85,72,25,4,186,0,287,453,269,38,1047
TAMIL NADU,2012,31,Public Sector Undertaking,0,41,76,67,7,191,0,22,27,17,1,67,0,63,103,84,8,258
TAMIL NADU,2012,31,Students,101,274,12,0,0,387,95,294,19,0,0,408,196,568,31,0,0,795
TAMIL NADU,2012,31,Unemployed,5,316,425,594,177,1517,4,175,141,83,18,421,9,491,566,677,195,1938
TAMIL NADU,2012,31,Professional Activity,0,40,40,46,19,145,0,31,32,10,2,75,0,71,72,56,21,220
TAMIL NADU,2012,31,Agriculture (Total),0,68,137,123,81,409,0,31,32,22,5,90,0,99,169,145,86,499
TAMIL NADU,2012,31,Retired Persons,0,0,3,13,46,62,0,0,0,0,9,9,0,0,3,13,55,71
TAMIL NADU,2013,31,House Wife,0,0,0,0,0,0,0,993,924,435,244,2596,0,993,924,435,244,2596
TAMIL NADU,2013,31,Service (Government),0,26,73,63,0,162,0,12,9,11,0,32,0,38,82,74,0,194
TAMIL NADU,2013,31,Service (Private),0,343,582,424,94,1443,0,133,70,39,9,251,0,476,652,463,103,1694
TAMIL NADU,2013,31,Public Sector Undertaking,0,54,65,64,16,199,0,16,17,9,1,43,0,70,82,73,17,242
TAMIL NADU,2013,31,Students,96,384,17,0,0,497,76,282,11,0,0,369,172,666,28,0,0,866
TAMIL NADU,2013,31,Unemployed,0,400,382,332,98,1212,0,139,77,63,18,297,0,539,459,395,116,1509
TAMIL NADU,2013,31,Professional Activity,0,97,233,128,32,490,0,17,19,12,3,51,0,114,252,140,35,541
TAMIL NADU,2013,31,Agriculture (Total),0,12,24,43,17,96,0,4,3,2,0,9,0,16,27,45,17,105
TAMIL NADU,2013,31,Retired Persons,0,0,0,22,80,102,0,0,0,0,14,14,0,0,0,22,94,116
TAMIL NADU,2014,31,House Wife,0,0,0,0,0,0,0,896,777,313,157,2143,0,896,777,313,157,2143
TAMIL NADU,2014,31,Service (Government),0,25,93,74,15,207,0,17,8,4,0,29,0,42,101,78,15,236
TAMIL NADU,2014,31,Service (Private),0,290,309,199,49,847,0,76,37,30,2,145,0,366,346,229,51,992
TAMIL NADU,2014,31,Public Sector Undertaking,0,62,57,44,14,177,0,18,4,4,0,26,0,80,61,48,14,203
TAMIL NADU,2014,31,Students,49,406,8,0,0,463,52,330,3,2,3,390,101,736,11,2,3,853
TAMIL NADU,2014,31,Unemployed,0,445,420,267,175,1307,0,193,110,80,39,422,0,638,530,347,214,1729
TAMIL NADU,2014,31,Agriculture (Total),0,147,256,202,86,691,0,98,55,40,11,204,0,245,311,242,97,895
TAMIL NADU,2014,31,Retired Persons,0,0,18,10,47,75,0,1,1,2,1,5,0,1,19,12,48,80
TELANGANA,2001,32,House Wife,0,0,0,0,0,0,0,0,0,0,0,0,0,0,0,0,0,0
TELANGANA,2001,32,Service (Government),0,0,0,0,0,0,0,0,0,0,0,0,0,0,0,0,0,0
TELANGANA,2001,32,Service (Private),0,0,0,0,0,0,0,0,0,0,0,0,0,0,0,0,0,0
TELANGANA,2001,32,Public Sector Undertaking,0,0,0,0,0,0,0,0,0,0,0,0,0,0,0,0,0,0
TELANGANA,2001,32,Students,0,0,0,0,0,0,0,0,0,0,0,0,0,0,0,0,0,0
TELANGANA,2001,32,Unemployed,0,0,0,0,0,0,0,0,0,0,0,0,0,0,0,0,0,0
TELANGANA,2001,32,Professional Activity,0,0,0,0,0,0,0,0,0,0,0,0,0,0,0,0,0,0
TELANGANA,2001,32,Agriculture (Total),0,0,0,0,0,0,0,0,0,0,0,0,0,0,0,0,0,0
TELANGANA,2001,32,Retired Persons,0,0,0,0,0,0,0,0,0,0,0,0,0,0,0,0,0,0
TELANGANA,2002,32,House Wife,0,0,0,0,0,0,0,0,0,0,0,0,0,0,0,0,0,0
TELANGANA,2002,32,Service (Government),0,0,0,0,0,0,0,0,0,0,0,0,0,0,0,0,0,0
TELANGANA,2002,32,Service (Private),0,0,0,0,0,0,0,0,0,0,0,0,0,0,0,0,0,0
TELANGANA,2002,32,Public Sector Undertaking,0,0,0,0,0,0,0,0,0,0,0,0,0,0,0,0,0,0
TELANGANA,2002,32,Students,0,0,0,0,0,0,0,0,0,0,0,0,0,0,0,0,0,0
TELANGANA,2002,32,Unemployed,0,0,0,0,0,0,0,0,0,0,0,0,0,0,0,0,0,0
TELANGANA,2002,32,Professional Activity,0,0,0,0,0,0,0,0,0,0,0,0,0,0,0,0,0,0
TELANGANA,2002,32,Agriculture (Total),0,0,0,0,0,0,0,0,0,0,0,0,0,0,0,0,0,0
TELANGANA,2002,32,Retired Persons,0,0,0,0,0,0,0,0,0,0,0,0,0,0,0,0,0,0
TELANGANA,2003,32,House Wife,0,0,0,0,0,0,0,0,0,0,0,0,0,0,0,0,0,0
TELANGANA,2003,32,Service (Government),0,0,0,0,0,0,0,0,0,0,0,0,0,0,0,0,0,0
TELANGANA,2003,32,Service (Private),0,0,0,0,0,0,0,0,0,0,0,0,0,0,0,0,0,0
TELANGANA,2003,32,Public Sector Undertaking,0,0,0,0,0,0,0,0,0,0,0,0,0,0,0,0,0,0
TELANGANA,2003,32,Students,0,0,0,0,0,0,0,0,0,0,0,0,0,0,0,0,0,0
TELANGANA,2003,32,Unemployed,0,0,0,0,0,0,0,0,0,0,0,0,0,0,0,0,0,0
TELANGANA,2003,32,Professional Activity,0,0,0,0,0,0,0,0,0,0,0,0,0,0,0,0,0,0
TELANGANA,2003,32,Agriculture (Total),0,0,0,0,0,0,0,0,0,0,0,0,0,0,0,0,0,0
TELANGANA,2003,32,Retired Persons,0,0,0,0,0,0,0,0,0,0,0,0,0,0,0,0,0,0
TELANGANA,2004,32,House Wife,0,0,0,0,0,0,0,0,0,0,0,0,0,0,0,0,0,0
TELANGANA,2004,32,Service (Government),0,0,0,0,0,0,0,0,0,0,0,0,0,0,0,0,0,0
TELANGANA,2004,32,Service (Private),0,0,0,0,0,0,0,0,0,0,0,0,0,0,0,0,0,0
TELANGANA,2004,32,Public Sector Undertaking,0,0,0,0,0,0,0,0,0,0,0,0,0,0,0,0,0,0
TELANGANA,2004,32,Students,0,0,0,0,0,0,0,0,0,0,0,0,0,0,0,0,0,0
TELANGANA,2004,32,Unemployed,0,0,0,0,0,0,0,0,0,0,0,0,0,0,0,0,0,0
TELANGANA,2004,32,Professional Activity,0,0,0,0,0,0,0,0,0,0,0,0,0,0,0,0,0,0
TELANGANA,2004,32,Agriculture (Total),0,0,0,0,0,0,0,0,0,0,0,0,0,0,0,0,0,0
TELANGANA,2004,32,Retired Persons,0,0,0,0,0,0,0,0,0,0,0,0,0,0,0,0,0,0
TELANGANA,2005,32,House Wife,0,0,0,0,0,0,0,0,0,0,0,0,0,0,0,0,0,0
TELANGANA,2005,32,Service (Government),0,0,0,0,0,0,0,0,0,0,0,0,0,0,0,0,0,0
TELANGANA,2005,32,Service (Private),0,0,0,0,0,0,0,0,0,0,0,0,0,0,0,0,0,0
TELANGANA,2005,32,Public Sector Undertaking,0,0,0,0,0,0,0,0,0,0,0,0,0,0,0,0,0,0
TELANGANA,2005,32,Students,0,0,0,0,0,0,0,0,0,0,0,0,0,0,0,0,0,0
TELANGANA,2005,32,Unemployed,0,0,0,0,0,0,0,0,0,0,0,0,0,0,0,0,0,0
TELANGANA,2005,32,Professional Activity,0,0,0,0,0,0,0,0,0,0,0,0,0,0,0,0,0,0
TELANGANA,2005,32,Agriculture (Total),0,0,0,0,0,0,0,0,0,0,0,0,0,0,0,0,0,0
TELANGANA,2005,32,Retired Persons,0,0,0,0,0,0,0,0,0,0,0,0,0,0,0,0,0,0
TELANGANA,2006,32,House Wife,0,0,0,0,0,0,0,0,0,0,0,0,0,0,0,0,0,0
TELANGANA,2006,32,Service (Government),0,0,0,0,0,0,0,0,0,0,0,0,0,0,0,0,0,0
TELANGANA,2006,32,Service (Private),0,0,0,0,0,0,0,0,0,0,0,0,0,0,0,0,0,0
TELANGANA,2006,32,Public Sector Undertaking,0,0,0,0,0,0,0,0,0,0,0,0,0,0,0,0,0,0
TELANGANA,2006,32,Students,0,0,0,0,0,0,0,0,0,0,0,0,0,0,0,0,0,0
TELANGANA,2006,32,Unemployed,0,0,0,0,0,0,0,0,0,0,0,0,0,0,0,0,0,0
TELANGANA,2006,32,Professional Activity,0,0,0,0,0,0,0,0,0,0,0,0,0,0,0,0,0,0
TELANGANA,2006,32,Agriculture (Total),0,0,0,0,0,0,0,0,0,0,0,0,0,0,0,0,0,0
TELANGANA,2006,32,Retired Persons,0,0,0,0,0,0,0,0,0,0,0,0,0,0,0,0,0,0
TELANGANA,2007,32,House Wife,0,0,0,0,0,0,0,0,0,0,0,0,0,0,0,0,0,0
TELANGANA,2007,32,Service (Government),0,0,0,0,0,0,0,0,0,0,0,0,0,0,0,0,0,0
TELANGANA,2007,32,Service (Private),0,0,0,0,0,0,0,0,0,0,0,0,0,0,0,0,0,0
TELANGANA,2007,32,Public Sector Undertaking,0,0,0,0,0,0,0,0,0,0,0,0,0,0,0,0,0,0
TELANGANA,2007,32,Students,0,0,0,0,0,0,0,0,0,0,0,0,0,0,0,0,0,0
TELANGANA,2007,32,Unemployed,0,0,0,0,0,0,0,0,0,0,0,0,0,0,0,0,0,0
TELANGANA,2007,32,Professional Activity,0,0,0,0,0,0,0,0,0,0,0,0,0,0,0,0,0,0
TELANGANA,2007,32,Agriculture (Total),0,0,0,0,0,0,0,0,0,0,0,0,0,0,0,0,0,0
TELANGANA,2007,32,Retired Persons,0,0,0,0,0,0,0,0,0,0,0,0,0,0,0,0,0,0
TELANGANA,2008,32,House Wife,0,0,0,0,0,0,0,0,0,0,0,0,0,0,0,0,0,0
TELANGANA,2008,32,Service (Government),0,0,0,0,0,0,0,0,0,0,0,0,0,0,0,0,0,0
TELANGANA,2008,32,Service (Private),0,0,0,0,0,0,0,0,0,0,0,0,0,0,0,0,0,0
TELANGANA,2008,32,Public Sector Undertaking,0,0,0,0,0,0,0,0,0,0,0,0,0,0,0,0,0,0
TELANGANA,2008,32,Students,0,0,0,0,0,0,0,0,0,0,0,0,0,0,0,0,0,0
TELANGANA,2008,32,Unemployed,0,0,0,0,0,0,0,0,0,0,0,0,0,0,0,0,0,0
TELANGANA,2008,32,Professional Activity,0,0,0,0,0,0,0,0,0,0,0,0,0,0,0,0,0,0
TELANGANA,2008,32,Agriculture (Total),0,0,0,0,0,0,0,0,0,0,0,0,0,0,0,0,0,0
TELANGANA,2008,32,Retired Persons,0,0,0,0,0,0,0,0,0,0,0,0,0,0,0,0,0,0
TELANGANA,2009,32,House Wife,0,0,0,0,0,0,0,0,0,0,0,0,0,0,0,0,0,0
TELANGANA,2009,32,Service (Government),0,0,0,0,0,0,0,0,0,0,0,0,0,0,0,0,0,0
TELANGANA,2009,32,Service (Private),0,0,0,0,0,0,0,0,0,0,0,0,0,0,0,0,0,0
TELANGANA,2009,32,Public Sector Undertaking,0,0,0,0,0,0,0,0,0,0,0,0,0,0,0,0,0,0
TELANGANA,2009,32,Students,0,0,0,0,0,0,0,0,0,0,0,0,0,0,0,0,0,0
TELANGANA,2009,32,Unemployed,0,0,0,0,0,0,0,0,0,0,0,0,0,0,0,0,0,0
TELANGANA,2009,32,Professional Activity,0,0,0,0,0,0,0,0,0,0,0,0,0,0,0,0,0,0
TELANGANA,2009,32,Agriculture (Total),0,0,0,0,0,0,0,0,0,0,0,0,0,0,0,0,0,0
TELANGANA,2009,32,Retired Persons,0,0,0,0,0,0,0,0,0,0,0,0,0,0,0,0,0,0
TELANGANA,2010,32,House Wife,0,0,0,0,0,0,0,0,0,0,0,0,0,0,0,0,0,0
TELANGANA,2010,32,Service (Government),0,0,0,0,0,0,0,0,0,0,0,0,0,0,0,0,0,0
TELANGANA,2010,32,Service (Private),0,0,0,0,0,0,0,0,0,0,0,0,0,0,0,0,0,0
TELANGANA,2010,32,Public Sector Undertaking,0,0,0,0,0,0,0,0,0,0,0,0,0,0,0,0,0,0
TELANGANA,2010,32,Students,0,0,0,0,0,0,0,0,0,0,0,0,0,0,0,0,0,0
TELANGANA,2010,32,Unemployed,0,0,0,0,0,0,0,0,0,0,0,0,0,0,0,0,0,0
TELANGANA,2010,32,Professional Activity,0,0,0,0,0,0,0,0,0,0,0,0,0,0,0,0,0,0
TELANGANA,2010,32,Agriculture (Total),0,0,0,0,0,0,0,0,0,0,0,0,0,0,0,0,0,0
TELANGANA,2010,32,Retired Persons,0,0,0,0,0,0,0,0,0,0,0,0,0,0,0,0,0,0
TELANGANA,2011,32,House Wife,0,0,0,0,0,0,0,0,0,0,0,0,0,0,0,0,0,0
TELANGANA,2011,32,Service (Government),0,0,0,0,0,0,0,0,0,0,0,0,0,0,0,0,0,0
TELANGANA,2011,32,Service (Private),0,0,0,0,0,0,0,0,0,0,0,0,0,0,0,0,0,0
TELANGANA,2011,32,Public Sector Undertaking,0,0,0,0,0,0,0,0,0,0,0,0,0,0,0,0,0,0
TELANGANA,2011,32,Students,0,0,0,0,0,0,0,0,0,0,0,0,0,0,0,0,0,0
TELANGANA,2011,32,Unemployed,0,0,0,0,0,0,0,0,0,0,0,0,0,0,0,0,0,0
TELANGANA,2011,32,Professional Activity,0,0,0,0,0,0,0,0,0,0,0,0,0,0,0,0,0,0
TELANGANA,2011,32,Agriculture (Total),0,0,0,0,0,0,0,0,0,0,0,0,0,0,0,0,0,0
TELANGANA,2011,32,Retired Persons,0,0,0,0,0,0,0,0,0,0,0,0,0,0,0,0,0,0
TELANGANA,2012,32,House Wife,0,0,0,0,0,0,0,0,0,0,0,0,0,0,0,0,0,0
TELANGANA,2012,32,Service (Government),0,0,0,0,0,0,0,0,0,0,0,0,0,0,0,0,0,0
TELANGANA,2012,32,Service (Private),0,0,0,0,0,0,0,0,0,0,0,0,0,0,0,0,0,0
TELANGANA,2012,32,Public Sector Undertaking,0,0,0,0,0,0,0,0,0,0,0,0,0,0,0,0,0,0
TELANGANA,2012,32,Students,0,0,0,0,0,0,0,0,0,0,0,0,0,0,0,0,0,0
TELANGANA,2012,32,Unemployed,0,0,0,0,0,0,0,0,0,0,0,0,0,0,0,0,0,0
TELANGANA,2012,32,Professional Activity,0,0,0,0,0,0,0,0,0,0,0,0,0,0,0,0,0,0
TELANGANA,2012,32,Agriculture (Total),0,0,0,0,0,0,0,0,0,0,0,0,0,0,0,0,0,0
TELANGANA,2012,32,Retired Persons,0,0,0,0,0,0,0,0,0,0,0,0,0,0,0,0,0,0
TELANGANA,2013,32,House Wife,0,0,0,0,0,0,0,0,0,0,0,0,0,0,0,0,0,0
TELANGANA,2013,32,Service (Government),0,0,0,0,0,0,0,0,0,0,0,0,0,0,0,0,0,0
TELANGANA,2013,32,Service (Private),0,0,0,0,0,0,0,0,0,0,0,0,0,0,0,0,0,0
TELANGANA,2013,32,Public Sector Undertaking,0,0,0,0,0,0,0,0,0,0,0,0,0,0,0,0,0,0
TELANGANA,2013,32,Students,0,0,0,0,0,0,0,0,0,0,0,0,0,0,0,0,0,0
TELANGANA,2013,32,Unemployed,0,0,0,0,0,0,0,0,0,0,0,0,0,0,0,0,0,0
TELANGANA,2013,32,Professional Activity,0,0,0,0,0,0,0,0,0,0,0,0,0,0,0,0,0,0
TELANGANA,2013,32,Agriculture (Total),0,0,0,0,0,0,0,0,0,0,0,0,0,0,0,0,0,0
TELANGANA,2013,32,Retired Persons,0,0,0,0,0,0,0,0,0,0,0,0,0,0,0,0,0,0
TELANGANA,2014,32,House Wife,0,0,0,0,0,0,0,272,245,123,85,725,0,272,245,123,85,725
TELANGANA,2014,32,Service (Government),0,29,43,31,1,104,0,12,10,5,0,27,0,41,53,36,1,131
TELANGANA,2014,32,Service (Private),0,113,130,41,6,290,0,43,12,2,4,61,0,156,142,43,10,351
TELANGANA,2014,32,Public Sector Undertaking,0,14,37,39,0,90,3,36,9,4,0,52,3,50,46,43,0,142
TELANGANA,2014,32,Students,10,177,4,0,0,191,19,142,1,0,0,162,29,319,5,0,0,353
TELANGANA,2014,32,Unemployed,0,124,92,37,14,267,1,21,11,1,1,35,1,145,103,38,15,302
TELANGANA,2014,32,Agriculture (Total),0,287,421,313,94,1115,1,76,71,55,29,232,1,363,492,368,123,1347
TELANGANA,2014,32,Retired Persons,0,4,1,0,22,27,0,2,0,0,1,3,0,6,1,0,23,30
TOTAL (ALL INDIA),2001,37,House Wife,0,0,0,0,0,0,70,10160,7259,2986,1184,21659,70,10160,7259,2986,1184,21659
TOTAL (ALL INDIA),2001,37,Service (Government),0,386,780,587,21,1774,0,202,232,71,14,519,0,588,1012,658,35,2293
TOTAL (ALL INDIA),2001,37,Service (Private),24,2222,2993,1714,365,7318,60,710,485,298,110,1663,84,2932,3478,2012,475,8981
TOTAL (ALL INDIA),2001,37,Public Sector Undertaking,0,640,644,471,127,1882,0,255,222,96,14,587,0,895,866,567,141,2469
TOTAL (ALL INDIA),2001,37,Students,683,2234,164,27,0,3108,546,1730,66,22,2,2366,1229,3964,230,49,2,5474
TOTAL (ALL INDIA),2001,37,Unemployed,53,2917,2997,1853,595,8415,57,895,601,194,90,1837,110,3812,3598,2047,685,10252
TOTAL (ALL INDIA),2001,37,Professional Activity,21,606,960,542,166,2295,11,108,99,76,23,317,32,714,1059,618,189,2612
TOTAL (ALL INDIA),2001,37,Agriculture (Total),88,3830,5119,3414,1378,13829,80,1028,889,451,138,2586,168,4858,6008,3865,1516,16415
TOTAL (ALL INDIA),2001,37,Retired Persons,0,27,32,140,501,700,0,6,20,46,112,184,0,33,52,186,613,884
TOTAL (ALL INDIA),2002,37,House Wife,0,0,0,0,0,0,30,10484,7654,3284,1278,22730,30,10484,7654,3284,1278,22730
TOTAL (ALL INDIA),2002,37,Service (Government),0,417,771,499,21,1708,0,167,202,125,8,502,0,584,973,624,29,2210
TOTAL (ALL INDIA),2002,37,Service (Private),11,2278,2932,1660,256,7137,14,654,486,224,76,1454,25,2932,3418,1884,332,8591
TOTAL (ALL INDIA),2002,37,Public Sector Undertaking,0,589,684,466,71,1810,0,218,199,99,7,523,0,807,883,565,78,2333
TOTAL (ALL INDIA),2002,37,Students,586,2258,199,19,0,3062,679,1527,86,1,0,2293,1265,3785,285,20,0,5355
TOTAL (ALL INDIA),2002,37,Unemployed,37,3127,2988,1599,619,8370,41,961,560,182,66,1810,78,4088,3548,1781,685,10180
TOTAL (ALL INDIA),2002,37,Professional Activity,1,614,899,550,172,2236,0,67,83,78,13,241,1,681,982,628,185,2477
TOTAL (ALL INDIA),2002,37,Agriculture (Total),30,4134,5651,3958,1535,15308,28,1107,864,503,161,2663,58,5241,6515,4461,1696,17971
TOTAL (ALL INDIA),2002,37,Retired Persons,0,5,19,176,524,724,0,0,14,28,97,139,0,5,33,204,621,863
TOTAL (ALL INDIA),2003,37,House Wife,0,0,0,0,0,0,22,10049,7840,3821,1569,23301,22,10049,7840,3821,1569,23301
TOTAL (ALL INDIA),2003,37,Service (Government),1,491,793,581,23,1889,1,191,178,74,0,444,2,682,971,655,23,2333
TOTAL (ALL INDIA),2003,37,Service (Private),22,1996,2805,1591,234,6648,2,664,528,235,32,1461,24,2660,3333,1826,266,8109
TOTAL (ALL INDIA),2003,37,Public Sector Undertaking,1,710,885,758,48,2402,3,243,157,80,5,488,4,953,1042,838,53,2890
TOTAL (ALL INDIA),2003,37,Students,575,2485,288,37,2,3387,599,1916,174,15,0,2704,1174,4401,462,52,2,6091
TOTAL (ALL INDIA),2003,37,Unemployed,51,3292,3039,1250,533,8165,38,888,492,245,85,1748,89,4180,3531,1495,618,9913
TOTAL (ALL INDIA),2003,37,Professional Activity,6,831,1109,683,164,2793,1,94,101,60,16,272,7,925,1210,743,180,3065
TOTAL (ALL INDIA),2003,37,Agriculture (Total),49,3794,5413,3799,1646,14701,71,1026,823,423,120,2463,120,4820,6236,4222,1766,17164
TOTAL (ALL INDIA),2003,37,Retired Persons,0,10,32,164,694,900,0,9,10,54,89,162,0,19,42,218,783,1062
TOTAL (ALL INDIA),2004,37,House Wife,0,0,0,0,0,0,48,10625,7779,3390,1328,23170,48,10625,7779,3390,1328,23170
TOTAL (ALL INDIA),2004,37,Service (Government),0,371,779,455,17,1622,0,98,96,58,0,252,0,469,875,513,17,1874
TOTAL (ALL INDIA),2004,37,Service (Private),11,1954,2773,1609,216,6563,6,535,394,175,27,1137,17,2489,3167,1784,243,7700
TOTAL (ALL INDIA),2004,37,Public Sector Undertaking,0,532,731,501,41,1805,0,138,155,82,8,383,0,670,886,583,49,2188
TOTAL (ALL INDIA),2004,37,Students,649,2289,170,0,0,3108,626,1830,44,1,1,2502,1275,4119,214,1,1,5610
TOTAL (ALL INDIA),2004,37,Unemployed,42,3081,2819,1424,453,7819,30,868,500,218,103,1719,72,3949,3319,1642,556,9538
TOTAL (ALL INDIA),2004,37,Professional Activity,5,706,936,660,144,2451,1,83,83,44,27,238,6,789,1019,704,171,2689
TOTAL (ALL INDIA),2004,37,Agriculture (Total),26,4075,5997,4147,1684,15929,50,915,773,409,165,2312,76,4990,6770,4556,1849,18241
TOTAL (ALL INDIA),2004,37,Retired Persons,0,0,28,120,675,823,0,0,0,42,74,116,0,0,28,162,749,939
TOTAL (ALL INDIA),2005,37,House Wife,0,0,0,0,0,0,30,10704,7960,3968,1479,24141,30,10704,7960,3968,1479,24141
TOTAL (ALL INDIA),2005,37,Service (Government),0,300,620,514,5,1439,0,85,119,49,1,254,0,385,739,563,6,1693
TOTAL (ALL INDIA),2005,37,Service (Private),20,2514,2987,1766,201,7488,34,637,417,174,64,1326,54,3151,3404,1940,265,8814
TOTAL (ALL INDIA),2005,37,Public Sector Undertaking,0,466,750,519,33,1768,0,150,147,70,8,375,0,616,897,589,41,2143
TOTAL (ALL INDIA),2005,37,Students,584,2145,157,3,0,2889,585,1585,78,1,0,2249,1169,3730,235,4,0,5138
TOTAL (ALL INDIA),2005,37,Unemployed,41,3101,2534,1086,364,7126,15,937,458,158,104,1672,56,4038,2992,1244,468,8798
TOTAL (ALL INDIA),2005,37,Professional Activity,17,627,985,710,152,2491,5,108,49,50,20,232,22,735,1034,760,172,2723
TOTAL (ALL INDIA),2005,37,Agriculture (Total),54,3636,5678,3910,1695,14973,41,759,754,417,187,2158,95,4395,6432,4327,1882,17131
TOTAL (ALL INDIA),2005,37,Retired Persons,0,16,10,164,630,820,0,4,4,15,71,94,0,20,14,179,701,914
TOTAL (ALL INDIA),2006,37,House Wife,0,0,0,0,0,0,40,11317,8379,4031,1296,25063,40,11317,8379,4031,1296,25063
TOTAL (ALL INDIA),2006,37,Service (Government),5,434,815,568,12,1834,0,122,129,54,8,313,5,556,944,622,20,2147
TOTAL (ALL INDIA),2006,37,Service (Private),6,2170,3101,1955,231,7463,0,902,457,200,19,1578,6,3072,3558,2155,250,9041
TOTAL (ALL INDIA),2006,37,Public Sector Undertaking,2,610,935,421,57,2025,3,153,110,106,4,376,5,763,1045,527,61,2401
TOTAL (ALL INDIA),2006,37,Students,562,2421,107,25,8,3123,636,2009,84,5,0,2734,1198,4430,191,30,8,5857
TOTAL (ALL INDIA),2006,37,Unemployed,11,3260,2666,1075,403,7415,7,843,370,168,83,1471,18,4103,3036,1243,486,8886
TOTAL (ALL INDIA),2006,37,Professional Activity,16,852,1359,973,208,3408,5,112,77,35,6,235,21,964,1436,1008,214,3643
TOTAL (ALL INDIA),2006,37,Agriculture (Total),56,3535,5761,3704,1608,14664,58,922,847,429,140,2396,114,4457,6608,4133,1748,17060
TOTAL (ALL INDIA),2006,37,Retired Persons,1,36,39,137,752,965,0,1,6,12,135,154,1,37,45,149,887,1119
TOTAL (ALL INDIA),2007,37,House Wife,0,0,0,0,0,0,49,10925,8184,3644,1360,24162,49,10925,8184,3644,1360,24162
TOTAL (ALL INDIA),2007,37,Service (Government),0,365,658,525,10,1558,1,123,107,53,15,299,1,488,765,578,25,1857
TOTAL (ALL INDIA),2007,37,Service (Private),31,2397,3440,2043,334,8245,6,977,513,260,67,1823,37,3374,3953,2303,401,10068
TOTAL (ALL INDIA),2007,37,Public Sector Undertaking,0,546,995,587,83,2211,6,196,111,122,1,436,6,742,1106,709,84,2647
TOTAL (ALL INDIA),2007,37,Students,603,2644,159,8,2,3416,637,2090,91,6,8,2832,1240,4734,250,14,10,6248
TOTAL (ALL INDIA),2007,37,Unemployed,29,2786,2423,1181,270,6689,32,943,597,192,58,1822,61,3729,3020,1373,328,8511
TOTAL (ALL INDIA),2007,37,Professional Activity,4,780,1228,783,191,2986,9,114,83,31,12,249,13,894,1311,814,203,3235
TOTAL (ALL INDIA),2007,37,Agriculture (Total),46,3266,5467,4066,1664,14509,49,797,707,414,156,2123,95,4063,6174,4480,1820,16632
TOTAL (ALL INDIA),2007,37,Retired Persons,0,37,69,149,664,919,2,8,7,23,89,129,2,45,76,172,753,1048
TOTAL (ALL INDIA),2008,37,House Wife,0,0,0,0,0,0,51,10799,8581,3554,1382,24367,51,10799,8581,3554,1382,24367
TOTAL (ALL INDIA),2008,37,Service (Government),0,325,778,612,14,1729,0,131,136,61,13,341,0,456,914,673,27,2070
TOTAL (ALL INDIA),2008,37,Service (Private),7,2564,3682,2123,306,8682,8,1002,541,219,49,1819,15,3566,4223,2342,355,10501
TOTAL (ALL INDIA),2008,37,Public Sector Undertaking,4,636,1036,777,138,2591,3,219,137,122,35,516,7,855,1173,899,173,3107
TOTAL (ALL INDIA),2008,37,Students,514,2627,188,35,4,3368,573,2053,62,4,0,2692,1087,4680,250,39,4,6060
TOTAL (ALL INDIA),2008,37,Unemployed,43,2955,2521,1325,327,7171,28,922,609,244,27,1830,71,3877,3130,1569,354,9001
TOTAL (ALL INDIA),2008,37,Professional Activity,5,743,1298,786,198,3030,5,174,127,49,20,375,10,917,1425,835,218,3405
TOTAL (ALL INDIA),2008,37,Agriculture (Total),32,3464,5416,3728,1505,14145,39,752,756,368,136,2051,71,4216,6172,4096,1641,16196
TOTAL (ALL INDIA),2008,37,Retired Persons,0,13,35,148,558,754,0,3,6,20,103,132,0,16,41,168,661,886
TOTAL (ALL INDIA),2009,37,House Wife,0,0,0,0,0,0,62,11029,8613,3843,1545,25092,62,11029,8613,3843,1545,25092
TOTAL (ALL INDIA),2009,37,Service (Government),0,279,628,484,25,1416,0,126,111,59,2,298,0,405,739,543,27,1714
TOTAL (ALL INDIA),2009,37,Service (Private),3,2770,3925,2067,388,9153,2,750,510,241,64,1567,5,3520,4435,2308,452,10720
TOTAL (ALL INDIA),2009,37,Public Sector Undertaking,0,722,957,660,136,2475,1,176,145,100,17,439,1,898,1102,760,153,2914
TOTAL (ALL INDIA),2009,37,Students,649,2934,173,12,0,3768,629,2272,89,3,0,2993,1278,5206,262,15,0,6761
TOTAL (ALL INDIA),2009,37,Unemployed,37,2931,3435,1540,445,8388,30,693,433,277,95,1528,67,3624,3868,1817,540,9916
TOTAL (ALL INDIA),2009,37,Professional Activity,20,871,1238,954,199,3282,0,156,125,55,16,352,20,1027,1363,1009,215,3634
TOTAL (ALL INDIA),2009,37,Agriculture (Total),46,3464,5820,4045,1576,14951,27,931,808,482,169,2417,73,4395,6628,4527,1745,17368
TOTAL (ALL INDIA),2009,37,Retired Persons,1,17,29,189,600,836,0,10,46,31,108,195,1,27,75,220,708,1031
TOTAL (ALL INDIA),2010,37,House Wife,0,0,0,0,0,0,58,11008,8564,3798,1630,25058,58,11008,8564,3798,1630,25058
TOTAL (ALL INDIA),2010,37,Service (Government),0,305,649,456,27,1437,0,205,145,52,3,405,0,510,794,508,30,1842
TOTAL (ALL INDIA),2010,37,Service (Private),14,2904,3605,2188,288,8999,9,770,492,193,39,1503,23,3674,4097,2381,327,10502
TOTAL (ALL INDIA),2010,37,Public Sector Undertaking,18,648,1036,630,124,2456,1,175,178,74,16,444,19,823,1214,704,140,2900
TOTAL (ALL INDIA),2010,37,Students,717,3134,137,42,7,4037,693,2568,71,10,0,3342,1410,5702,208,52,7,7379
TOTAL (ALL INDIA),2010,37,Unemployed,52,2964,3182,1483,563,8244,31,895,548,192,123,1789,83,3859,3730,1675,686,10033
TOTAL (ALL INDIA),2010,37,Professional Activity,4,1024,1479,908,291,3706,8,139,134,55,17,353,12,1163,1613,963,308,4059
TOTAL (ALL INDIA),2010,37,Agriculture (Total),58,3416,5082,3616,1420,13592,46,889,759,453,225,2372,104,4305,5841,4069,1645,15964
TOTAL (ALL INDIA),2010,37,Retired Persons,0,16,17,141,578,752,0,12,2,31,101,146,0,28,19,172,679,898
TOTAL (ALL INDIA),2011,37,House Wife,0,0,0,0,0,0,81,10730,8541,3710,1534,24596,81,10730,8541,3710,1534,24596
TOTAL (ALL INDIA),2011,37,Service (Government),0,268,612,439,11,1330,1,128,117,40,10,296,1,396,729,479,21,1626
TOTAL (ALL INDIA),2011,37,Service (Private),7,2965,3932,2205,357,9466,4,781,622,245,54,1706,11,3746,4554,2450,411,11172
TOTAL (ALL INDIA),2011,37,Public Sector Undertaking,8,587,831,607,82,2115,4,266,210,80,9,569,12,853,1041,687,91,2684
TOTAL (ALL INDIA),2011,37,Students,620,3384,171,13,0,4188,566,2838,92,9,3,3508,1186,6222,263,22,3,7696
TOTAL (ALL INDIA),2011,37,Unemployed,65,2918,3479,1722,393,8577,43,921,532,275,71,1842,108,3839,4011,1997,464,10419
TOTAL (ALL INDIA),2011,37,Professional Activity,1,1092,1472,946,254,3765,3,181,127,85,45,441,4,1273,1599,1031,299,4206
TOTAL (ALL INDIA),2011,37,Agriculture (Total),24,2967,4509,3227,1344,12071,19,762,693,391,91,1956,43,3729,5202,3618,1435,14027
TOTAL (ALL INDIA),2011,37,Retired Persons,0,19,23,146,534,722,0,18,6,31,80,135,0,37,29,177,614,857
TOTAL (ALL INDIA),2012,37,House Wife,0,0,0,0,0,0,28,9585,7282,3550,1459,21904,28,9585,7282,3550,1459,21904
TOTAL (ALL INDIA),2012,37,Service (Government),0,267,560,504,27,1358,6,125,127,47,3,308,6,392,687,551,30,1666
TOTAL (ALL INDIA),2012,37,Service (Private),21,3278,3928,2120,341,9688,22,774,532,214,43,1585,43,4052,4460,2334,384,11273
TOTAL (ALL INDIA),2012,37,Public Sector Undertaking,0,480,703,451,82,1716,9,110,187,79,9,394,9,590,890,530,91,2110
TOTAL (ALL INDIA),2012,37,Students,537,2777,141,22,0,3477,571,2469,122,7,8,3177,1108,5246,263,29,8,6654
TOTAL (ALL INDIA),2012,37,Unemployed,38,2451,2682,1775,504,7450,30,693,460,228,66,1477,68,3144,3142,2003,570,8927
TOTAL (ALL INDIA),2012,37,Professional Activity,7,856,1217,835,229,3144,1,136,116,46,13,312,8,992,1333,881,242,3456
TOTAL (ALL INDIA),2012,37,Agriculture (Total),6,2624,4374,3456,1491,11951,18,607,674,356,148,1803,24,3231,5048,3812,1639,13754
TOTAL (ALL INDIA),2012,37,Retired Persons,0,9,19,184,520,732,5,9,2,14,71,101,5,18,21,198,591,833
TOTAL (ALL INDIA),2013,37,House Wife,0,0,0,0,0,0,26,9697,7809,3546,1664,22742,26,9697,7809,3546,1664,22742
TOTAL (ALL INDIA),2013,37,Service (Government),0,305,646,516,52,1519,0,131,97,47,17,292,0,436,743,563,69,1811
TOTAL (ALL INDIA),2013,37,Service (Private),2,3301,4352,2561,481,10697,6,809,552,238,53,1658,8,4110,4904,2799,534,12355
TOTAL (ALL INDIA),2013,37,Public Sector Undertaking,0,633,859,547,102,2141,2,149,164,72,12,399,2,782,1023,619,114,2540
TOTAL (ALL INDIA),2013,37,Students,709,3660,231,23,11,4634,614,3064,90,16,5,3789,1323,6724,321,39,16,8423
TOTAL (ALL INDIA),2013,37,Unemployed,15,2776,3102,1846,532,8271,17,698,467,234,81,1497,32,3474,3569,2080,613,9768
TOTAL (ALL INDIA),2013,37,Professional Activity,4,988,1495,934,210,3631,0,119,105,67,24,315,4,1107,1600,1001,234,3946
TOTAL (ALL INDIA),2013,37,Agriculture (Total),13,2379,3834,3050,1213,10489,9,426,440,257,151,1283,22,2805,4274,3307,1364,11772
TOTAL (ALL INDIA),2013,37,Retired Persons,0,0,44,175,697,916,0,24,19,41,117,201,0,24,63,216,814,1117
TOTAL (ALL INDIA),2014,37,House Wife,0,0,0,0,0,0,17,9498,6743,2669,1221,20148,17,9498,6743,2669,1221,20148
TOTAL (ALL INDIA),2014,37,Service (Government),2,436,782,523,43,1786,0,207,151,48,8,414,2,643,933,571,51,2200
TOTAL (ALL INDIA),2014,37,Service (Private),4,1971,2058,1076,134,5243,1,512,274,134,15,936,5,2483,2332,1210,149,6179
TOTAL (ALL INDIA),2014,37,Public Sector Undertaking,0,421,486,301,32,1240,3,104,46,35,0,188,3,525,532,336,32,1428
TOTAL (ALL INDIA),2014,37,Students,383,3761,102,13,2,4261,379,3366,51,3,8,3807,762,7127,153,16,10,8068
TOTAL (ALL INDIA),2014,37,Unemployed,11,3304,2895,1477,799,8486,8,734,364,173,149,1428,19,4038,3259,1650,948,9914
TOTAL (ALL INDIA),2014,37,Agriculture (Total),2,2789,4193,2849,1056,10889,4,610,454,237,166,1471,6,3399,4647,3086,1222,12360
TOTAL (ALL INDIA),2014,37,Retired Persons,2,30,59,140,559,790,0,13,5,8,54,80,2,43,64,148,613,870
TOTAL (STATES),2001,,House Wife,0,0,0,0,0,0,69,9879,7077,2934,1166,21125,69,9879,7077,2934,1166,21125
TOTAL (STATES),2001,,Service (Government),0,371,751,574,21,1717,0,201,231,70,14,516,0,572,982,644,35,2233
TOTAL (STATES),2001,,Service (Private),24,2107,2881,1655,360,7027,60,692,483,298,110,1643,84,2799,3364,1953,470,8670
TOTAL (STATES),2001,,Public Sector Undertaking,0,628,636,465,126,1855,0,254,222,95,14,585,0,882,858,560,140,2440
TOTAL (STATES),2001,,Students,671,2179,160,27,0,3037,526,1666,66,22,2,2282,1197,3845,226,49,2,5319
TOTAL (STATES),2001,,Unemployed,52,2806,2912,1814,562,8146,51,855,595,194,90,1785,103,3661,3507,2008,652,9931
TOTAL (STATES),2001,,Professional Activity,21,603,955,538,166,2283,11,107,99,76,23,316,32,710,1054,614,189,2599
TOTAL (STATES),2001,,Agriculture (Total),88,3808,5080,3375,1357,13708,80,1021,888,449,138,2576,168,4829,5968,3824,1495,16284
TOTAL (STATES),2001,,Retired Persons,0,27,32,140,497,696,0,6,20,46,112,184,0,33,52,186,609,880
TOTAL (STATES),2002,,House Wife,0,0,0,0,0,0,30,10265,7506,3237,1257,22295,30,10265,7506,3237,1257,22295
TOTAL (STATES),2002,,Service (Government),0,399,745,478,20,1642,0,161,200,125,8,494,0,560,945,603,28,2136
TOTAL (STATES),2002,,Service (Private),11,2156,2763,1569,232,6731,14,639,477,224,75,1429,25,2795,3240,1793,307,8160
TOTAL (STATES),2002,,Public Sector Undertaking,0,588,674,461,71,1794,0,218,199,99,7,523,0,806,873,560,78,2317
TOTAL (STATES),2002,,Students,568,2205,199,19,0,2991,660,1466,78,1,0,2205,1228,3671,277,20,0,5196
TOTAL (STATES),2002,,Unemployed,35,2975,2907,1571,605,8093,39,917,556,181,66,1759,74,3892,3463,1752,671,9852
TOTAL (STATES),2002,,Professional Activity,1,611,896,545,172,2225,0,67,83,78,13,241,1,678,979,623,185,2466
TOTAL (STATES),2002,,Agriculture (Total),30,4109,5596,3917,1513,15165,28,1103,861,503,160,2655,58,5212,6457,4420,1673,17820
TOTAL (STATES),2002,,Retired Persons,0,5,16,173,517,711,0,0,14,27,95,136,0,5,30,200,612,847
TOTAL (STATES),2003,,House Wife,0,0,0,0,0,0,22,9849,7711,3767,1546,22895,22,9849,7711,3767,1546,22895
TOTAL (STATES),2003,,Service (Government),1,481,768,567,22,1839,1,181,175,71,0,428,2,662,943,638,22,2267
TOTAL (STATES),2003,,Service (Private),22,1914,2723,1562,228,6449,2,640,521,235,32,1430,24,2554,3244,1797,260,7879
TOTAL (STATES),2003,,Public Sector Undertaking,1,706,872,752,47,2378,3,242,157,80,5,487,4,948,1029,832,52,2865
TOTAL (STATES),2003,,Students,561,2425,288,37,2,3313,582,1839,171,15,0,2607,1143,4264,459,52,2,5920
TOTAL (STATES),2003,,Unemployed,50,3142,2924,1222,508,7846,36,821,480,235,84,1656,86,3963,3404,1457,592,9502
TOTAL (STATES),2003,,Professional Activity,5,805,1072,665,163,2710,1,93,101,60,16,271,6,898,1173,725,179,2981
TOTAL (STATES),2003,,Agriculture (Total),49,3779,5398,3782,1638,14646,71,1024,823,423,120,2461,120,4803,6221,4205,1758,17107
TOTAL (STATES),2003,,Retired Persons,0,10,32,162,692,896,0,9,10,54,89,162,0,19,42,216,781,1058
TOTAL (STATES),2004,,House Wife,0,0,0,0,0,0,48,10395,7638,3356,1304,22741,48,10395,7638,3356,1304,22741
TOTAL (STATES),2004,,Service (Government),0,365,753,433,17,1568,0,96,94,55,0,245,0,461,847,488,17,1813
TOTAL (STATES),2004,,Service (Private),11,1831,2661,1572,209,6284,6,524,392,175,27,1124,17,2355,3053,1747,236,7408
TOTAL (STATES),2004,,Public Sector Undertaking,0,527,728,499,40,1794,0,135,154,82,8,379,0,662,882,581,48,2173
TOTAL (STATES),2004,,Students,633,2227,170,0,0,3030,609,1755,44,1,1,2410,1242,3982,214,1,1,5440
TOTAL (STATES),2004,,Unemployed,40,2938,2705,1381,428,7492,29,798,476,213,96,1612,69,3736,3181,1594,524,9104
TOTAL (STATES),2004,,Professional Activity,5,695,921,655,142,2418,1,83,83,44,27,238,6,778,1004,699,169,2656
TOTAL (STATES),2004,,Agriculture (Total),26,4050,5947,4091,1672,15786,50,904,762,406,163,2285,76,4954,6709,4497,1835,18071
TOTAL (STATES),2004,,Retired Persons,0,0,28,118,669,815,0,0,0,42,74,116,0,0,28,160,743,931
TOTAL (STATES),2005,,House Wife,0,0,0,0,0,0,30,10468,7786,3907,1458,23649,30,10468,7786,3907,1458,23649
TOTAL (STATES),2005,,Service (Government),0,290,592,489,5,1376,0,80,118,46,1,245,0,370,710,535,6,1621
TOTAL (STATES),2005,,Service (Private),20,2399,2876,1691,186,7172,33,608,413,174,64,1292,53,3007,3289,1865,250,8464
TOTAL (STATES),2005,,Public Sector Undertaking,0,465,742,517,32,1756,0,149,147,70,8,374,0,614,889,587,40,2130
TOTAL (STATES),2005,,Students,575,2085,151,3,0,2814,575,1531,77,1,0,2184,1150,3616,228,4,0,4998
TOTAL (STATES),2005,,Unemployed,40,2956,2448,1036,342,6822,13,874,451,158,92,1588,53,3830,2899,1194,434,8410
TOTAL (STATES),2005,,Professional Activity,17,626,979,705,151,2478,5,107,49,50,20,231,22,733,1028,755,171,2709
TOTAL (STATES),2005,,Agriculture (Total),54,3604,5600,3859,1685,14802,41,758,751,417,187,2154,95,4362,6351,4276,1872,16956
TOTAL (STATES),2005,,Retired Persons,0,16,10,163,624,813,0,4,4,15,71,94,0,20,14,178,695,907
TOTAL (STATES),2006,,House Wife,0,0,0,0,0,0,40,11044,8215,3991,1281,24571,40,11044,8215,3991,1281,24571
TOTAL (STATES),2006,,Service (Government),5,424,783,547,12,1771,0,120,124,54,8,306,5,544,907,601,20,2077
TOTAL (STATES),2006,,Service (Private),6,2013,2940,1885,221,7065,0,879,453,200,19,1551,6,2892,3393,2085,240,8616
TOTAL (STATES),2006,,Public Sector Undertaking,2,600,923,418,56,1999,2,151,110,106,4,373,4,751,1033,524,60,2372
TOTAL (STATES),2006,,Students,553,2345,107,25,8,3038,615,1917,83,5,0,2620,1168,4262,190,30,8,5658
TOTAL (STATES),2006,,Unemployed,10,3084,2551,1032,386,7063,5,788,364,166,76,1399,15,3872,2915,1198,462,8462
TOTAL (STATES),2006,,Professional Activity,16,851,1358,971,208,3404,5,112,77,35,6,235,21,963,1435,1006,214,3639
TOTAL (STATES),2006,,Agriculture (Total),56,3496,5678,3650,1593,14473,58,921,845,426,140,2390,114,4417,6523,4076,1733,16863
TOTAL (STATES),2006,,Retired Persons,1,27,34,135,749,946,0,1,6,12,135,154,1,28,40,147,884,1100
TOTAL (STATES),2007,,House Wife,0,0,0,0,0,0,49,10681,8050,3613,1342,23735,49,10681,8050,3613,1342,23735
TOTAL (STATES),2007,,Service (Government),0,358,631,509,10,1508,1,115,105,53,15,289,1,473,736,562,25,1797
TOTAL (STATES),2007,,Service (Private),30,2264,3313,2002,329,7938,6,950,503,258,67,1784,36,3214,3816,2260,396,9722
TOTAL (STATES),2007,,Public Sector Undertaking,0,542,990,584,83,2199,6,194,111,122,1,434,6,736,1101,706,84,2633
TOTAL (STATES),2007,,Students,591,2555,154,8,2,3310,621,2010,87,6,7,2731,1212,4565,241,14,9,6041
TOTAL (STATES),2007,,Unemployed,28,2639,2319,1149,255,6390,32,860,574,190,53,1709,60,3499,2893,1339,308,8099
TOTAL (STATES),2007,,Professional Activity,4,777,1228,782,191,2982,9,113,83,31,12,248,13,890,1311,813,203,3230
TOTAL (STATES),2007,,Agriculture (Total),46,3220,5366,3996,1644,14272,49,788,701,413,156,2107,95,4008,6067,4409,1800,16379
TOTAL (STATES),2007,,Retired Persons,0,37,69,148,650,904,2,8,7,23,89,129,2,45,76,171,739,1033
TOTAL (STATES),2008,,House Wife,0,0,0,0,0,0,51,10560,8434,3514,1363,23922,51,10560,8434,3514,1363,23922
TOTAL (STATES),2008,,Service (Government),0,318,765,598,14,1695,0,129,132,60,12,333,0,447,897,658,26,2028
TOTAL (STATES),2008,,Service (Private),7,2452,3568,2081,300,8408,8,974,534,217,49,1782,15,3426,4102,2298,349,10190
TOTAL (STATES),2008,,Public Sector Undertaking,4,620,1024,774,134,2556,3,213,137,122,35,510,7,833,1161,896,169,3066
TOTAL (STATES),2008,,Students,499,2544,184,35,4,3266,560,1952,56,4,0,2572,1059,4496,240,39,4,5838
TOTAL (STATES),2008,,Unemployed,42,2822,2411,1286,307,6868,27,852,597,244,27,1747,69,3674,3008,1530,334,8615
TOTAL (STATES),2008,,Professional Activity,5,743,1295,782,197,3022,5,174,127,49,20,375,10,917,1422,831,217,3397
TOTAL (STATES),2008,,Agriculture (Total),32,3451,5388,3713,1497,14081,38,750,755,368,136,2047,70,4201,6143,4081,1633,16128
TOTAL (STATES),2008,,Retired Persons,0,12,35,145,553,745,0,3,6,20,103,132,0,15,41,165,656,877
TOTAL (STATES),2009,,House Wife,0,0,0,0,0,0,62,10751,8459,3792,1524,24588,62,10751,8459,3792,1524,24588
TOTAL (STATES),2009,,Service (Government),0,273,608,461,24,1366,0,125,108,59,2,294,0,398,716,520,26,1660
TOTAL (STATES),2009,,Service (Private),3,2643,3800,2032,383,8861,2,722,500,239,64,1527,5,3365,4300,2271,447,10388
TOTAL (STATES),2009,,Public Sector Undertaking,0,707,940,652,136,2435,1,173,145,100,17,436,1,880,1085,752,153,2871
TOTAL (STATES),2009,,Students,636,2829,171,11,0,3647,609,2183,88,3,0,2883,1245,5012,259,14,0,6530
TOTAL (STATES),2009,,Unemployed,36,2783,3338,1493,416,8066,25,639,422,275,88,1449,61,3422,3760,1768,504,9515
TOTAL (STATES),2009,,Professional Activity,20,850,1214,937,199,3220,0,153,123,54,16,346,20,1003,1337,991,215,3566
TOTAL (STATES),2009,,Agriculture (Total),46,3418,5762,3977,1563,14766,27,929,803,481,169,2409,73,4347,6565,4458,1732,17175
TOTAL (STATES),2009,,Retired Persons,1,17,29,189,590,826,0,10,46,31,108,195,1,27,75,220,698,1021
TOTAL (STATES),2010,,House Wife,0,0,0,0,0,0,58,10725,8389,3749,1608,24529,58,10725,8389,3749,1608,24529
TOTAL (STATES),2010,,Service (Government),0,297,627,441,26,1391,0,198,144,52,3,397,0,495,771,493,29,1788
TOTAL (STATES),2010,,Service (Private),14,2774,3485,2150,274,8697,9,737,484,192,39,1461,23,3511,3969,2342,313,10158
TOTAL (STATES),2010,,Public Sector Undertaking,18,635,1011,623,124,2411,1,170,176,74,16,437,19,805,1187,697,140,2848
TOTAL (STATES),2010,,Students,697,3045,136,42,7,3927,672,2483,68,8,0,3231,1369,5528,204,50,7,7158
TOTAL (STATES),2010,,Unemployed,52,2828,3079,1440,531,7930,28,827,536,192,116,1699,80,3655,3615,1632,647,9629
TOTAL (STATES),2010,,Professional Activity,4,989,1379,840,286,3498,8,137,133,53,16,347,12,1126,1512,893,302,3845
TOTAL (STATES),2010,,Agriculture (Total),58,3411,5069,3608,1415,13561,46,889,759,453,225,2372,104,4300,5828,4061,1640,15933
TOTAL (STATES),2010,,Retired Persons,0,16,17,141,562,736,0,12,2,31,101,146,0,28,19,172,663,882
TOTAL (STATES),2011,,House Wife,0,0,0,0,0,0,81,10501,8387,3668,1515,24152,81,10501,8387,3668,1515,24152
TOTAL (STATES),2011,,Service (Government),0,248,591,423,10,1272,1,121,115,38,10,285,1,369,706,461,20,1557
TOTAL (STATES),2011,,Service (Private),7,2823,3788,2144,352,9114,4,740,611,241,53,1649,11,3563,4399,2385,405,10763
TOTAL (STATES),2011,,Public Sector Undertaking,8,565,824,602,82,2081,4,264,210,79,9,566,12,829,1034,681,91,2647
TOTAL (STATES),2011,,Students,604,3252,171,13,0,4040,544,2725,92,8,3,3372,1148,5977,263,21,3,7412
TOTAL (STATES),2011,,Unemployed,64,2684,3328,1675,364,8115,42,860,520,270,60,1752,106,3544,3848,1945,424,9867
TOTAL (STATES),2011,,Professional Activity,1,1055,1386,891,249,3582,3,181,127,85,45,441,4,1236,1513,976,294,4023
TOTAL (STATES),2011,,Agriculture (Total),24,2961,4500,3220,1343,12048,19,762,693,391,91,1956,43,3723,5193,3611,1434,14004
TOTAL (STATES),2011,,Retired Persons,0,19,23,146,518,706,0,18,5,31,80,134,0,37,28,177,598,840
TOTAL (STATES),2012,,House Wife,0,0,0,0,0,0,28,9330,7100,3493,1428,21379,28,9330,7100,3493,1428,21379
TOTAL (STATES),2012,,Service (Government),0,256,535,476,25,1292,6,122,125,44,3,300,6,378,660,520,28,1592
TOTAL (STATES),2012,,Service (Private),21,3118,3764,2067,332,9302,22,747,530,214,43,1556,43,3865,4294,2281,375,10858
TOTAL (STATES),2012,,Public Sector Undertaking,0,464,681,447,82,1674,9,104,187,79,9,388,9,568,868,526,91,2062
TOTAL (STATES),2012,,Students,514,2630,141,22,0,3307,542,2330,115,7,8,3002,1056,4960,256,29,8,6309
TOTAL (STATES),2012,,Unemployed,35,2246,2558,1735,473,7047,26,636,456,227,60,1405,61,2882,3014,1962,533,8452
TOTAL (STATES),2012,,Professional Activity,7,830,1167,805,223,3032,1,136,112,46,13,308,8,966,1279,851,236,3340
TOTAL (STATES),2012,,Agriculture (Total),6,2612,4368,3448,1490,11924,18,607,674,356,148,1803,24,3219,5042,3804,1638,13727
TOTAL (STATES),2012,,Retired Persons,0,9,18,182,499,708,5,9,2,14,71,101,5,18,20,196,570,809
TOTAL (STATES),2013,,House Wife,0,0,0,0,0,0,26,9465,7664,3504,1638,22297,26,9465,7664,3504,1638,22297
TOTAL (STATES),2013,,Service (Government),0,290,619,481,52,1442,0,126,93,43,17,279,0,416,712,524,69,1721
TOTAL (STATES),2013,,Service (Private),2,3184,4244,2501,470,10401,6,789,544,237,53,1629,8,3973,4788,2738,523,12030
TOTAL (STATES),2013,,Public Sector Undertaking,0,602,826,537,101,2066,2,141,163,71,12,389,2,743,989,608,113,2455
TOTAL (STATES),2013,,Students,689,3520,229,23,11,4472,590,2909,85,16,5,3605,1279,6429,314,39,16,8077
TOTAL (STATES),2013,,Unemployed,15,2608,2971,1787,502,7883,17,666,461,232,80,1456,32,3274,3432,2019,582,9339
TOTAL (STATES),2013,,Professional Activity,4,984,1491,933,207,3619,0,119,105,67,24,315,4,1103,1596,1000,231,3934
TOTAL (STATES),2013,,Agriculture (Total),13,2376,3828,3038,1207,10462,9,425,440,257,151,1282,22,2801,4268,3295,1358,11744
TOTAL (STATES),2013,,Retired Persons,0,0,43,172,676,891,0,24,19,41,117,201,0,24,62,213,793,1092
TOTAL (STATES),2014,,House Wife,0,0,0,0,0,0,17,9314,6646,2641,1206,19824,17,9314,6646,2641,1206,19824
TOTAL (STATES),2014,,Service (Government),2,423,765,515,43,1748,0,193,150,48,8,399,2,616,915,563,51,2147
TOTAL (STATES),2014,,Service (Private),4,1875,1973,1036,126,5014,1,494,265,134,15,909,5,2369,2238,1170,141,5923
TOTAL (STATES),2014,,Public Sector Undertaking,0,407,463,293,32,1195,3,98,46,34,0,181,3,505,509,327,32,1376
TOTAL (STATES),2014,,Students,366,3594,99,13,2,4074,369,3248,51,3,8,3679,735,6842,150,16,10,7753
TOTAL (STATES),2014,,Unemployed,10,3181,2772,1441,789,8193,6,699,349,173,148,1375,16,3880,3121,1614,937,9568
TOTAL (STATES),2014,,Agriculture (Total),2,2784,4183,2844,1053,10866,4,609,454,237,166,1470,6,3393,4637,3081,1219,12336
TOTAL (STATES),2014,,Retired Persons,2,30,59,135,542,768,0,13,5,8,52,78,2,43,64,143,594,846
TOTAL (UTs),2001,,House Wife,0,0,0,0,0,0,1,281,182,52,18,534,1,281,182,52,18,534
TOTAL (UTs),2001,,Service (Government),0,15,29,13,0,57,0,1,1,1,0,3,0,16,30,14,0,60
TOTAL (UTs),2001,,Service (Private),0,115,112,59,5,291,0,18,2,0,0,20,0,133,114,59,5,311
TOTAL (UTs),2001,,Public Sector Undertaking,0,12,8,6,1,27,0,1,0,1,0,2,0,13,8,7,1,29
TOTAL (UTs),2001,,Students,12,55,4,0,0,71,20,64,0,0,0,84,32,119,4,0,0,155
TOTAL (UTs),2001,,Unemployed,1,111,85,39,33,269,6,40,6,0,0,52,7,151,91,39,33,321
TOTAL (UTs),2001,,Professional Activity,0,3,5,4,0,12,0,1,0,0,0,1,0,4,5,4,0,13
TOTAL (UTs),2001,,Agriculture (Total),0,22,39,39,21,121,0,7,1,2,0,10,0,29,40,41,21,131
TOTAL (UTs),2001,,Retired Persons,0,0,0,0,4,4,0,0,0,0,0,0,0,0,0,0,4,4
TOTAL (UTs),2002,,House Wife,0,0,0,0,0,0,0,219,148,47,21,435,0,219,148,47,21,435
TOTAL (UTs),2002,,Service (Government),0,18,26,21,1,66,0,6,2,0,0,8,0,24,28,21,1,74
TOTAL (UTs),2002,,Service (Private),0,122,169,91,24,406,0,15,9,0,1,25,0,137,178,91,25,431
TOTAL (UTs),2002,,Public Sector Undertaking,0,1,10,5,0,16,0,0,0,0,0,0,0,1,10,5,0,16
TOTAL (UTs),2002,,Students,18,53,0,0,0,71,19,61,8,0,0,88,37,114,8,0,0,159
TOTAL (UTs),2002,,Unemployed,2,152,81,28,14,277,2,44,4,1,0,51,4,196,85,29,14,328
TOTAL (UTs),2002,,Professional Activity,0,3,3,5,0,11,0,0,0,0,0,0,0,3,3,5,0,11
TOTAL (UTs),2002,,Agriculture (Total),0,25,55,41,22,143,0,4,3,0,1,8,0,29,58,41,23,151
TOTAL (UTs),2002,,Retired Persons,0,0,3,3,7,13,0,0,0,1,2,3,0,0,3,4,9,16
TOTAL (UTs),2003,,House Wife,0,0,0,0,0,0,0,200,129,54,23,406,0,200,129,54,23,406
TOTAL (UTs),2003,,Service (Government),0,10,25,14,1,50,0,10,3,3,0,16,0,20,28,17,1,66
TOTAL (UTs),2003,,Service (Private),0,82,82,29,6,199,0,24,7,0,0,31,0,106,89,29,6,230
TOTAL (UTs),2003,,Public Sector Undertaking,0,4,13,6,1,24,0,1,0,0,0,1,0,5,13,6,1,25
TOTAL (UTs),2003,,Students,14,60,0,0,0,74,17,77,3,0,0,97,31,137,3,0,0,171
TOTAL (UTs),2003,,Unemployed,1,150,115,28,25,319,2,67,12,10,1,92,3,217,127,38,26,411
TOTAL (UTs),2003,,Professional Activity,1,26,37,18,1,83,0,1,0,0,0,1,1,27,37,18,1,84
TOTAL (UTs),2003,,Agriculture (Total),0,15,15,17,8,55,0,2,0,0,0,2,0,17,15,17,8,57
TOTAL (UTs),2003,,Retired Persons,0,0,0,2,2,4,0,0,0,0,0,0,0,0,0,2,2,4
TOTAL (UTs),2004,,House Wife,0,0,0,0,0,0,0,230,141,34,24,429,0,230,141,34,24,429
TOTAL (UTs),2004,,Service (Government),0,6,26,22,0,54,0,2,2,3,0,7,0,8,28,25,0,61
TOTAL (UTs),2004,,Service (Private),0,123,112,37,7,279,0,11,2,0,0,13,0,134,114,37,7,292
TOTAL (UTs),2004,,Public Sector Undertaking,0,5,3,2,1,11,0,3,1,0,0,4,0,8,4,2,1,15
TOTAL (UTs),2004,,Students,16,62,0,0,0,78,17,75,0,0,0,92,33,137,0,0,0,170
TOTAL (UTs),2004,,Unemployed,2,143,114,43,25,327,1,70,24,5,7,107,3,213,138,48,32,434
TOTAL (UTs),2004,,Professional Activity,0,11,15,5,2,33,0,0,0,0,0,0,0,11,15,5,2,33
TOTAL (UTs),2004,,Agriculture (Total),0,25,50,56,12,143,0,11,11,3,2,27,0,36,61,59,14,170
TOTAL (UTs),2004,,Retired Persons,0,0,0,2,6,8,0,0,0,0,0,0,0,0,0,2,6,8
TOTAL (UTs),2005,,House Wife,0,0,0,0,0,0,0,236,174,61,21,492,0,236,174,61,21,492
TOTAL (UTs),2005,,Service (Government),0,10,28,25,0,63,0,5,1,3,0,9,0,15,29,28,0,72
TOTAL (UTs),2005,,Service (Private),0,115,111,75,15,316,1,29,4,0,0,34,1,144,115,75,15,350
TOTAL (UTs),2005,,Public Sector Undertaking,0,1,8,2,1,12,0,1,0,0,0,1,0,2,8,2,1,13
TOTAL (UTs),2005,,Students,9,60,6,0,0,75,10,54,1,0,0,65,19,114,7,0,0,140
TOTAL (UTs),2005,,Unemployed,1,145,86,50,22,304,2,63,7,0,12,84,3,208,93,50,34,388
TOTAL (UTs),2005,,Professional Activity,0,1,6,5,1,13,0,1,0,0,0,1,0,2,6,5,1,14
TOTAL (UTs),2005,,Agriculture (Total),0,32,78,51,10,171,0,1,3,0,0,4,0,33,81,51,10,175
TOTAL (UTs),2005,,Retired Persons,0,0,0,1,6,7,0,0,0,0,0,0,0,0,0,1,6,7
TOTAL (UTs),2006,,House Wife,0,0,0,0,0,0,0,273,164,40,15,492,0,273,164,40,15,492
TOTAL (UTs),2006,,Service (Government),0,10,32,21,0,63,0,2,5,0,0,7,0,12,37,21,0,70
TOTAL (UTs),2006,,Service (Private),0,157,161,70,10,398,0,23,4,0,0,27,0,180,165,70,10,425
TOTAL (UTs),2006,,Public Sector Undertaking,0,10,12,3,1,26,1,2,0,0,0,3,1,12,12,3,1,29
TOTAL (UTs),2006,,Students,9,76,0,0,0,85,21,92,1,0,0,114,30,168,1,0,0,199
TOTAL (UTs),2006,,Unemployed,1,176,115,43,17,352,2,55,6,2,7,72,3,231,121,45,24,424
TOTAL (UTs),2006,,Professional Activity,0,1,1,2,0,4,0,0,0,0,0,0,0,1,1,2,0,4
TOTAL (UTs),2006,,Agriculture (Total),0,39,83,54,15,191,0,1,2,3,0,6,0,40,85,57,15,197
TOTAL (UTs),2006,,Retired Persons,0,9,5,2,3,19,0,0,0,0,0,0,0,9,5,2,3,19
TOTAL (UTs),2007,,House Wife,0,0,0,0,0,0,0,244,134,31,18,427,0,244,134,31,18,427
TOTAL (UTs),2007,,Service (Government),0,7,27,16,0,50,0,8,2,0,0,10,0,15,29,16,0,60
TOTAL (UTs),2007,,Service (Private),1,133,127,41,5,307,0,27,10,2,0,39,1,160,137,43,5,346
TOTAL (UTs),2007,,Public Sector Undertaking,0,4,5,3,0,12,0,2,0,0,0,2,0,6,5,3,0,14
TOTAL (UTs),2007,,Students,12,89,5,0,0,106,16,80,4,0,1,101,28,169,9,0,1,207
TOTAL (UTs),2007,,Unemployed,1,147,104,32,15,299,0,83,23,2,5,113,1,230,127,34,20,412
TOTAL (UTs),2007,,Professional Activity,0,3,0,1,0,4,0,1,0,0,0,1,0,4,0,1,0,5
TOTAL (UTs),2007,,Agriculture (Total),0,46,101,70,20,237,0,9,6,1,0,16,0,55,107,71,20,253
TOTAL (UTs),2007,,Retired Persons,0,0,0,1,14,15,0,0,0,0,0,0,0,0,0,1,14,15
TOTAL (UTs),2008,,House Wife,0,0,0,0,0,0,0,239,147,40,19,445,0,239,147,40,19,445
TOTAL (UTs),2008,,Service (Government),0,7,13,14,0,34,0,2,4,1,1,8,0,9,17,15,1,42
TOTAL (UTs),2008,,Service (Private),0,112,114,42,6,274,0,28,7,2,0,37,0,140,121,44,6,311
TOTAL (UTs),2008,,Public Sector Undertaking,0,16,12,3,4,35,0,6,0,0,0,6,0,22,12,3,4,41
TOTAL (UTs),2008,,Students,15,83,4,0,0,102,13,101,6,0,0,120,28,184,10,0,0,222
TOTAL (UTs),2008,,Unemployed,1,133,110,39,20,303,1,70,12,0,0,83,2,203,122,39,20,386
TOTAL (UTs),2008,,Professional Activity,0,0,3,4,1,8,0,0,0,0,0,0,0,0,3,4,1,8
TOTAL (UTs),2008,,Agriculture (Total),0,13,28,15,8,64,1,2,1,0,0,4,1,15,29,15,8,68
TOTAL (UTs),2008,,Retired Persons,0,1,0,3,5,9,0,0,0,0,0,0,0,1,0,3,5,9
TOTAL (UTs),2009,,House Wife,0,0,0,0,0,0,0,278,154,51,21,504,0,278,154,51,21,504
TOTAL (UTs),2009,,Service (Government),0,6,20,23,1,50,0,1,3,0,0,4,0,7,23,23,1,54
TOTAL (UTs),2009,,Service (Private),0,127,125,35,5,292,0,28,10,2,0,40,0,155,135,37,5,332
TOTAL (UTs),2009,,Public Sector Undertaking,0,15,17,8,0,40,0,3,0,0,0,3,0,18,17,8,0,43
TOTAL (UTs),2009,,Students,13,105,2,1,0,121,20,89,1,0,0,110,33,194,3,1,0,231
TOTAL (UTs),2009,,Unemployed,1,148,97,47,29,322,5,54,11,2,7,79,6,202,108,49,36,401
TOTAL (UTs),2009,,Professional Activity,0,21,24,17,0,62,0,3,2,1,0,6,0,24,26,18,0,68
TOTAL (UTs),2009,,Agriculture (Total),0,46,58,68,13,185,0,2,5,1,0,8,0,48,63,69,13,193
TOTAL (UTs),2009,,Retired Persons,0,0,0,0,10,10,0,0,0,0,0,0,0,0,0,0,10,10
TOTAL (UTs),2010,,House Wife,0,0,0,0,0,0,0,283,175,49,22,529,0,283,175,49,22,529
TOTAL (UTs),2010,,Service (Government),0,8,22,15,1,46,0,7,1,0,0,8,0,15,23,15,1,54
TOTAL (UTs),2010,,Service (Private),0,130,120,38,14,302,0,33,8,1,0,42,0,163,128,39,14,344
TOTAL (UTs),2010,,Public Sector Undertaking,0,13,25,7,0,45,0,5,2,0,0,7,0,18,27,7,0,52
TOTAL (UTs),2010,,Students,20,89,1,0,0,110,21,85,3,2,0,111,41,174,4,2,0,221
TOTAL (UTs),2010,,Unemployed,0,136,103,43,32,314,3,68,12,0,7,90,3,204,115,43,39,404
TOTAL (UTs),2010,,Professional Activity,0,35,100,68,5,208,0,2,1,2,1,6,0,37,101,70,6,214
TOTAL (UTs),2010,,Agriculture (Total),0,5,13,8,5,31,0,0,0,0,0,0,0,5,13,8,5,31
TOTAL (UTs),2010,,Retired Persons,0,0,0,0,16,16,0,0,0,0,0,0,0,0,0,0,16,16
TOTAL (UTs),2011,,House Wife,0,0,0,0,0,0,0,229,154,42,19,444,0,229,154,42,19,444
TOTAL (UTs),2011,,Service (Government),0,20,21,16,1,58,0,7,2,2,0,11,0,27,23,18,1,69
TOTAL (UTs),2011,,Service (Private),0,142,144,61,5,352,0,41,11,4,1,57,0,183,155,65,6,409
TOTAL (UTs),2011,,Public Sector Undertaking,0,22,7,5,0,34,0,2,0,1,0,3,0,24,7,6,0,37
TOTAL (UTs),2011,,Students,16,132,0,0,0,148,22,113,0,1,0,136,38,245,0,1,0,284
TOTAL (UTs),2011,,Unemployed,1,234,151,47,29,462,1,61,12,5,11,90,2,295,163,52,40,552
TOTAL (UTs),2011,,Professional Activity,0,37,86,55,5,183,0,0,0,0,0,0,0,37,86,55,5,183
TOTAL (UTs),2011,,Agriculture (Total),0,6,9,7,1,23,0,0,0,0,0,0,0,6,9,7,1,23
TOTAL (UTs),2011,,Retired Persons,0,0,0,0,16,16,0,0,1,0,0,1,0,0,1,0,16,17
TOTAL (UTs),2012,,House Wife,0,0,0,0,0,0,0,255,182,57,31,525,0,255,182,57,31,525
TOTAL (UTs),2012,,Service (Government),0,11,25,28,2,66,0,3,2,3,0,8,0,14,27,31,2,74
TOTAL (UTs),2012,,Service (Private),0,160,164,53,9,386,0,27,2,0,0,29,0,187,166,53,9,415
TOTAL (UTs),2012,,Public Sector Undertaking,0,16,22,4,0,42,0,6,0,0,0,6,0,22,22,4,0,48
TOTAL (UTs),2012,,Students,23,147,0,0,0,170,29,139,7,0,0,175,52,286,7,0,0,345
TOTAL (UTs),2012,,Unemployed,3,205,124,40,31,403,4,57,4,1,6,72,7,262,128,41,37,475
TOTAL (UTs),2012,,Professional Activity,0,26,50,30,6,112,0,0,4,0,0,4,0,26,54,30,6,116
TOTAL (UTs),2012,,Agriculture (Total),0,12,6,8,1,27,0,0,0,0,0,0,0,12,6,8,1,27
TOTAL (UTs),2012,,Retired Persons,0,0,1,2,21,24,0,0,0,0,0,0,0,0,1,2,21,24
TOTAL (UTs),2013,,House Wife,0,0,0,0,0,0,0,232,145,42,26,445,0,232,145,42,26,445
TOTAL (UTs),2013,,Service (Government),0,15,27,35,0,77,0,5,4,4,0,13,0,20,31,39,0,90
TOTAL (UTs),2013,,Service (Private),0,117,108,60,11,296,0,20,8,1,0,29,0,137,116,61,11,325
TOTAL (UTs),2013,,Public Sector Undertaking,0,31,33,10,1,75,0,8,1,1,0,10,0,39,34,11,1,85
TOTAL (UTs),2013,,Students,20,140,2,0,0,162,24,155,5,0,0,184,44,295,7,0,0,346
TOTAL (UTs),2013,,Unemployed,0,168,131,59,30,388,0,32,6,2,1,41,0,200,137,61,31,429
TOTAL (UTs),2013,,Professional Activity,0,4,4,1,3,12,0,0,0,0,0,0,0,4,4,1,3,12
TOTAL (UTs),2013,,Agriculture (Total),0,3,6,12,6,27,0,1,0,0,0,1,0,4,6,12,6,28
TOTAL (UTs),2013,,Retired Persons,0,0,1,3,21,25,0,0,0,0,0,0,0,0,1,3,21,25
TOTAL (UTs),2014,,House Wife,0,0,0,0,0,0,0,184,97,28,15,324,0,184,97,28,15,324
TOTAL (UTs),2014,,Service (Government),0,13,17,8,0,38,0,14,1,0,0,15,0,27,18,8,0,53
TOTAL (UTs),2014,,Service (Private),0,96,85,40,8,229,0,18,9,0,0,27,0,114,94,40,8,256
TOTAL (UTs),2014,,Public Sector Undertaking,0,14,23,8,0,45,0,6,0,1,0,7,0,20,23,9,0,52
TOTAL (UTs),2014,,Students,17,167,3,0,0,187,10,118,0,0,0,128,27,285,3,0,0,315
TOTAL (UTs),2014,,Unemployed,1,123,123,36,10,293,2,35,15,0,1,53,3,158,138,36,11,346
TOTAL (UTs),2014,,Agriculture (Total),0,5,10,5,3,23,0,1,0,0,0,1,0,6,10,5,3,24
TOTAL (UTs),2014,,Retired Persons,0,0,0,5,17,22,0,0,0,0,2,2,0,0,0,5,19,24
TRIPURA,2001,33,House Wife,0,0,0,0,0,0,0,20,40,8,3,71,0,20,40,8,3,71
TRIPURA,2001,33,Service (Government),0,0,0,0,0,0,0,0,0,0,0,0,0,0,0,0,0,0
TRIPURA,2001,33,Service (Private),0,2,10,1,0,13,0,0,0,2,0,2,0,2,10,3,0,15
TRIPURA,2001,33,Public Sector Undertaking,0,0,0,0,0,0,0,3,0,0,0,3,0,3,0,0,0,3
TRIPURA,2001,33,Students,10,18,9,0,0,37,5,10,18,0,0,33,15,28,27,0,0,70
TRIPURA,2001,33,Unemployed,2,20,14,2,2,40,2,10,1,1,0,14,4,30,15,3,2,54
TRIPURA,2001,33,Professional Activity,0,4,4,1,0,9,0,2,2,0,0,4,0,6,6,1,0,13
TRIPURA,2001,33,Agriculture (Total),0,10,26,3,2,41,0,0,0,0,0,0,0,10,26,3,2,41
TRIPURA,2001,33,Retired Persons,0,0,0,0,0,0,0,0,0,0,0,0,0,0,0,0,0,0
TRIPURA,2002,33,House Wife,0,0,0,0,0,0,0,54,39,6,5,104,0,54,39,6,5,104
TRIPURA,2002,33,Service (Government),0,5,10,8,0,23,0,5,4,2,0,11,0,10,14,10,0,34
TRIPURA,2002,33,Service (Private),0,10,8,5,0,23,0,4,5,3,0,12,0,14,13,8,0,35
TRIPURA,2002,33,Public Sector Undertaking,0,6,14,3,0,23,0,3,4,2,0,9,0,9,18,5,0,32
TRIPURA,2002,33,Students,4,15,0,0,0,19,4,9,6,0,0,19,8,24,6,0,0,38
TRIPURA,2002,33,Unemployed,1,22,21,9,0,53,2,2,1,0,0,5,3,24,22,9,0,58
TRIPURA,2002,33,Professional Activity,0,10,16,10,4,40,0,0,0,0,0,0,0,10,16,10,4,40
TRIPURA,2002,33,Agriculture (Total),0,8,12,7,0,27,1,3,4,3,3,14,1,11,16,10,3,41
TRIPURA,2002,33,Retired Persons,0,0,0,2,2,4,0,0,0,0,0,0,0,0,0,2,2,4
TRIPURA,2003,33,House Wife,0,0,0,0,0,0,0,52,51,17,0,120,0,52,51,17,0,120
TRIPURA,2003,33,Service (Government),0,12,4,3,0,19,0,3,3,3,0,9,0,15,7,6,0,28
TRIPURA,2003,33,Service (Private),0,14,6,3,0,23,0,2,2,0,0,4,0,16,8,3,0,27
TRIPURA,2003,33,Public Sector Undertaking,0,17,11,7,0,35,0,4,4,2,0,10,0,21,15,9,0,45
TRIPURA,2003,33,Students,7,59,70,21,0,157,2,29,31,11,0,73,9,88,101,32,0,230
TRIPURA,2003,33,Unemployed,0,74,85,49,0,208,3,35,40,24,0,102,3,109,125,73,0,310
TRIPURA,2003,33,Professional Activity,0,0,0,1,0,1,0,3,2,1,0,6,0,3,2,2,0,7
TRIPURA,2003,33,Agriculture (Total),0,0,0,0,0,0,0,2,1,1,0,4,0,2,1,1,0,4
TRIPURA,2003,33,Retired Persons,0,0,0,0,4,4,0,0,0,0,4,4,0,0,0,0,8,8
TRIPURA,2004,33,House Wife,0,0,0,0,0,0,4,85,51,7,5,152,4,85,51,7,5,152
TRIPURA,2004,33,Service (Government),0,3,5,0,0,8,0,0,3,0,0,3,0,3,8,0,0,11
TRIPURA,2004,33,Service (Private),0,2,4,3,2,11,0,0,3,0,0,3,0,2,7,3,2,14
TRIPURA,2004,33,Public Sector Undertaking,0,0,2,2,0,4,0,0,0,0,0,0,0,0,2,2,0,4
TRIPURA,2004,33,Students,4,42,0,0,0,46,18,46,0,0,0,64,22,88,0,0,0,110
TRIPURA,2004,33,Unemployed,0,73,57,39,5,174,0,41,33,8,0,82,0,114,90,47,5,256
TRIPURA,2004,33,Professional Activity,0,16,11,4,0,31,0,0,0,0,0,0,0,16,11,4,0,31
TRIPURA,2004,33,Agriculture (Total),0,5,7,2,1,15,0,0,0,0,0,0,0,5,7,2,1,15
TRIPURA,2004,33,Retired Persons,0,0,0,0,0,0,0,0,0,0,0,0,0,0,0,0,0,0
TRIPURA,2005,33,House Wife,0,0,0,0,0,0,0,47,38,15,4,104,0,47,38,15,4,104
TRIPURA,2005,33,Service (Government),0,3,13,7,0,23,0,5,3,2,0,10,0,8,16,9,0,33
TRIPURA,2005,33,Service (Private),0,8,15,11,0,34,0,6,5,3,0,14,0,14,20,14,0,48
TRIPURA,2005,33,Public Sector Undertaking,0,8,9,5,0,22,0,3,4,5,0,12,0,11,13,10,0,34
TRIPURA,2005,33,Students,6,22,1,0,0,29,8,28,4,0,0,40,14,50,5,0,0,69
TRIPURA,2005,33,Unemployed,0,33,25,14,0,72,0,11,3,2,2,18,0,44,28,16,2,90
TRIPURA,2005,33,Professional Activity,0,8,15,13,5,41,0,0,0,0,0,0,0,8,15,13,5,41
TRIPURA,2005,33,Agriculture (Total),0,14,6,6,3,29,0,0,0,0,0,0,0,14,6,6,3,29
TRIPURA,2005,33,Retired Persons,0,0,0,7,7,14,0,0,0,0,0,0,0,0,0,7,7,14
TRIPURA,2006,33,House Wife,0,0,0,0,0,0,0,72,48,10,3,133,0,72,48,10,3,133
TRIPURA,2006,33,Service (Government),0,1,5,4,0,10,0,0,0,0,0,0,0,1,5,4,0,10
TRIPURA,2006,33,Service (Private),0,2,3,2,0,7,0,0,0,0,0,0,0,2,3,2,0,7
TRIPURA,2006,33,Public Sector Undertaking,0,2,2,2,0,6,0,0,0,0,0,0,0,2,2,2,0,6
TRIPURA,2006,33,Students,4,27,12,0,0,43,7,31,3,0,0,41,11,58,15,0,0,84
TRIPURA,2006,33,Unemployed,0,19,23,3,0,45,0,13,4,0,0,17,0,32,27,3,0,62
TRIPURA,2006,33,Professional Activity,0,3,4,0,0,7,0,0,0,0,0,0,0,3,4,0,0,7
TRIPURA,2006,33,Agriculture (Total),0,0,5,2,0,7,0,0,0,0,0,0,0,0,5,2,0,7
TRIPURA,2006,33,Retired Persons,0,0,0,0,0,0,0,0,0,0,0,0,0,0,0,0,0,0
TRIPURA,2007,33,House Wife,0,0,0,0,0,0,0,49,31,9,4,93,0,49,31,9,4,93
TRIPURA,2007,33,Service (Government),0,3,23,2,0,28,0,3,2,0,0,5,0,6,25,2,0,33
TRIPURA,2007,33,Service (Private),0,2,6,0,0,8,0,0,0,0,0,0,0,2,6,0,0,8
TRIPURA,2007,33,Public Sector Undertaking,0,0,0,0,0,0,0,0,0,0,0,0,0,0,0,0,0,0
TRIPURA,2007,33,Students,14,22,0,0,0,36,16,18,0,0,0,34,30,40,0,0,0,70
TRIPURA,2007,33,Unemployed,0,12,20,9,0,41,0,2,1,0,0,3,0,14,21,9,0,44
TRIPURA,2007,33,Professional Activity,0,0,0,0,0,0,0,0,0,0,0,0,0,0,0,0,0,0
TRIPURA,2007,33,Agriculture (Total),0,0,0,0,0,0,0,0,0,0,0,0,0,0,0,0,0,0
TRIPURA,2007,33,Retired Persons,0,1,0,1,0,2,0,0,0,0,0,0,0,1,0,1,0,2
TRIPURA,2008,33,House Wife,0,0,0,0,0,0,0,56,43,29,2,130,0,56,43,29,2,130
TRIPURA,2008,33,Service (Government),0,3,9,3,0,15,0,0,0,0,0,0,0,3,9,3,0,15
TRIPURA,2008,33,Service (Private),0,4,8,2,0,14,0,0,7,4,0,11,0,4,15,6,0,25
TRIPURA,2008,33,Public Sector Undertaking,0,0,0,2,0,2,0,0,0,0,0,0,0,0,0,2,0,2
TRIPURA,2008,33,Students,9,43,0,0,0,52,13,26,0,0,0,39,22,69,0,0,0,91
TRIPURA,2008,33,Unemployed,0,32,61,27,13,133,0,13,5,0,0,18,0,45,66,27,13,151
TRIPURA,2008,33,Professional Activity,0,0,0,0,0,0,0,0,0,0,0,0,0,0,0,0,0,0
TRIPURA,2008,33,Agriculture (Total),0,10,20,15,0,45,0,0,5,0,0,5,0,10,25,15,0,50
TRIPURA,2008,33,Retired Persons,0,0,0,0,0,0,0,0,0,0,0,0,0,0,0,0,0,0
TRIPURA,2009,33,House Wife,0,0,0,0,0,0,0,93,48,26,9,176,0,93,48,26,9,176
TRIPURA,2009,33,Service (Government),0,5,9,5,0,19,0,0,0,0,0,0,0,5,9,5,0,19
TRIPURA,2009,33,Service (Private),0,9,5,2,3,19,0,0,0,0,0,0,0,9,5,2,3,19
TRIPURA,2009,33,Public Sector Undertaking,0,0,2,0,0,2,0,0,0,0,0,0,0,0,2,0,0,2
TRIPURA,2009,33,Students,8,39,0,0,0,47,8,34,0,0,0,42,16,73,0,0,0,89
TRIPURA,2009,33,Unemployed,0,22,3,0,0,25,0,1,3,0,0,4,0,23,6,0,0,29
TRIPURA,2009,33,Professional Activity,0,5,10,4,1,20,0,0,0,0,0,0,0,5,10,4,1,20
TRIPURA,2009,33,Agriculture (Total),0,11,16,13,5,45,0,0,0,0,0,0,0,11,16,13,5,45
TRIPURA,2009,33,Retired Persons,0,0,0,0,0,0,0,0,0,0,0,0,0,0,0,0,0,0
TRIPURA,2010,33,House Wife,0,0,0,0,0,0,1,72,64,34,23,194,1,72,64,34,23,194
TRIPURA,2010,33,Service (Government),0,2,8,8,0,18,0,0,0,1,0,1,0,2,8,9,0,19
TRIPURA,2010,33,Service (Private),0,14,5,6,5,30,0,0,0,0,0,0,0,14,5,6,5,30
TRIPURA,2010,33,Public Sector Undertaking,0,0,0,0,0,0,0,0,0,0,0,0,0,0,0,0,0,0
TRIPURA,2010,33,Students,15,57,2,0,0,74,14,16,2,0,0,32,29,73,4,0,0,106
TRIPURA,2010,33,Unemployed,0,4,3,14,14,35,0,0,0,0,6,6,0,4,3,14,20,41
TRIPURA,2010,33,Professional Activity,0,5,17,5,3,30,0,0,0,0,0,0,0,5,17,5,3,30
TRIPURA,2010,33,Agriculture (Total),0,11,15,17,3,46,0,1,4,7,0,12,0,12,19,24,3,58
TRIPURA,2010,33,Retired Persons,0,0,0,1,10,11,0,0,0,0,0,0,0,0,0,1,10,11
TRIPURA,2011,33,House Wife,0,0,0,0,0,0,0,29,47,37,27,140,0,29,47,37,27,140
TRIPURA,2011,33,Service (Government),0,0,2,1,0,3,0,0,0,0,0,0,0,0,2,1,0,3
TRIPURA,2011,33,Service (Private),0,10,6,3,1,20,0,0,0,0,0,0,0,10,6,3,1,20
TRIPURA,2011,33,Public Sector Undertaking,0,0,0,0,0,0,0,0,0,0,0,0,0,0,0,0,0,0
TRIPURA,2011,33,Students,2,78,0,0,0,80,5,77,0,0,0,82,7,155,0,0,0,162
TRIPURA,2011,33,Unemployed,0,1,1,0,0,2,0,0,0,0,0,0,0,1,1,0,0,2
TRIPURA,2011,33,Professional Activity,0,0,0,0,0,0,0,0,0,0,0,0,0,0,0,0,0,0
TRIPURA,2011,33,Agriculture (Total),0,5,9,4,2,20,0,0,0,0,0,0,0,5,9,4,2,20
TRIPURA,2011,33,Retired Persons,0,0,0,0,0,0,0,0,0,0,0,0,0,0,0,0,0,0
TRIPURA,2012,33,House Wife,0,0,0,0,0,0,0,44,36,24,24,128,0,44,36,24,24,128
TRIPURA,2012,33,Service (Government),0,1,0,1,0,2,0,0,0,0,0,0,0,1,0,1,0,2
TRIPURA,2012,33,Service (Private),0,3,3,0,0,6,0,0,0,0,0,0,0,3,3,0,0,6
TRIPURA,2012,33,Public Sector Undertaking,0,0,0,0,0,0,0,0,0,0,0,0,0,0,0,0,0,0
TRIPURA,2012,33,Students,7,38,0,0,0,45,4,27,0,0,0,31,11,65,0,0,0,76
TRIPURA,2012,33,Unemployed,0,9,10,6,0,25,0,1,2,0,0,3,0,10,12,6,0,28
TRIPURA,2012,33,Professional Activity,0,0,0,2,4,6,0,0,0,0,0,0,0,0,0,2,4,6
TRIPURA,2012,33,Agriculture (Total),0,5,6,5,2,18,0,0,0,0,0,0,0,5,6,5,2,18
TRIPURA,2012,33,Retired Persons,0,0,0,0,0,0,0,0,0,0,0,0,0,0,0,0,0,0
TRIPURA,2013,33,House Wife,0,0,0,0,0,0,0,72,44,34,13,163,0,72,44,34,13,163
TRIPURA,2013,33,Service (Government),0,1,3,0,0,4,0,0,0,0,0,0,0,1,3,0,0,4
TRIPURA,2013,33,Service (Private),0,2,2,0,0,4,0,0,0,0,0,0,0,2,2,0,0,4
TRIPURA,2013,33,Public Sector Undertaking,0,0,1,0,0,1,0,0,0,0,0,0,0,0,1,0,0,1
TRIPURA,2013,33,Students,8,71,5,0,0,84,4,42,0,0,0,46,12,113,5,0,0,130
TRIPURA,2013,33,Unemployed,0,20,31,5,1,57,0,6,2,1,0,9,0,26,33,6,1,66
TRIPURA,2013,33,Professional Activity,0,0,0,0,0,0,0,0,0,0,0,0,0,0,0,0,0,0
TRIPURA,2013,33,Agriculture (Total),0,4,17,24,11,56,0,0,0,0,0,0,0,4,17,24,11,56
TRIPURA,2013,33,Retired Persons,0,0,0,0,0,0,0,0,0,0,0,0,0,0,0,0,0,0
TRIPURA,2014,33,House Wife,0,0,0,0,0,0,0,55,44,15,9,123,0,55,44,15,9,123
TRIPURA,2014,33,Service (Government),0,5,20,11,0,36,0,3,5,4,2,14,0,8,25,15,2,50
TRIPURA,2014,33,Service (Private),0,2,0,0,0,2,0,0,0,0,0,0,0,2,0,0,0,2
TRIPURA,2014,33,Public Sector Undertaking,0,2,2,2,0,6,0,0,0,0,0,0,0,2,2,2,0,6
TRIPURA,2014,33,Students,7,32,0,0,0,39,3,31,0,0,0,34,10,63,0,0,0,73
TRIPURA,2014,33,Unemployed,0,42,39,16,4,101,0,7,4,1,0,12,0,49,43,17,4,113
TRIPURA,2014,33,Agriculture (Total),0,11,8,9,1,29,0,2,0,1,0,3,0,13,8,10,1,32
TRIPURA,2014,33,Retired Persons,0,0,0,0,3,3,0,0,0,0,2,2,0,0,0,0,5,5
UTTAR PRADESH,2001,34,House Wife,0,0,0,0,0,0,13,577,374,87,24,1075,13,577,374,87,24,1075
UTTAR PRADESH,2001,34,Service (Government),0,8,16,6,1,31,0,15,11,0,0,26,0,23,27,6,1,57
UTTAR PRADESH,2001,34,Service (Private),1,113,85,39,1,239,1,34,23,15,0,73,2,147,108,54,1,312
UTTAR PRADESH,2001,34,Public Sector Undertaking,0,22,11,4,2,39,0,5,2,0,0,7,0,27,13,4,2,46
UTTAR PRADESH,2001,34,Students,38,82,3,0,0,123,20,66,2,0,0,88,58,148,5,0,0,211
UTTAR PRADESH,2001,34,Unemployed,12,167,96,34,7,316,2,12,4,2,0,20,14,179,100,36,7,336
UTTAR PRADESH,2001,34,Professional Activity,0,8,17,9,3,37,0,1,2,1,0,4,0,9,19,10,3,41
UTTAR PRADESH,2001,34,Agriculture (Total),6,175,175,140,82,578,4,39,40,19,8,110,10,214,215,159,90,688
UTTAR PRADESH,2001,34,Retired Persons,0,0,0,2,3,5,0,1,2,1,2,6,0,1,2,3,5,11
UTTAR PRADESH,2002,34,House Wife,0,0,0,0,0,0,8,555,329,157,54,1103,8,555,329,157,54,1103
UTTAR PRADESH,2002,34,Service (Government),0,7,10,3,1,21,0,4,5,0,0,9,0,11,15,3,1,30
UTTAR PRADESH,2002,34,Service (Private),0,82,77,41,0,200,0,14,12,1,0,27,0,96,89,42,0,227
UTTAR PRADESH,2002,34,Public Sector Undertaking,0,11,12,9,0,32,0,1,3,0,0,4,0,12,15,9,0,36
UTTAR PRADESH,2002,34,Students,15,90,11,4,0,120,21,67,8,0,0,96,36,157,19,4,0,216
UTTAR PRADESH,2002,34,Unemployed,1,216,168,53,14,452,4,21,6,2,0,33,5,237,174,55,14,485
UTTAR PRADESH,2002,34,Professional Activity,0,10,7,8,4,29,0,3,3,0,0,6,0,13,10,8,4,35
UTTAR PRADESH,2002,34,Agriculture (Total),7,152,165,107,40,471,4,28,15,5,2,54,11,180,180,112,42,525
UTTAR PRADESH,2002,34,Retired Persons,0,0,2,1,10,13,0,0,0,0,1,1,0,0,2,1,11,14
UTTAR PRADESH,2003,34,House Wife,0,0,0,0,0,0,2,548,310,159,54,1073,2,548,310,159,54,1073
UTTAR PRADESH,2003,34,Service (Government),0,19,15,9,0,43,0,6,10,1,0,17,0,25,25,10,0,60
UTTAR PRADESH,2003,34,Service (Private),4,23,93,46,7,173,0,36,26,11,2,75,4,59,119,57,9,248
UTTAR PRADESH,2003,34,Public Sector Undertaking,1,9,28,12,7,57,0,4,1,0,0,5,1,13,29,12,7,62
UTTAR PRADESH,2003,34,Students,24,93,0,1,0,118,27,64,7,0,0,98,51,157,7,1,0,216
UTTAR PRADESH,2003,34,Unemployed,3,195,141,42,11,392,3,35,16,7,1,62,6,230,157,49,12,454
UTTAR PRADESH,2003,34,Professional Activity,1,34,44,18,9,106,0,7,3,1,0,11,1,41,47,19,9,117
UTTAR PRADESH,2003,34,Agriculture (Total),0,129,132,56,24,341,0,23,16,3,4,46,0,152,148,59,28,387
UTTAR PRADESH,2003,34,Retired Persons,0,0,5,10,14,29,0,7,0,1,1,9,0,7,5,11,15,38
UTTAR PRADESH,2004,34,House Wife,0,0,0,0,0,0,26,643,290,104,27,1090,26,643,290,104,27,1090
UTTAR PRADESH,2004,34,Service (Government),0,12,13,5,0,30,0,2,0,0,0,2,0,14,13,5,0,32
UTTAR PRADESH,2004,34,Service (Private),0,54,75,23,3,155,0,32,29,12,0,73,0,86,104,35,3,228
UTTAR PRADESH,2004,34,Public Sector Undertaking,0,42,26,13,2,83,0,14,14,9,0,37,0,56,40,22,2,120
UTTAR PRADESH,2004,34,Students,28,92,8,0,0,128,20,53,0,0,0,73,48,145,8,0,0,201
UTTAR PRADESH,2004,34,Unemployed,2,135,103,42,13,295,2,57,27,3,3,92,4,192,130,45,16,387
UTTAR PRADESH,2004,34,Professional Activity,0,33,26,21,0,80,0,1,5,1,0,7,0,34,31,22,0,87
UTTAR PRADESH,2004,34,Agriculture (Total),8,128,151,93,21,401,0,51,31,9,4,95,8,179,182,102,25,496
UTTAR PRADESH,2004,34,Retired Persons,0,0,2,2,13,17,0,0,0,1,3,4,0,0,2,3,16,21
UTTAR PRADESH,2005,34,House Wife,0,0,0,0,0,0,0,547,348,119,0,1014,0,547,348,119,0,1014
UTTAR PRADESH,2005,34,Service (Government),0,8,16,11,0,35,0,8,3,2,0,13,0,16,19,13,0,48
UTTAR PRADESH,2005,34,Service (Private),3,74,54,27,6,164,25,29,0,5,36,95,28,103,54,32,42,259
UTTAR PRADESH,2005,34,Public Sector Undertaking,0,18,32,22,0,72,0,23,18,11,0,52,0,41,50,33,0,124
UTTAR PRADESH,2005,34,Students,19,105,16,0,0,140,12,60,7,0,0,79,31,165,23,0,0,219
UTTAR PRADESH,2005,34,Unemployed,2,69,91,26,7,195,0,39,24,9,0,72,2,108,115,35,7,267
UTTAR PRADESH,2005,34,Professional Activity,1,13,17,24,6,61,0,1,2,0,0,3,1,14,19,24,6,64
UTTAR PRADESH,2005,34,Agriculture (Total),3,108,164,103,44,422,1,41,27,15,16,100,4,149,191,118,60,522
UTTAR PRADESH,2005,34,Retired Persons,0,0,0,3,3,6,0,0,0,2,1,3,0,0,0,5,4,9
UTTAR PRADESH,2006,34,House Wife,0,0,0,0,0,0,8,446,186,39,31,710,8,446,186,39,31,710
UTTAR PRADESH,2006,34,Service (Government),0,52,34,20,9,115,0,13,8,8,3,32,0,65,42,28,12,147
UTTAR PRADESH,2006,34,Service (Private),2,79,53,18,3,155,0,27,28,3,0,58,2,106,81,21,3,213
UTTAR PRADESH,2006,34,Public Sector Undertaking,0,9,15,4,0,28,0,13,5,1,0,19,0,22,20,5,0,47
UTTAR PRADESH,2006,34,Students,14,88,0,0,0,102,5,62,2,0,0,69,19,150,2,0,0,171
UTTAR PRADESH,2006,34,Unemployed,1,58,116,17,9,201,0,24,14,1,1,40,1,82,130,18,10,241
UTTAR PRADESH,2006,34,Professional Activity,0,33,20,14,3,70,0,6,3,8,0,17,0,39,23,22,3,87
UTTAR PRADESH,2006,34,Agriculture (Total),1,125,150,49,21,346,6,27,22,6,4,65,7,152,172,55,25,411
UTTAR PRADESH,2006,34,Retired Persons,0,0,0,4,3,7,0,0,0,0,0,0,0,0,0,4,3,7
UTTAR PRADESH,2007,34,House Wife,0,0,0,0,0,0,10,560,312,67,25,974,10,560,312,67,25,974
UTTAR PRADESH,2007,34,Service (Government),0,15,15,9,0,39,0,6,4,1,3,14,0,21,19,10,3,53
UTTAR PRADESH,2007,34,Service (Private),3,72,83,28,5,191,0,26,12,4,1,43,3,98,95,32,6,234
UTTAR PRADESH,2007,34,Public Sector Undertaking,0,10,11,9,3,33,1,8,4,0,0,13,1,18,15,9,3,46
UTTAR PRADESH,2007,34,Students,18,123,7,0,0,148,20,96,8,0,2,126,38,219,15,0,2,274
UTTAR PRADESH,2007,34,Unemployed,5,129,122,49,12,317,1,34,8,2,5,50,6,163,130,51,17,367
UTTAR PRADESH,2007,34,Professional Activity,1,17,31,26,14,89,2,9,0,2,0,13,3,26,31,28,14,102
UTTAR PRADESH,2007,34,Agriculture (Total),3,84,125,123,54,389,5,29,27,20,16,97,8,113,152,143,70,486
UTTAR PRADESH,2007,34,Retired Persons,0,0,0,2,3,5,0,0,0,0,1,1,0,0,0,2,4,6
UTTAR PRADESH,2008,34,House Wife,0,0,0,0,0,0,10,618,337,91,49,1105,10,618,337,91,49,1105
UTTAR PRADESH,2008,34,Service (Government),0,8,15,7,0,30,0,9,5,0,0,14,0,17,20,7,0,44
UTTAR PRADESH,2008,34,Service (Private),0,102,84,4,2,192,0,24,12,5,0,41,0,126,96,9,2,233
UTTAR PRADESH,2008,34,Public Sector Undertaking,0,18,19,5,1,43,0,3,4,4,0,11,0,21,23,9,1,54
UTTAR PRADESH,2008,34,Students,27,148,22,1,2,200,25,125,4,0,0,154,52,273,26,1,2,354
UTTAR PRADESH,2008,34,Unemployed,1,101,90,32,15,239,0,25,17,4,1,47,1,126,107,36,16,286
UTTAR PRADESH,2008,34,Professional Activity,0,6,9,6,1,22,0,7,1,1,0,9,0,13,10,7,1,31
UTTAR PRADESH,2008,34,Agriculture (Total),1,128,267,156,64,616,0,44,59,14,12,129,1,172,326,170,76,745
UTTAR PRADESH,2008,34,Retired Persons,0,0,1,2,3,6,0,0,0,0,0,0,0,0,1,2,3,6
UTTAR PRADESH,2009,34,House Wife,0,0,0,0,0,0,7,605,272,74,48,1006,7,605,272,74,48,1006
UTTAR PRADESH,2009,34,Service (Government),0,10,15,6,0,31,0,11,4,3,0,18,0,21,19,9,0,49
UTTAR PRADESH,2009,34,Service (Private),0,95,112,47,7,261,0,42,36,8,0,86,0,137,148,55,7,347
UTTAR PRADESH,2009,34,Public Sector Undertaking,0,16,12,22,0,50,0,16,7,0,0,23,0,32,19,22,0,73
UTTAR PRADESH,2009,34,Students,21,172,10,0,0,203,29,107,7,0,0,143,50,279,17,0,0,346
UTTAR PRADESH,2009,34,Unemployed,5,135,118,48,13,319,1,21,20,7,3,52,6,156,138,55,16,371
UTTAR PRADESH,2009,34,Professional Activity,0,7,8,5,1,21,0,1,1,0,0,2,0,8,9,5,1,23
UTTAR PRADESH,2009,34,Agriculture (Total),6,121,253,96,48,524,0,59,28,24,21,132,6,180,281,120,69,656
UTTAR PRADESH,2009,34,Retired Persons,0,2,0,0,2,4,0,0,11,0,0,11,0,2,11,0,2,15
UTTAR PRADESH,2010,34,House Wife,0,0,0,0,0,0,8,480,350,105,62,1005,8,480,350,105,62,1005
UTTAR PRADESH,2010,34,Service (Government),0,14,16,7,1,38,0,60,9,6,0,75,0,74,25,13,1,113
UTTAR PRADESH,2010,34,Service (Private),0,90,51,42,5,188,4,37,20,8,1,70,4,127,71,50,6,258
UTTAR PRADESH,2010,34,Public Sector Undertaking,0,5,7,4,0,16,0,3,2,1,0,6,0,8,9,5,0,22
UTTAR PRADESH,2010,34,Students,13,131,10,2,0,156,29,132,0,0,0,161,42,263,10,2,0,317
UTTAR PRADESH,2010,34,Unemployed,5,95,88,32,12,232,0,23,24,9,0,56,5,118,112,41,12,288
UTTAR PRADESH,2010,34,Professional Activity,0,32,21,9,5,67,0,0,0,0,0,0,0,32,21,9,5,67
UTTAR PRADESH,2010,34,Agriculture (Total),2,110,171,116,33,432,4,54,31,19,8,116,6,164,202,135,41,548
UTTAR PRADESH,2010,34,Retired Persons,0,0,0,4,8,12,0,1,0,2,1,4,0,1,0,6,9,16
UTTAR PRADESH,2011,34,House Wife,0,0,0,0,0,0,24,739,327,109,45,1244,24,739,327,109,45,1244
UTTAR PRADESH,2011,34,Service (Government),0,11,21,16,0,48,0,22,17,2,0,41,0,33,38,18,0,89
UTTAR PRADESH,2011,34,Service (Private),0,133,127,57,2,319,0,29,46,4,0,79,0,162,173,61,2,398
UTTAR PRADESH,2011,34,Public Sector Undertaking,0,4,4,8,0,16,0,2,2,0,0,4,0,6,6,8,0,20
UTTAR PRADESH,2011,34,Students,17,122,10,4,0,153,16,89,1,0,0,106,33,211,11,4,0,259
UTTAR PRADESH,2011,34,Unemployed,1,132,86,29,11,259,3,22,27,9,2,63,4,154,113,38,13,322
UTTAR PRADESH,2011,34,Professional Activity,0,30,54,27,2,113,0,4,3,2,0,9,0,34,57,29,2,122
UTTAR PRADESH,2011,34,Agriculture (Total),3,152,199,118,81,553,4,32,36,12,8,92,7,184,235,130,89,645
UTTAR PRADESH,2011,34,Retired Persons,0,0,2,1,3,6,0,2,0,0,1,3,0,2,2,1,4,9
UTTAR PRADESH,2012,34,House Wife,0,0,0,0,0,0,7,546,393,98,33,1077,7,546,393,98,33,1077
UTTAR PRADESH,2012,34,Service (Government),0,24,23,15,0,62,4,10,12,1,0,27,4,34,35,16,0,89
UTTAR PRADESH,2012,34,Service (Private),1,94,142,73,15,325,14,93,24,14,0,145,15,187,166,87,15,470
UTTAR PRADESH,2012,34,Public Sector Undertaking,0,12,8,11,0,31,0,6,10,9,0,25,0,18,18,20,0,56
UTTAR PRADESH,2012,34,Students,20,122,11,1,0,154,15,104,31,0,1,151,35,226,42,1,1,305
UTTAR PRADESH,2012,34,Unemployed,2,98,80,26,3,209,0,21,15,1,0,37,2,119,95,27,3,246
UTTAR PRADESH,2012,34,Professional Activity,0,22,53,28,22,125,0,5,0,0,0,5,0,27,53,28,22,130
UTTAR PRADESH,2012,34,Agriculture (Total),2,161,230,170,56,619,2,36,44,27,17,126,4,197,274,197,73,745
UTTAR PRADESH,2012,34,Retired Persons,0,0,2,1,5,8,0,0,0,0,2,2,0,0,2,1,7,10
UTTAR PRADESH,2013,34,House Wife,0,0,0,0,0,0,5,605,375,145,40,1170,5,605,375,145,40,1170
UTTAR PRADESH,2013,34,Service (Government),0,8,22,13,2,45,0,11,5,2,0,18,0,19,27,15,2,63
UTTAR PRADESH,2013,34,Service (Private),0,151,186,97,12,446,0,67,39,20,1,127,0,218,225,117,13,573
UTTAR PRADESH,2013,34,Public Sector Undertaking,0,36,31,19,4,90,1,10,6,4,1,22,1,46,37,23,5,112
UTTAR PRADESH,2013,34,Students,41,154,26,6,0,227,20,149,7,2,0,178,61,303,33,8,0,405
UTTAR PRADESH,2013,34,Unemployed,3,111,100,83,16,313,2,16,22,17,0,57,5,127,122,100,16,370
UTTAR PRADESH,2013,34,Professional Activity,0,26,29,13,0,68,0,4,3,0,0,7,0,30,32,13,0,75
UTTAR PRADESH,2013,34,Agriculture (Total),5,215,235,156,33,644,5,39,49,11,2,106,10,254,284,167,35,750
UTTAR PRADESH,2013,34,Retired Persons,0,0,2,0,7,9,0,0,5,1,3,9,0,0,7,1,10,18
UTTAR PRADESH,2014,34,House Wife,0,0,0,0,0,0,4,576,212,38,5,835,4,576,212,38,5,835
UTTAR PRADESH,2014,34,Service (Government),1,9,24,9,0,43,0,6,4,0,0,10,1,15,28,9,0,53
UTTAR PRADESH,2014,34,Service (Private),0,35,29,14,3,81,0,14,4,2,0,20,0,49,33,16,3,101
UTTAR PRADESH,2014,34,Public Sector Undertaking,0,8,27,7,1,43,0,4,4,0,0,8,0,12,31,7,1,51
UTTAR PRADESH,2014,34,Students,7,138,9,1,0,155,12,83,2,0,0,97,19,221,11,1,0,252
UTTAR PRADESH,2014,34,Unemployed,1,215,133,34,7,390,0,39,12,5,0,56,1,254,145,39,7,446
UTTAR PRADESH,2014,34,Agriculture (Total),0,48,79,28,10,165,0,17,7,3,0,27,0,65,86,31,10,192
UTTAR PRADESH,2014,34,Retired Persons,2,3,9,3,4,21,0,3,0,0,0,3,2,6,9,3,4,24
UTTARAKHAND,2001,35,House Wife,0,0,0,0,0,0,0,30,24,8,2,64,0,30,24,8,2,64
UTTARAKHAND,2001,35,Service (Government),0,2,6,2,0,10,0,9,1,0,0,10,0,11,7,2,0,20
UTTARAKHAND,2001,35,Service (Private),1,3,41,18,2,65,3,9,5,0,0,17,4,12,46,18,2,82
UTTARAKHAND,2001,35,Public Sector Undertaking,0,1,1,0,0,2,0,0,0,0,0,0,0,1,1,0,0,2
UTTARAKHAND,2001,35,Students,2,10,0,0,0,12,1,8,0,0,0,9,3,18,0,0,0,21
UTTARAKHAND,2001,35,Unemployed,0,10,18,0,0,28,0,3,0,1,0,4,0,13,18,1,0,32
UTTARAKHAND,2001,35,Professional Activity,0,0,0,0,0,0,0,0,0,0,0,0,0,0,0,0,0,0
UTTARAKHAND,2001,35,Agriculture (Total),0,3,9,5,1,18,0,2,1,0,0,3,0,5,10,5,1,21
UTTARAKHAND,2001,35,Retired Persons,0,0,0,2,0,2,0,0,0,0,0,0,0,0,0,2,0,2
UTTARAKHAND,2002,35,House Wife,0,0,0,0,0,0,1,58,44,14,2,119,1,58,44,14,2,119
UTTARAKHAND,2002,35,Service (Government),0,2,2,1,0,5,0,1,1,0,0,2,0,3,3,1,0,7
UTTARAKHAND,2002,35,Service (Private),0,12,12,1,0,25,0,2,0,0,0,2,0,14,12,1,0,27
UTTARAKHAND,2002,35,Public Sector Undertaking,0,1,0,0,0,1,0,0,0,0,0,0,0,1,0,0,0,1
UTTARAKHAND,2002,35,Students,2,4,0,0,0,6,0,3,0,0,0,3,2,7,0,0,0,9
UTTARAKHAND,2002,35,Unemployed,1,18,9,7,3,38,1,4,1,0,1,7,2,22,10,7,4,45
UTTARAKHAND,2002,35,Professional Activity,0,3,1,0,0,4,0,0,0,0,0,0,0,3,1,0,0,4
UTTARAKHAND,2002,35,Agriculture (Total),0,10,14,3,4,31,0,2,1,0,0,3,0,12,15,3,4,34
UTTARAKHAND,2002,35,Retired Persons,0,0,0,5,0,5,0,0,0,0,0,0,0,0,0,5,0,5
UTTARAKHAND,2003,35,House Wife,0,0,0,0,0,0,0,49,21,10,1,81,0,49,21,10,1,81
UTTARAKHAND,2003,35,Service (Government),0,4,6,4,0,14,0,1,0,0,0,1,0,5,6,4,0,15
UTTARAKHAND,2003,35,Service (Private),0,19,29,12,0,60,0,12,3,0,0,15,0,31,32,12,0,75
UTTARAKHAND,2003,35,Public Sector Undertaking,0,1,1,0,0,2,0,0,4,1,0,5,0,1,5,1,0,7
UTTARAKHAND,2003,35,Students,0,9,0,0,0,9,1,7,0,0,0,8,1,16,0,0,0,17
UTTARAKHAND,2003,35,Unemployed,0,30,15,10,0,55,0,0,0,0,0,0,0,30,15,10,0,55
UTTARAKHAND,2003,35,Professional Activity,0,5,2,2,0,9,0,0,1,0,0,1,0,5,3,2,0,10
UTTARAKHAND,2003,35,Agriculture (Total),0,14,14,10,1,39,0,1,1,0,0,2,0,15,15,10,1,41
UTTARAKHAND,2003,35,Retired Persons,0,0,0,1,0,1,0,0,0,0,0,0,0,0,0,1,0,1
UTTARAKHAND,2004,35,House Wife,0,0,0,0,0,0,0,37,18,8,0,63,0,37,18,8,0,63
UTTARAKHAND,2004,35,Service (Government),0,0,5,2,0,7,0,0,0,0,0,0,0,0,5,2,0,7
UTTARAKHAND,2004,35,Service (Private),0,10,6,2,0,18,0,2,1,0,0,3,0,12,7,2,0,21
UTTARAKHAND,2004,35,Public Sector Undertaking,0,0,0,0,0,0,0,0,0,0,0,0,0,0,0,0,0,0
UTTARAKHAND,2004,35,Students,1,6,0,0,0,7,0,9,0,0,0,9,1,15,0,0,0,16
UTTARAKHAND,2004,35,Unemployed,0,10,10,5,1,26,0,1,0,0,0,1,0,11,10,5,1,27
UTTARAKHAND,2004,35,Professional Activity,0,0,0,0,0,0,0,0,1,0,0,1,0,0,1,0,0,1
UTTARAKHAND,2004,35,Agriculture (Total),0,2,11,4,1,18,0,3,1,0,0,4,0,5,12,4,1,22
UTTARAKHAND,2004,35,Retired Persons,0,0,1,0,0,1,0,0,0,0,0,0,0,0,1,0,0,1
UTTARAKHAND,2005,35,House Wife,0,0,0,0,0,0,0,44,20,3,0,67,0,44,20,3,0,67
UTTARAKHAND,2005,35,Service (Government),0,2,3,2,0,7,0,0,0,0,0,0,0,2,3,2,0,7
UTTARAKHAND,2005,35,Service (Private),0,7,7,3,0,17,0,2,1,0,0,3,0,9,8,3,0,20
UTTARAKHAND,2005,35,Public Sector Undertaking,0,3,3,0,0,6,0,1,0,0,0,1,0,4,3,0,0,7
UTTARAKHAND,2005,35,Students,0,8,0,0,0,8,3,3,0,0,0,6,3,11,0,0,0,14
UTTARAKHAND,2005,35,Unemployed,0,19,18,6,0,43,0,0,1,0,0,1,0,19,19,6,0,44
UTTARAKHAND,2005,35,Professional Activity,0,2,4,4,0,10,0,0,0,0,0,0,0,2,4,4,0,10
UTTARAKHAND,2005,35,Agriculture (Total),0,4,4,5,2,15,0,3,3,3,0,9,0,7,7,8,2,24
UTTARAKHAND,2005,35,Retired Persons,0,0,0,1,2,3,0,0,0,0,0,0,0,0,0,1,2,3
UTTARAKHAND,2006,35,House Wife,0,0,0,0,0,0,0,43,33,8,2,86,0,43,33,8,2,86
UTTARAKHAND,2006,35,Service (Government),0,4,7,2,0,13,0,0,0,1,0,1,0,4,7,3,0,14
UTTARAKHAND,2006,35,Service (Private),0,4,9,4,1,18,0,3,4,1,1,9,0,7,13,5,2,27
UTTARAKHAND,2006,35,Public Sector Undertaking,0,1,3,2,0,6,0,3,2,1,0,6,0,4,5,3,0,12
UTTARAKHAND,2006,35,Students,0,4,0,0,0,4,1,6,3,0,0,10,1,10,3,0,0,14
UTTARAKHAND,2006,35,Unemployed,0,6,6,5,2,19,0,2,2,1,0,5,0,8,8,6,2,24
UTTARAKHAND,2006,35,Professional Activity,0,0,4,2,0,6,0,2,1,0,0,3,0,2,5,2,0,9
UTTARAKHAND,2006,35,Agriculture (Total),0,10,12,10,1,33,0,9,8,1,0,18,0,19,20,11,1,51
UTTARAKHAND,2006,35,Retired Persons,0,0,0,0,4,4,0,0,0,0,0,0,0,0,0,0,4,4
UTTARAKHAND,2007,35,House Wife,0,0,0,0,0,0,0,40,19,6,2,67,0,40,19,6,2,67
UTTARAKHAND,2007,35,Service (Government),0,1,4,0,0,5,0,2,0,0,0,2,0,3,4,0,0,7
UTTARAKHAND,2007,35,Service (Private),0,8,14,4,0,26,0,3,2,0,0,5,0,11,16,4,0,31
UTTARAKHAND,2007,35,Public Sector Undertaking,0,2,10,1,0,13,0,3,3,0,0,6,0,5,13,1,0,19
UTTARAKHAND,2007,35,Students,1,5,2,0,0,8,3,4,0,0,0,7,4,9,2,0,0,15
UTTARAKHAND,2007,35,Unemployed,1,8,8,3,0,20,1,2,3,0,0,6,2,10,11,3,0,26
UTTARAKHAND,2007,35,Professional Activity,0,0,3,1,0,4,0,1,0,0,0,1,0,1,3,1,0,5
UTTARAKHAND,2007,35,Agriculture (Total),0,7,9,2,0,18,0,6,2,2,0,10,0,13,11,4,0,28
UTTARAKHAND,2007,35,Retired Persons,0,0,0,0,0,0,0,0,0,0,0,0,0,0,0,0,0,0
UTTARAKHAND,2008,35,House Wife,0,0,0,0,0,0,0,32,8,4,0,44,0,32,8,4,0,44
UTTARAKHAND,2008,35,Service (Government),0,4,2,1,0,7,0,0,0,0,0,0,0,4,2,1,0,7
UTTARAKHAND,2008,35,Service (Private),1,7,7,2,0,17,0,3,2,1,0,6,1,10,9,3,0,23
UTTARAKHAND,2008,35,Public Sector Undertaking,0,2,2,1,0,5,0,0,0,1,0,1,0,2,2,2,0,6
UTTARAKHAND,2008,35,Students,0,4,2,0,0,6,2,5,0,0,0,7,2,9,2,0,0,13
UTTARAKHAND,2008,35,Unemployed,0,5,0,0,0,5,0,1,1,0,0,2,0,6,1,0,0,7
UTTARAKHAND,2008,35,Professional Activity,0,0,0,0,0,0,0,0,0,0,0,0,0,0,0,0,0,0
UTTARAKHAND,2008,35,Agriculture (Total),0,6,10,5,0,21,0,4,2,1,0,7,0,10,12,6,0,28
UTTARAKHAND,2008,35,Retired Persons,0,0,0,3,0,3,0,0,0,0,0,0,0,0,0,3,0,3
UTTARAKHAND,2009,35,House Wife,0,0,0,0,0,0,0,42,25,7,1,75,0,42,25,7,1,75
UTTARAKHAND,2009,35,Service (Government),0,3,1,4,0,8,0,0,0,0,0,0,0,3,1,4,0,8
UTTARAKHAND,2009,35,Service (Private),0,15,9,9,0,33,0,2,4,0,0,6,0,17,13,9,0,39
UTTARAKHAND,2009,35,Public Sector Undertaking,0,3,1,2,0,6,0,0,0,2,0,2,0,3,1,4,0,8
UTTARAKHAND,2009,35,Students,1,20,0,0,0,21,3,16,0,0,0,19,4,36,0,0,0,40
UTTARAKHAND,2009,35,Unemployed,0,10,16,5,0,31,0,4,1,0,0,5,0,14,17,5,0,36
UTTARAKHAND,2009,35,Professional Activity,0,2,8,14,3,27,0,5,2,0,0,7,0,7,10,14,3,34
UTTARAKHAND,2009,35,Agriculture (Total),0,10,9,4,3,26,0,4,0,0,0,4,0,14,9,4,3,30
UTTARAKHAND,2009,35,Retired Persons,1,12,7,17,5,42,0,6,8,6,0,20,1,18,15,23,5,62
UTTARAKHAND,2010,35,House Wife,0,0,0,0,0,0,0,28,18,6,2,54,0,28,18,6,2,54
UTTARAKHAND,2010,35,Service (Government),0,4,6,1,0,11,0,1,2,0,0,3,0,5,8,1,0,14
UTTARAKHAND,2010,35,Service (Private),0,7,10,4,0,21,0,3,0,0,0,3,0,10,10,4,0,24
UTTARAKHAND,2010,35,Public Sector Undertaking,0,0,0,0,0,0,0,1,0,0,0,1,0,1,0,0,0,1
UTTARAKHAND,2010,35,Students,2,8,0,0,0,10,4,20,0,0,0,24,6,28,0,0,0,34
UTTARAKHAND,2010,35,Unemployed,0,14,0,5,0,19,0,1,2,0,0,3,0,15,2,5,0,22
UTTARAKHAND,2010,35,Professional Activity,0,0,1,0,0,1,0,0,0,0,0,0,0,0,1,0,0,1
UTTARAKHAND,2010,35,Agriculture (Total),0,8,14,7,4,33,0,4,2,0,0,6,0,12,16,7,4,39
UTTARAKHAND,2010,35,Retired Persons,0,0,0,3,0,3,0,0,0,0,0,0,0,0,0,3,0,3
UTTARAKHAND,2011,35,House Wife,0,0,0,0,0,0,0,23,24,3,1,51,0,23,24,3,1,51
UTTARAKHAND,2011,35,Service (Government),0,5,9,3,0,17,0,2,0,0,0,2,0,7,9,3,0,19
UTTARAKHAND,2011,35,Service (Private),0,11,18,2,0,31,0,4,2,0,0,6,0,15,20,2,0,37
UTTARAKHAND,2011,35,Public Sector Undertaking,0,2,1,1,1,5,0,4,0,0,0,4,0,6,1,1,1,9
UTTARAKHAND,2011,35,Students,3,9,1,0,0,13,1,16,0,0,0,17,4,25,1,0,0,30
UTTARAKHAND,2011,35,Unemployed,1,12,13,7,3,36,0,3,2,0,0,5,1,15,15,7,3,41
UTTARAKHAND,2011,35,Professional Activity,0,1,2,0,0,3,0,0,0,0,0,0,0,1,2,0,0,3
UTTARAKHAND,2011,35,Agriculture (Total),0,10,2,9,1,22,0,2,1,0,0,3,0,12,3,9,1,25
UTTARAKHAND,2011,35,Retired Persons,0,0,1,0,3,4,0,0,0,0,0,0,0,0,1,0,3,4
UTTARAKHAND,2012,35,House Wife,0,0,0,0,0,0,0,43,15,2,3,63,0,43,15,2,3,63
UTTARAKHAND,2012,35,Service (Government),0,1,6,0,0,7,0,0,0,0,0,0,0,1,6,0,0,7
UTTARAKHAND,2012,35,Service (Private),0,11,21,13,0,45,0,1,1,0,0,2,0,12,22,13,0,47
UTTARAKHAND,2012,35,Public Sector Undertaking,0,0,5,2,0,7,1,0,0,0,0,1,1,0,5,2,0,8
UTTARAKHAND,2012,35,Students,1,8,2,0,0,11,1,6,2,0,0,9,2,14,4,0,0,20
UTTARAKHAND,2012,35,Unemployed,0,10,11,0,0,21,0,4,1,0,0,5,0,14,12,0,0,26
UTTARAKHAND,2012,35,Professional Activity,0,0,0,1,0,1,0,0,0,0,0,0,0,0,0,1,0,1
UTTARAKHAND,2012,35,Agriculture (Total),0,3,5,1,3,12,0,1,1,0,0,2,0,4,6,1,3,14
UTTARAKHAND,2012,35,Retired Persons,0,0,0,0,0,0,0,0,0,0,0,0,0,0,0,0,0,0
UTTARAKHAND,2013,35,House Wife,0,0,0,0,0,0,0,14,9,10,1,34,0,14,9,10,1,34
UTTARAKHAND,2013,35,Service (Government),0,5,4,4,1,14,0,0,0,0,0,0,0,5,4,4,1,14
UTTARAKHAND,2013,35,Service (Private),0,12,15,5,1,33,0,2,0,0,0,2,0,14,15,5,1,35
UTTARAKHAND,2013,35,Public Sector Undertaking,0,4,3,1,0,8,0,0,0,0,0,0,0,4,3,1,0,8
UTTARAKHAND,2013,35,Students,0,24,0,1,0,25,0,15,0,0,0,15,0,39,0,1,0,40
UTTARAKHAND,2013,35,Unemployed,0,16,5,4,0,25,0,2,0,0,0,2,0,18,5,4,0,27
UTTARAKHAND,2013,35,Professional Activity,0,0,0,0,0,0,0,0,0,0,0,0,0,0,0,0,0,0
UTTARAKHAND,2013,35,Agriculture (Total),0,4,6,4,0,14,0,0,1,0,0,1,0,4,7,4,0,15
UTTARAKHAND,2013,35,Retired Persons,0,0,0,2,2,4,0,0,0,0,0,0,0,0,0,2,2,4
UTTARAKHAND,2014,35,House Wife,0,0,0,0,0,0,0,19,12,3,0,34,0,19,12,3,0,34
UTTARAKHAND,2014,35,Service (Government),0,2,0,0,0,2,0,0,0,0,0,0,0,2,0,0,0,2
UTTARAKHAND,2014,35,Service (Private),0,21,2,0,0,23,0,0,0,0,0,0,0,21,2,0,0,23
UTTARAKHAND,2014,35,Public Sector Undertaking,0,4,2,1,0,7,0,0,0,0,0,0,0,4,2,1,0,7
UTTARAKHAND,2014,35,Students,1,25,0,0,0,26,0,7,0,0,0,7,1,32,0,0,0,33
UTTARAKHAND,2014,35,Unemployed,0,14,5,4,3,26,0,3,0,0,0,3,0,17,5,4,3,29
UTTARAKHAND,2014,35,Agriculture (Total),0,0,0,0,0,0,0,0,0,0,0,0,0,0,0,0,0,0
UTTARAKHAND,2014,35,Retired Persons,0,0,0,0,0,0,0,0,0,0,0,0,0,0,0,0,0,0
WEST BENGAL,2001,36,House Wife,0,0,0,0,0,0,0,653,588,242,72,1555,0,653,588,242,72,1555
WEST BENGAL,2001,36,Service (Government),0,42,65,68,7,182,0,38,65,13,5,121,0,80,130,81,12,303
WEST BENGAL,2001,36,Service (Private),16,229,366,335,49,995,41,118,121,97,48,425,57,347,487,432,97,1420
WEST BENGAL,2001,36,Public Sector Undertaking,0,170,111,137,55,473,0,93,104,64,8,269,0,263,215,201,63,742
WEST BENGAL,2001,36,Students,132,263,2,0,0,397,73,331,13,0,0,417,205,594,15,0,0,814
WEST BENGAL,2001,36,Unemployed,2,217,229,186,12,646,0,99,110,14,0,223,2,316,339,200,12,869
WEST BENGAL,2001,36,Professional Activity,0,23,67,64,41,195,5,22,28,16,10,81,5,45,95,80,51,276
WEST BENGAL,2001,36,Agriculture (Total),8,284,279,266,98,935,13,72,133,93,0,311,21,356,412,359,98,1246
WEST BENGAL,2001,36,Retired Persons,0,0,0,8,94,102,0,0,0,17,28,45,0,0,0,25,122,147
WEST BENGAL,2002,36,House Wife,0,0,0,0,0,0,0,925,907,395,67,2294,0,925,907,395,67,2294
WEST BENGAL,2002,36,Service (Government),0,20,64,59,5,148,0,21,35,49,1,106,0,41,99,108,6,254
WEST BENGAL,2002,36,Service (Private),2,251,273,235,31,792,0,141,136,63,34,374,2,392,409,298,65,1166
WEST BENGAL,2002,36,Public Sector Undertaking,0,173,96,110,27,406,0,72,86,54,1,213,0,245,182,164,28,619
WEST BENGAL,2002,36,Students,127,251,20,1,0,399,144,118,6,0,0,268,271,369,26,1,0,667
WEST BENGAL,2002,36,Unemployed,4,274,218,145,19,660,0,150,124,13,3,290,4,424,342,158,22,950
WEST BENGAL,2002,36,Professional Activity,0,15,79,56,14,164,0,1,16,28,0,45,0,16,95,84,14,209
WEST BENGAL,2002,36,Agriculture (Total),0,321,425,302,95,1143,1,108,140,119,7,375,1,429,565,421,102,1518
WEST BENGAL,2002,36,Retired Persons,0,0,0,40,95,135,0,0,0,0,18,18,0,0,0,40,113,153
WEST BENGAL,2003,36,House Wife,0,0,0,0,0,0,0,1402,1414,980,287,4083,0,1402,1414,980,287,4083
WEST BENGAL,2003,36,Service (Government),0,74,76,52,0,202,0,7,12,9,0,28,0,81,88,61,0,230
WEST BENGAL,2003,36,Service (Private),0,221,290,226,0,737,0,26,47,22,0,95,0,247,337,248,0,832
WEST BENGAL,2003,36,Public Sector Undertaking,0,322,255,369,0,946,0,79,44,18,0,141,0,401,299,387,0,1087
WEST BENGAL,2003,36,Students,41,418,79,0,0,538,61,413,99,0,0,573,102,831,178,0,0,1111
WEST BENGAL,2003,36,Unemployed,0,392,356,9,0,757,0,87,64,0,0,151,0,479,420,9,0,908
WEST BENGAL,2003,36,Professional Activity,0,92,121,140,15,368,0,9,6,5,1,21,0,101,127,145,16,389
WEST BENGAL,2003,36,Agriculture (Total),0,201,394,260,65,920,0,51,48,16,1,116,0,252,442,276,66,1036
WEST BENGAL,2003,36,Retired Persons,0,0,0,0,241,241,0,0,0,0,7,7,0,0,0,0,248,248
WEST BENGAL,2004,36,House Wife,0,0,0,0,0,0,0,1577,1224,480,71,3352,0,1577,1224,480,71,3352
WEST BENGAL,2004,36,Service (Government),0,15,65,45,0,125,0,9,11,6,0,26,0,24,76,51,0,151
WEST BENGAL,2004,36,Service (Private),0,122,263,212,0,597,0,37,20,20,0,77,0,159,283,232,0,674
WEST BENGAL,2004,36,Public Sector Undertaking,0,162,243,246,0,651,0,13,27,26,0,66,0,175,270,272,0,717
WEST BENGAL,2004,36,Students,119,318,11,0,0,448,145,212,4,0,0,361,264,530,15,0,0,809
WEST BENGAL,2004,36,Unemployed,0,371,270,72,0,713,0,68,74,16,0,158,0,439,344,88,0,871
WEST BENGAL,2004,36,Professional Activity,0,71,70,136,9,286,0,2,4,2,1,9,0,73,74,138,10,295
WEST BENGAL,2004,36,Agriculture (Total),0,220,298,250,29,797,2,7,10,6,0,25,2,227,308,256,29,822
WEST BENGAL,2004,36,Retired Persons,0,0,0,0,218,218,0,0,0,3,10,13,0,0,0,3,228,231
WEST BENGAL,2005,36,House Wife,0,0,0,0,0,0,0,1834,1296,830,195,4155,0,1834,1296,830,195,4155
WEST BENGAL,2005,36,Service (Government),0,46,70,48,0,164,0,2,9,9,0,20,0,48,79,57,0,184
WEST BENGAL,2005,36,Service (Private),0,418,464,237,0,1119,0,94,104,47,0,245,0,512,568,284,0,1364
WEST BENGAL,2005,36,Public Sector Undertaking,0,97,222,152,0,471,0,32,12,2,0,46,0,129,234,154,0,517
WEST BENGAL,2005,36,Students,141,285,27,0,0,453,164,102,12,0,0,278,305,387,39,0,0,731
WEST BENGAL,2005,36,Unemployed,0,617,301,10,0,928,0,152,63,6,0,221,0,769,364,16,0,1149
WEST BENGAL,2005,36,Professional Activity,0,57,133,148,8,346,0,3,1,2,0,6,0,60,134,150,8,352
WEST BENGAL,2005,36,Agriculture (Total),0,233,293,282,45,853,0,12,60,30,10,112,0,245,353,312,55,965
WEST BENGAL,2005,36,Retired Persons,0,0,0,0,212,212,0,0,0,0,15,15,0,0,0,0,227,227
WEST BENGAL,2006,36,House Wife,0,0,0,0,0,0,0,2263,1584,1111,62,5020,0,2263,1584,1111,62,5020
WEST BENGAL,2006,36,Service (Government),0,20,81,62,0,163,0,8,16,12,0,36,0,28,97,74,0,199
WEST BENGAL,2006,36,Service (Private),0,93,339,256,0,688,0,36,65,29,0,130,0,129,404,285,0,818
WEST BENGAL,2006,36,Public Sector Undertaking,0,265,388,123,0,776,0,33,25,21,0,79,0,298,413,144,0,855
WEST BENGAL,2006,36,Students,146,491,2,0,0,639,184,317,1,0,0,502,330,808,3,0,0,1141
WEST BENGAL,2006,36,Unemployed,0,928,639,0,0,1567,0,144,37,0,0,181,0,1072,676,0,0,1748
WEST BENGAL,2006,36,Professional Activity,0,182,242,279,35,738,0,23,12,3,0,38,0,205,254,282,35,776
WEST BENGAL,2006,36,Agriculture (Total),0,196,455,256,56,963,0,85,105,31,5,226,0,281,560,287,61,1189
WEST BENGAL,2006,36,Retired Persons,0,0,0,0,297,297,0,0,0,0,46,46,0,0,0,0,343,343
WEST BENGAL,2007,36,House Wife,0,0,0,0,0,0,0,1541,1296,451,74,3362,0,1541,1296,451,74,3362
WEST BENGAL,2007,36,Service (Government),0,23,48,43,2,116,0,3,8,13,0,24,0,26,56,56,2,140
WEST BENGAL,2007,36,Service (Private),0,136,225,207,11,579,0,23,63,17,0,103,0,159,288,224,11,682
WEST BENGAL,2007,36,Public Sector Undertaking,0,130,327,192,6,655,0,42,24,18,0,84,0,172,351,210,6,739
WEST BENGAL,2007,36,Students,112,532,5,0,0,649,110,369,10,0,0,489,222,901,15,0,0,1138
WEST BENGAL,2007,36,Unemployed,3,321,348,129,4,805,10,137,183,32,0,362,13,458,531,161,4,1167
WEST BENGAL,2007,36,Professional Activity,0,22,118,122,1,263,0,2,1,0,0,3,0,24,119,122,1,266
WEST BENGAL,2007,36,Agriculture (Total),5,188,432,185,68,878,0,68,98,40,18,224,5,256,530,225,86,1102
WEST BENGAL,2007,36,Retired Persons,0,0,0,0,95,95,0,0,0,0,16,16,0,0,0,0,111,111
WEST BENGAL,2008,36,House Wife,0,0,0,0,0,0,0,1607,1172,406,59,3244,0,1607,1172,406,59,3244
WEST BENGAL,2008,36,Service (Government),0,17,62,41,0,120,0,4,7,14,0,25,0,21,69,55,0,145
WEST BENGAL,2008,36,Service (Private),2,122,214,190,7,535,0,29,38,16,0,83,2,151,252,206,7,618
WEST BENGAL,2008,36,Public Sector Undertaking,0,58,275,201,3,537,1,19,43,22,0,85,1,77,318,223,3,622
WEST BENGAL,2008,36,Students,112,430,13,0,0,555,118,262,5,0,0,385,230,692,18,0,0,940
WEST BENGAL,2008,36,Unemployed,9,460,471,166,5,1111,15,152,212,66,1,446,24,612,683,232,6,1557
WEST BENGAL,2008,36,Professional Activity,0,34,124,74,2,234,0,9,4,0,0,13,0,43,128,74,2,247
WEST BENGAL,2008,36,Agriculture (Total),0,161,311,159,29,660,0,33,50,12,4,99,0,194,361,171,33,759
WEST BENGAL,2008,36,Retired Persons,0,0,0,0,63,63,0,0,0,0,10,10,0,0,0,0,73,73
WEST BENGAL,2009,36,House Wife,0,0,0,0,0,0,0,1495,1256,488,66,3305,0,1495,1256,488,66,3305
WEST BENGAL,2009,36,Service (Government),0,32,94,53,0,179,0,19,26,14,1,60,0,51,120,67,1,239
WEST BENGAL,2009,36,Service (Private),0,143,241,266,6,656,0,64,80,15,1,160,0,207,321,281,7,816
WEST BENGAL,2009,36,Public Sector Undertaking,0,67,228,215,4,514,0,33,37,23,0,93,0,100,265,238,4,607
WEST BENGAL,2009,36,Students,117,313,23,0,0,453,120,279,18,0,0,417,237,592,41,0,0,870
WEST BENGAL,2009,36,Unemployed,1,448,591,108,3,1151,1,86,88,29,0,204,2,534,679,137,3,1355
WEST BENGAL,2009,36,Professional Activity,0,23,96,59,2,180,0,15,13,0,0,28,0,38,109,59,2,208
WEST BENGAL,2009,36,Agriculture (Total),1,256,402,217,53,929,4,49,52,18,2,125,5,305,454,235,55,1054
WEST BENGAL,2009,36,Retired Persons,0,0,0,0,58,58,0,0,0,0,30,30,0,0,0,0,88,88
WEST BENGAL,2010,36,House Wife,0,0,0,0,0,0,0,1271,1123,459,75,2928,0,1271,1123,459,75,2928
WEST BENGAL,2010,36,Service (Government),0,17,84,39,1,141,0,4,7,8,0,19,0,21,91,47,1,160
WEST BENGAL,2010,36,Service (Private),0,143,243,253,7,646,0,64,69,19,5,157,0,207,312,272,12,803
WEST BENGAL,2010,36,Public Sector Undertaking,0,83,264,195,2,544,0,57,44,12,11,124,0,140,308,207,13,668
WEST BENGAL,2010,36,Students,108,398,35,3,0,544,97,280,23,5,0,405,205,678,58,8,0,949
WEST BENGAL,2010,36,Unemployed,0,304,382,75,3,764,0,114,127,23,1,265,0,418,509,98,4,1029
WEST BENGAL,2010,36,Professional Activity,0,56,232,102,11,401,0,31,53,10,6,100,0,87,285,112,17,501
WEST BENGAL,2010,36,Agriculture (Total),2,218,389,164,27,800,0,63,53,57,20,193,2,281,442,221,47,993
WEST BENGAL,2010,36,Retired Persons,0,0,0,0,55,55,0,0,0,0,11,11,0,0,0,0,66,66
WEST BENGAL,2011,36,House Wife,0,0,0,0,0,0,1,1218,1171,474,91,2955,1,1218,1171,474,91,2955
WEST BENGAL,2011,36,Service (Government),0,14,66,25,1,106,0,7,5,5,0,17,0,21,71,30,1,123
WEST BENGAL,2011,36,Service (Private),0,114,235,222,1,572,0,78,66,32,0,176,0,192,301,254,1,748
WEST BENGAL,2011,36,Public Sector Undertaking,0,73,245,191,0,509,0,90,61,30,2,183,0,163,306,221,2,692
WEST BENGAL,2011,36,Students,92,426,9,0,0,527,96,404,7,0,0,507,188,830,16,0,0,1034
WEST BENGAL,2011,36,Unemployed,0,394,638,139,24,1195,0,138,163,76,6,383,0,532,801,215,30,1578
WEST BENGAL,2011,36,Professional Activity,0,43,165,151,8,367,0,16,18,13,0,47,0,59,183,164,8,414
WEST BENGAL,2011,36,Agriculture (Total),0,132,293,182,55,662,0,39,69,37,0,145,0,171,362,219,55,807
WEST BENGAL,2011,36,Retired Persons,0,0,0,0,61,61,0,0,0,0,11,11,0,0,0,0,72,72
WEST BENGAL,2012,36,House Wife,0,0,0,0,0,0,0,0,0,0,0,0,0,0,0,0,0,0
WEST BENGAL,2012,36,Service (Government),0,0,0,0,0,0,0,0,0,0,0,0,0,0,0,0,0,0
WEST BENGAL,2012,36,Service (Private),0,0,0,0,0,0,0,0,0,0,0,0,0,0,0,0,0,0
WEST BENGAL,2012,36,Public Sector Undertaking,0,0,0,0,0,0,0,0,0,0,0,0,0,0,0,0,0,0
WEST BENGAL,2012,36,Students,0,0,0,0,0,0,0,0,0,0,0,0,0,0,0,0,0,0
WEST BENGAL,2012,36,Unemployed,0,0,0,0,0,0,0,0,0,0,0,0,0,0,0,0,0,0
WEST BENGAL,2012,36,Professional Activity,0,0,0,0,0,0,0,0,0,0,0,0,0,0,0,0,0,0
WEST BENGAL,2012,36,Agriculture (Total),0,0,0,0,0,0,0,0,0,0,0,0,0,0,0,0,0,0
WEST BENGAL,2012,36,Retired Persons,0,0,0,0,0,0,0,0,0,0,0,0,0,0,0,0,0,0
WEST BENGAL,2013,36,House Wife,0,0,0,0,0,0,0,740,847,399,117,2103,0,740,847,399,117,2103
WEST BENGAL,2013,36,Service (Government),0,13,29,36,3,81,0,2,2,1,0,5,0,15,31,37,3,86
WEST BENGAL,2013,36,Service (Private),0,105,263,206,8,582,0,36,50,33,0,119,0,141,313,239,8,701
WEST BENGAL,2013,36,Public Sector Undertaking,0,115,164,67,8,354,0,28,27,15,2,72,0,143,191,82,10,426
WEST BENGAL,2013,36,Students,79,357,28,0,0,464,49,257,18,0,0,324,128,614,46,0,0,788
WEST BENGAL,2013,36,Unemployed,1,249,326,191,31,798,12,129,169,71,15,396,13,378,495,262,46,1194
WEST BENGAL,2013,36,Professional Activity,0,42,142,84,6,274,0,11,7,7,1,26,0,53,149,91,7,300
WEST BENGAL,2013,36,Agriculture (Total),0,0,0,0,0,0,0,0,0,0,0,0,0,0,0,0,0,0
WEST BENGAL,2013,36,Retired Persons,0,0,0,5,62,67,0,0,0,0,8,8,0,0,0,5,70,75
WEST BENGAL,2014,36,House Wife,0,0,0,0,0,0,0,1008,743,250,87,2088,0,1008,743,250,87,2088
WEST BENGAL,2014,36,Service (Government),0,15,37,35,0,87,0,12,9,3,0,24,0,27,46,38,0,111
WEST BENGAL,2014,36,Service (Private),0,126,178,93,1,398,0,44,43,7,2,96,0,170,221,100,3,494
WEST BENGAL,2014,36,Public Sector Undertaking,0,42,46,34,3,125,0,10,13,6,0,29,0,52,59,40,3,154
WEST BENGAL,2014,36,Students,47,330,15,3,0,395,36,275,3,0,0,314,83,605,18,3,0,709
WEST BENGAL,2014,36,Unemployed,0,398,416,156,17,987,0,73,79,21,9,182,0,471,495,177,26,1169
WEST BENGAL,2014,36,Agriculture (Total),0,54,74,56,9,193,0,20,15,2,0,37,0,74,89,58,9,230
WEST BENGAL,2014,36,Retired Persons,0,0,0,1,80,81,0,2,0,0,5,7,0,2,0,1,85,88