"","STATE.UT","Year","CAUSE","Male.upto.14.years","Male.15.29.years","Male.30.44.years","Male.45.59.years","Male.60.years.and.above","Total.Male","Female.upto.14.years","Female.15.29.years","Female.30.44.years","Female.45.59.years","Female.60.years.and.above","Total.Female","Transgender.upto.14.years","Transgender.15.29.years","Transgender.30.44.years","Transgender.45.59.years","Transgender.60.years.and.above","Total.Transgender","Grand.Total"
"1","ANDHRA PRADESH",2001,"Total",173,2058,2213,1566,369,6379,185,1871,1198,697,192,4143,0,0,0,0,0,0,10522
"2","ANDHRA PRADESH",2002,"Total",101,2173,2831,1935,531,7571,139,1804,1374,572,233,4122,0,0,0,0,0,0,11693
"3","ANDHRA PRADESH",2003,"Total",155,2270,2846,1745,497,7513,197,1685,1204,609,201,3896,0,0,0,0,0,0,11409
"4","ANDHRA PRADESH",2004,"Total",95,2562,3448,2175,802,9082,142,1959,1344,689,310,4444,0,0,0,0,0,0,13526
"5","ANDHRA PRADESH",2005,"Total",143,2444,3178,2156,944,8865,161,1904,1360,733,419,4577,0,0,0,0,0,0,13442
"6","ANDHRA PRADESH",2006,"Total",169,2696,3278,2032,688,8863,195,1987,1357,583,291,4413,0,0,0,0,0,0,13276
"7","ANDHRA PRADESH",2007,"Total",121,2936,3660,2304,928,9949,194,2139,1450,804,346,4933,0,0,0,0,0,0,14882
"8","ANDHRA PRADESH",2008,"Total",91,2714,3669,2477,770,9721,122,1882,1584,738,307,4633,0,0,0,0,0,0,14354
"9","ANDHRA PRADESH",2009,"Total",67,2727,3722,2586,785,9887,127,1934,1420,829,303,4613,0,0,0,0,0,0,14500
"10","ANDHRA PRADESH",2010,"Total",95,3530,3862,2566,894,10947,130,2145,1572,678,429,4954,0,0,0,0,0,0,15901
"11","ANDHRA PRADESH",2011,"Total",112,2828,3551,2710,919,10120,143,2284,1555,663,312,4957,0,0,0,0,0,0,15077
"12","ANDHRA PRADESH",2012,"Total",65,2543,3628,2340,951,9527,143,2046,1466,730,326,4711,0,0,0,0,0,0,14238
"13","ARUNACHAL PRADESH",2001,"Total",2,24,38,11,1,76,2,23,9,1,0,35,0,0,0,0,0,0,111
"14","ARUNACHAL PRADESH",2002,"Total",1,20,38,9,3,71,2,28,11,1,1,43,0,0,0,0,0,0,114
"15","ARUNACHAL PRADESH",2003,"Total",3,11,26,12,2,54,1,14,10,2,0,27,0,0,0,0,0,0,81
"16","ARUNACHAL PRADESH",2004,"Total",1,18,24,6,0,49,4,13,13,0,0,30,0,0,0,0,0,0,79
"17","ARUNACHAL PRADESH",2005,"Total",0,13,28,4,4,49,0,10,9,1,1,21,0,0,0,0,0,0,70
"18","ARUNACHAL PRADESH",2006,"Total",1,28,45,21,1,96,3,15,12,3,0,33,0,0,0,0,0,0,129
"19","ARUNACHAL PRADESH",2007,"Total",2,39,44,10,3,98,5,14,10,2,0,31,0,0,0,0,0,0,129
"20","ARUNACHAL PRADESH",2008,"Total",2,43,25,7,0,77,0,19,13,1,0,33,0,0,0,0,0,0,110
"21","ARUNACHAL PRADESH",2009,"Total",2,43,25,7,0,77,0,19,13,1,0,33,0,0,0,0,0,0,110
"22","ARUNACHAL PRADESH",2010,"Total",4,47,32,6,2,91,4,26,8,2,0,40,0,0,0,0,0,0,131
"23","ARUNACHAL PRADESH",2011,"Total",4,38,34,20,3,99,5,19,9,1,1,35,0,0,0,0,0,0,134
"24","ARUNACHAL PRADESH",2012,"Total",1,28,39,31,1,100,0,20,9,1,0,30,0,0,0,0,0,0,130
"25","ASSAM",2001,"Total",35,620,702,418,61,1836,19,383,274,119,16,811,0,0,0,0,0,0,2647
"26","ASSAM",2002,"Total",23,564,680,381,54,1702,24,376,275,108,25,808,0,0,0,0,0,0,2510
"27","ASSAM",2003,"Total",61,671,557,323,64,1676,48,512,225,101,34,920,0,0,0,0,0,0,2596
"28","ASSAM",2004,"Total",41,691,764,377,72,1945,18,446,296,120,14,894,0,0,0,0,0,0,2839
"29","ASSAM",2005,"Total",36,643,791,408,73,1951,37,425,299,116,18,895,0,0,0,0,0,0,2846
"30","ASSAM",2006,"Total",44,753,853,385,81,2116,32,413,348,107,15,915,0,0,0,0,0,0,3031
"31","ASSAM",2007,"Total",38,704,799,507,68,2116,33,427,331,120,35,946,0,0,0,0,0,0,3062
"32","ASSAM",2008,"Total",28,716,772,398,56,1970,17,503,360,120,19,1019,0,0,0,0,0,0,2989
"33","ASSAM",2009,"Total",27,655,712,425,63,1882,24,514,340,180,26,1084,0,0,0,0,0,0,2966
"34","ASSAM",2010,"Total",34,745,735,442,70,2026,32,489,302,122,22,967,0,0,0,0,0,0,2993
"35","ASSAM",2011,"Total",20,667,686,408,45,1826,10,410,341,126,13,900,0,0,0,0,0,0,2726
"36","ASSAM",2012,"Total",37,695,983,627,50,2392,16,362,322,163,9,872,0,0,0,0,0,0,3264
"37","BIHAR",2001,"Total",8,131,121,31,16,307,14,153,94,27,8,296,0,0,0,0,0,0,603
"38","BIHAR",2002,"Total",23,157,162,68,16,426,13,145,96,35,5,294,0,0,0,0,0,0,720
"39","BIHAR",2003,"Total",49,135,104,51,12,351,15,127,90,12,4,248,0,0,0,0,0,0,599
"40","BIHAR",2004,"Total",16,75,76,30,15,212,9,59,51,14,6,139,0,0,0,0,0,0,351
"41","BIHAR",2005,"Total",14,123,106,70,14,327,5,104,77,23,7,216,0,0,0,0,0,0,543
"42","BIHAR",2006,"Total",28,123,102,35,11,299,24,123,129,38,5,319,0,0,0,0,0,0,618
"43","BIHAR",2007,"Total",33,212,146,115,28,534,44,196,117,51,23,431,0,0,0,0,0,0,965
"44","BIHAR",2008,"Total",35,218,202,97,57,609,33,165,145,40,23,406,0,0,0,0,0,0,1015
"45","BIHAR",2009,"Total",22,202,193,75,22,514,25,228,232,41,11,537,0,0,0,0,0,0,1051
"46","BIHAR",2010,"Total",40,228,272,136,36,712,54,227,159,53,21,514,0,0,0,0,0,0,1226
"47","BIHAR",2011,"Total",16,150,163,88,29,446,41,149,126,19,14,349,0,0,0,0,0,0,795
"48","BIHAR",2012,"Total",5,155,212,63,20,455,6,135,123,29,11,304,0,0,0,0,0,0,759
"49","CHHATTISGARH",2001,"Total",44,792,955,563,286,2640,49,634,418,193,91,1385,0,0,0,0,0,0,4025
"50","CHHATTISGARH",2002,"Total",85,794,928,606,216,2629,62,594,410,182,73,1321,0,0,0,0,0,0,3950
"51","CHHATTISGARH",2003,"Total",103,846,878,554,211,2592,106,622,373,161,65,1327,0,0,0,0,0,0,3919
"52","CHHATTISGARH",2004,"Total",77,879,1057,707,266,2986,92,654,460,225,78,1509,0,0,0,0,0,0,4495
"53","CHHATTISGARH",2005,"Total",160,1062,1174,676,233,3305,73,742,465,209,87,1576,0,0,0,0,0,0,4881
"54","CHHATTISGARH",2006,"Total",112,1067,1085,590,206,3060,96,775,428,188,79,1566,0,0,0,0,0,0,4626
"55","CHHATTISGARH",2007,"Total",78,1047,1123,688,320,3256,59,731,476,232,85,1583,0,0,0,0,0,0,4839
"56","CHHATTISGARH",2008,"Total",65,1125,1156,685,217,3248,82,854,478,218,65,1697,0,0,0,0,0,0,4945
"57","CHHATTISGARH",2009,"Total",104,1225,1342,937,346,3954,76,873,587,291,102,1929,0,0,0,0,0,0,5883
"58","CHHATTISGARH",2010,"Total",110,1384,1538,1102,411,4545,58,862,647,292,118,1977,0,0,0,0,0,0,6522
"59","CHHATTISGARH",2011,"Total",102,1428,1501,1081,415,4527,86,988,638,376,141,2229,0,0,0,0,0,0,6756
"60","CHHATTISGARH",2012,"Total",83,1304,1394,919,314,4014,78,766,443,232,121,1640,0,0,0,0,0,0,5654
"61","GOA",2001,"Total",0,43,73,35,16,167,3,30,32,6,18,89,0,0,0,0,0,0,256
"62","GOA",2002,"Total",0,73,90,46,17,226,2,40,26,9,6,83,0,0,0,0,0,0,309
"63","GOA",2003,"Total",0,61,96,42,14,213,4,51,18,11,3,87,0,0,0,0,0,0,300
"64","GOA",2004,"Total",6,73,82,44,7,212,5,46,31,14,6,102,0,0,0,0,0,0,314
"65","GOA",2005,"Total",2,54,85,40,16,197,2,42,15,15,11,85,0,0,0,0,0,0,282
"66","GOA",2006,"Total",1,60,69,40,13,183,6,40,22,13,11,92,0,0,0,0,0,0,275
"67","GOA",2007,"Total",1,54,69,36,18,178,2,47,25,14,4,92,0,0,0,0,0,0,270
"68","GOA",2008,"Total",0,55,84,29,15,183,3,54,26,10,11,104,0,0,0,0,0,0,287
"69","GOA",2009,"Total",1,50,72,44,17,184,2,48,22,14,8,94,0,0,0,0,0,0,278
"70","GOA",2010,"Total",2,69,81,63,21,236,3,37,21,9,16,86,0,0,0,0,0,0,322
"71","GOA",2011,"Total",5,52,81,39,18,195,3,51,26,9,9,98,0,0,0,0,0,0,293
"72","GOA",2012,"Total",5,53,78,44,16,196,3,37,30,9,14,93,0,0,0,0,0,0,289
"73","GUJARAT",2001,"Total",40,1002,1019,452,136,2649,58,1030,657,257,140,2142,0,0,0,0,0,0,4791
"74","GUJARAT",2002,"Total",25,1022,996,518,145,2706,39,946,590,258,105,1938,0,0,0,0,0,0,4644
"75","GUJARAT",2003,"Total",22,931,996,523,178,2650,43,873,581,260,159,1916,0,0,0,0,0,0,4566
"76","GUJARAT",2004,"Total",34,988,1037,611,180,2850,29,927,604,257,109,1926,0,0,0,0,0,0,4776
"77","GUJARAT",2005,"Total",25,980,1082,623,192,2902,33,851,601,259,119,1863,0,0,0,0,0,0,4765
"78","GUJARAT",2006,"Total",30,986,1134,694,204,3048,28,925,614,298,122,1987,0,0,0,0,0,0,5035
"79","GUJARAT",2007,"Total",33,1189,1266,673,214,3375,35,1012,688,311,159,2205,0,0,0,0,0,0,5580
"80","GUJARAT",2008,"Total",25,1250,1422,787,251,3735,39,1090,786,347,168,2430,0,0,0,0,0,0,6165
"81","GUJARAT",2009,"Total",27,1255,1404,737,248,3671,30,1159,771,348,177,2485,0,0,0,0,0,0,6156
"82","GUJARAT",2010,"Total",37,1343,1412,758,263,3813,42,1105,722,367,158,2394,0,0,0,0,0,0,6207
"83","GUJARAT",2011,"Total",35,1424,1398,800,255,3912,53,1093,755,399,170,2470,0,0,0,0,0,0,6382
"84","GUJARAT",2012,"Total",52,1554,1588,882,286,4362,57,1246,844,449,152,2748,0,0,0,0,0,0,7110
"85","HARYANA",2001,"Total",34,519,499,236,76,1364,20,322,220,56,25,643,0,0,0,0,0,0,2007
"86","HARYANA",2002,"Total",36,530,623,296,85,1570,20,337,203,53,17,630,0,0,0,0,0,0,2200
"87","HARYANA",2003,"Total",34,576,602,298,103,1613,25,314,185,66,24,614,0,0,0,0,0,0,2227
"88","HARYANA",2004,"Total",34,516,544,255,105,1454,22,307,204,72,23,628,0,0,0,0,0,0,2082
"89","HARYANA",2005,"Total",28,510,608,274,73,1493,15,257,187,76,18,553,0,0,0,0,0,0,2046
"90","HARYANA",2006,"Total",25,610,701,338,92,1766,21,252,177,71,29,550,0,0,0,0,0,0,2316
"91","HARYANA",2007,"Total",28,660,720,340,104,1852,8,313,172,65,23,581,0,0,0,0,0,0,2433
"92","HARYANA",2008,"Total",47,687,774,322,144,1974,39,274,255,85,29,682,0,0,0,0,0,0,2656
"93","HARYANA",2009,"Total",38,692,659,338,88,1815,34,294,245,95,20,688,0,0,0,0,0,0,2503
"94","HARYANA",2010,"Total",24,839,738,455,122,2178,17,320,242,109,29,717,0,0,0,0,0,0,2895
"95","HARYANA",2011,"Total",70,961,885,441,107,2464,25,380,252,107,17,781,0,0,0,0,0,0,3245
"96","HARYANA",2012,"Total",43,766,737,397,128,2071,28,357,234,103,34,756,0,0,0,0,0,0,2827
"97","HIMACHAL PRADESH",2001,"Total",1,54,64,49,9,177,3,70,38,14,5,130,0,0,0,0,0,0,307
"98","HIMACHAL PRADESH",2002,"Total",4,87,82,29,6,208,3,76,37,8,2,126,0,0,0,0,0,0,334
"99","HIMACHAL PRADESH",2003,"Total",2,78,81,63,16,240,5,72,46,21,2,146,0,0,0,0,0,0,386
"100","HIMACHAL PRADESH",2004,"Total",5,77,82,54,18,236,4,71,42,14,4,135,0,0,0,0,0,0,371
"101","HIMACHAL PRADESH",2005,"Total",2,69,86,42,15,214,1,81,47,13,3,145,0,0,0,0,0,0,359
"102","HIMACHAL PRADESH",2006,"Total",4,90,121,65,21,301,1,67,43,37,8,156,0,0,0,0,0,0,457
"103","HIMACHAL PRADESH",2007,"Total",2,92,98,38,28,258,0,72,46,11,15,144,0,0,0,0,0,0,402
"104","HIMACHAL PRADESH",2008,"Total",6,140,115,116,40,417,10,103,57,25,18,213,0,0,0,0,0,0,630
"105","HIMACHAL PRADESH",2009,"Total",5,126,128,72,35,366,11,84,55,26,18,194,0,0,0,0,0,0,560
"106","HIMACHAL PRADESH",2010,"Total",8,117,125,73,25,348,4,97,51,31,11,194,0,0,0,0,0,0,542
"107","HIMACHAL PRADESH",2011,"Total",5,98,88,46,32,269,5,66,62,30,11,174,0,0,0,0,0,0,443
"108","HIMACHAL PRADESH",2012,"Total",10,112,119,72,41,354,6,75,52,26,15,174,0,0,0,0,0,0,528
"109","JAMMU & KASHMIR",2001,"Total",2,29,31,18,11,91,2,31,21,5,3,62,0,0,0,0,0,0,153
"110","JAMMU & KASHMIR",2002,"Total",4,38,36,14,4,96,0,61,21,6,0,88,0,0,0,0,0,0,184
"111","JAMMU & KASHMIR",2003,"Total",1,30,19,9,4,63,5,43,21,3,3,75,0,0,0,0,0,0,138
"112","JAMMU & KASHMIR",2004,"Total",0,27,16,8,0,51,0,29,29,3,0,61,0,0,0,0,0,0,112
"113","JAMMU & KASHMIR",2005,"Total",3,113,59,17,4,196,4,54,36,1,3,98,0,0,0,0,0,0,294
"114","JAMMU & KASHMIR",2006,"Total",1,64,56,25,6,152,0,68,33,9,0,110,0,0,0,0,0,0,262
"115","JAMMU & KASHMIR",2007,"Total",0,65,57,23,8,153,0,51,24,4,2,81,0,0,0,0,0,0,234
"116","JAMMU & KASHMIR",2008,"Total",1,56,63,41,16,177,1,80,51,1,0,133,0,0,0,0,0,0,310
"117","JAMMU & KASHMIR",2009,"Total",0,44,74,34,16,168,2,81,54,10,6,153,0,0,0,0,0,0,321
"118","JAMMU & KASHMIR",2010,"Total",3,46,40,26,7,122,3,86,39,8,1,137,0,0,0,0,0,0,259
"119","JAMMU & KASHMIR",2011,"Total",4,40,53,39,8,144,5,87,39,11,1,143,0,0,0,0,0,0,287
"120","JAMMU & KASHMIR",2012,"Total",2,56,74,40,20,192,2,101,68,19,32,222,0,0,0,0,0,0,414
"121","JHARKHAND",2001,"Total",4,45,56,26,10,141,5,50,31,23,0,109,0,0,0,0,0,0,250
"122","JHARKHAND",2002,"Total",9,45,52,36,11,153,4,47,40,28,0,119,0,0,0,0,0,0,272
"123","JHARKHAND",2003,"Total",9,45,52,36,11,153,4,47,40,28,0,119,0,0,0,0,0,0,272
"124","JHARKHAND",2004,"Total",9,72,80,61,11,233,4,65,70,45,0,184,0,0,0,0,0,0,417
"125","JHARKHAND",2005,"Total",8,181,187,133,14,523,13,112,128,28,4,285,0,0,0,0,0,0,808
"126","JHARKHAND",2006,"Total",21,190,193,95,22,521,15,158,120,38,4,335,0,0,0,0,0,0,856
"127","JHARKHAND",2007,"Total",46,261,316,197,60,880,22,178,135,54,20,409,0,0,0,0,0,0,1289
"128","JHARKHAND",2008,"Total",20,171,238,134,39,602,31,113,108,50,7,309,0,0,0,0,0,0,911
"129","JHARKHAND",2009,"Total",16,203,272,202,51,744,22,135,124,64,23,368,0,0,0,0,0,0,1112
"130","JHARKHAND",2010,"Total",84,252,275,172,12,795,16,175,142,80,24,437,0,0,0,0,0,0,1232
"131","JHARKHAND",2011,"Total",13,324,263,179,46,825,18,189,127,44,9,387,0,0,0,0,0,0,1212
"132","JHARKHAND",2012,"Total",23,297,267,198,53,838,34,217,152,70,8,481,0,0,0,0,0,0,1319
"133","KARNATAKA",2001,"Total",180,2242,2880,1836,733,7871,184,1817,1118,626,265,4010,0,0,0,0,0,0,11881
"134","KARNATAKA",2002,"Total",121,2285,3031,1832,811,8080,204,1796,1282,568,340,4190,0,0,0,0,0,0,12270
"135","KARNATAKA",2003,"Total",142,2426,2895,2002,910,8375,154,1631,1281,611,309,3986,0,0,0,0,0,0,12361
"136","KARNATAKA",2004,"Total",159,2329,2928,1862,740,8018,146,1688,1231,597,257,3919,0,0,0,0,0,0,11937
"137","KARNATAKA",2005,"Total",104,2261,2691,1952,699,7707,87,1614,1226,651,272,3850,0,0,0,0,0,0,11557
"138","KARNATAKA",2006,"Total",151,2307,2840,2025,725,8048,131,1753,1325,690,265,4164,0,0,0,0,0,0,12212
"139","KARNATAKA",2007,"Total",109,2154,2984,2419,726,8392,127,1523,1235,753,274,3912,0,0,0,0,0,0,12304
"140","KARNATAKA",2008,"Total",54,2198,2870,2303,791,8216,80,1657,1261,690,318,4006,0,0,0,0,0,0,12222
"141","KARNATAKA",2009,"Total",203,1819,2903,2331,953,8209,163,1306,1252,895,370,3986,0,0,0,0,0,0,12195
"142","KARNATAKA",2010,"Total",87,2070,2865,2388,997,8407,168,1602,1248,835,391,4244,0,0,0,0,0,0,12651
"143","KARNATAKA",2011,"Total",220,2326,3044,2099,783,8472,88,1612,1263,875,312,4150,0,0,0,0,0,0,12622
"144","KARNATAKA",2012,"Total",78,2358,3157,2240,763,8596,78,1786,1263,756,274,4157,0,0,0,0,0,0,12753
"145","KERALA",2001,"Total",43,1109,2107,2240,1288,6787,48,794,798,666,479,2785,0,0,0,0,0,0,9572
"146","KERALA",2002,"Total",54,1264,2196,2177,1474,7165,65,689,840,625,426,2645,0,0,0,0,0,0,9810
"147","KERALA",2003,"Total",50,1200,2032,2216,1437,6935,49,774,647,544,489,2503,0,0,0,0,0,0,9438
"148","KERALA",2004,"Total",48,1107,2067,2110,1266,6598,53,729,654,536,483,2455,0,0,0,0,0,0,9053
"149","KERALA",2005,"Total",46,1238,2119,2207,1220,6830,50,690,632,576,466,2414,0,0,0,0,0,0,9244
"150","KERALA",2006,"Total",54,1066,1991,2199,1273,6583,60,682,640,602,459,2443,0,0,0,0,0,0,9026
"151","KERALA",2007,"Total",48,1097,2069,2273,1101,6588,43,610,681,647,393,2374,0,0,0,0,0,0,8962
"152","KERALA",2008,"Total",26,1016,2048,2001,1039,6130,42,666,692,637,402,2439,0,0,0,0,0,0,8569
"153","KERALA",2009,"Total",38,1191,1979,2042,1072,6322,30,705,616,633,449,2433,0,0,0,0,0,0,8755
"154","KERALA",2010,"Total",64,1040,1973,2171,1098,6346,46,608,626,544,416,2240,0,0,0,0,0,0,8586
"155","KERALA",2011,"Total",29,927,1900,2209,1147,6212,36,588,660,545,390,2219,0,0,0,0,0,0,8431
"156","KERALA",2012,"Total",31,921,1976,2235,1246,6409,30,574,530,556,391,2081,0,0,0,0,0,0,8490
"157","MADHYA PRADESH",2001,"Total",130,1417,1129,570,290,3536,115,1918,812,318,161,3324,0,0,0,0,0,0,6860
"158","MADHYA PRADESH",2002,"Total",92,1455,1118,633,281,3579,90,1865,861,342,162,3320,0,0,0,0,0,0,6899
"159","MADHYA PRADESH",2003,"Total",94,1379,1214,566,285,3538,89,1879,860,271,125,3224,0,0,0,0,0,0,6762
"160","MADHYA PRADESH",2004,"Total",109,1408,1202,595,320,3634,110,1753,819,321,158,3161,0,0,0,0,0,0,6795
"161","MADHYA PRADESH",2005,"Total",83,1124,949,472,223,2851,78,1527,684,212,96,2597,0,0,0,0,0,0,5448
"162","MADHYA PRADESH",2006,"Total",96,1167,1227,714,299,3503,83,1559,890,285,115,2932,0,0,0,0,0,0,6435
"163","MADHYA PRADESH",2007,"Total",93,1313,1126,676,262,3470,112,1673,726,229,119,2859,0,0,0,0,0,0,6329
"164","MADHYA PRADESH",2008,"Total",75,1592,1501,815,382,4365,80,1833,945,305,101,3264,0,0,0,0,0,0,7629
"165","MADHYA PRADESH",2009,"Total",266,1758,1584,1088,404,5100,242,2096,1142,376,157,4013,0,0,0,0,0,0,9113
"166","MADHYA PRADESH",2010,"Total",215,1790,1668,990,424,5087,161,2075,1105,392,183,3916,0,0,0,0,0,0,9003
"167","MADHYA PRADESH",2011,"Total",156,1977,1759,916,432,5240,163,2056,1187,429,184,4019,0,0,0,0,0,0,9259
"168","MADHYA PRADESH",2012,"Total",144,1996,1988,1148,498,5774,134,2060,1114,486,207,4001,0,0,0,0,0,0,9775
"169","MAHARASHTRA",2001,"Total",128,2805,3670,1938,797,9338,133,2633,1607,617,290,5280,0,0,0,0,0,0,14618
"170","MAHARASHTRA",2002,"Total",102,2844,3670,1866,965,9447,110,2645,1483,538,306,5082,0,0,0,0,0,0,14529
"171","MAHARASHTRA",2003,"Total",99,3066,3747,2106,792,9810,92,2486,1552,561,259,4950,0,0,0,0,0,0,14760
"172","MAHARASHTRA",2004,"Total",87,3080,3738,2138,860,9903,93,2573,1353,536,271,4826,0,0,0,0,0,0,14729
"173","MAHARASHTRA",2005,"Total",75,2877,3631,2101,919,9603,79,2613,1296,549,286,4823,0,0,0,0,0,0,14426
"174","MAHARASHTRA",2006,"Total",68,3088,4042,2326,986,10510,85,2683,1366,525,325,4984,0,0,0,0,0,0,15494
"175","MAHARASHTRA",2007,"Total",42,3022,3908,2425,1023,10420,74,2618,1261,515,296,4764,0,0,0,0,0,0,15184
"176","MAHARASHTRA",2008,"Total",47,3036,3725,2247,834,9889,74,2412,1251,458,290,4485,0,0,0,0,0,0,14374
"177","MAHARASHTRA",2009,"Total",48,2901,3686,2190,960,9785,55,2387,1294,503,276,4515,0,0,0,0,0,0,14300
"178","MAHARASHTRA",2010,"Total",49,3485,3972,2363,989,10858,95,2804,1334,524,301,5058,0,0,0,0,0,0,15916
"179","MAHARASHTRA",2011,"Total",46,3477,3960,2349,1055,10887,80,2728,1422,534,296,5060,0,0,0,0,0,0,15947
"180","MAHARASHTRA",2012,"Total",73,3496,3998,2679,1058,11304,83,2531,1313,574,307,4808,0,0,0,0,0,0,16112
"181","MANIPUR",2001,"Total",1,12,5,5,1,24,0,11,5,1,0,17,0,0,0,0,0,0,41
"182","MANIPUR",2002,"Total",0,9,8,9,4,30,0,7,1,1,0,9,0,0,0,0,0,0,39
"183","MANIPUR",2003,"Total",0,9,6,3,3,21,0,4,0,0,1,5,0,0,0,0,0,0,26
"184","MANIPUR",2004,"Total",0,17,12,3,0,32,1,5,3,0,0,9,0,0,0,0,0,0,41
"185","MANIPUR",2005,"Total",0,5,17,1,0,23,0,2,2,0,0,4,0,0,0,0,0,0,27
"186","MANIPUR",2006,"Total",0,7,11,5,1,24,0,11,1,0,0,12,0,0,0,0,0,0,36
"187","MANIPUR",2007,"Total",1,7,17,3,0,28,0,4,6,1,0,11,0,0,0,0,0,0,39
"188","MANIPUR",2008,"Total",0,11,12,0,0,23,1,7,2,1,0,11,0,0,0,0,0,0,34
"189","MANIPUR",2009,"Total",0,6,11,1,0,18,0,6,3,0,0,9,0,0,0,0,0,0,27
"190","MANIPUR",2010,"Total",0,7,13,4,0,24,0,8,4,1,0,13,0,0,0,0,0,0,37
"191","MANIPUR",2011,"Total",0,6,9,3,0,18,0,12,2,1,0,15,0,0,0,0,0,0,33
"192","MANIPUR",2012,"Total",0,14,9,0,0,23,1,11,4,1,1,18,0,0,0,0,0,0,41
"193","MEGHALAYA",2001,"Total",1,22,36,5,5,69,0,11,2,3,2,18,0,0,0,0,0,0,87
"194","MEGHALAYA",2002,"Total",3,9,21,13,3,49,2,8,6,2,0,18,0,0,0,0,0,0,67
"195","MEGHALAYA",2003,"Total",3,7,14,7,1,32,1,5,2,0,1,9,0,0,0,0,0,0,41
"196","MEGHALAYA",2004,"Total",0,11,18,8,2,39,0,14,2,0,0,16,0,0,0,0,0,0,55
"197","MEGHALAYA",2005,"Total",3,16,14,10,7,50,0,13,5,2,1,21,0,0,0,0,0,0,71
"198","MEGHALAYA",2006,"Total",1,40,19,5,4,69,1,17,5,0,0,23,0,0,0,0,0,0,92
"199","MEGHALAYA",2007,"Total",1,28,21,7,3,60,0,15,12,0,0,27,0,0,0,0,0,0,87
"200","MEGHALAYA",2008,"Total",0,19,27,10,1,57,1,11,12,2,2,28,0,0,0,0,0,0,85
"201","MEGHALAYA",2009,"Total",1,24,11,27,4,67,1,18,6,17,3,45,0,0,0,0,0,0,112
"202","MEGHALAYA",2010,"Total",2,37,23,13,5,80,1,15,9,2,1,28,0,0,0,0,0,0,108
"203","MEGHALAYA",2011,"Total",4,67,25,13,2,111,1,21,13,5,2,42,0,0,0,0,0,0,153
"204","MEGHALAYA",2012,"Total",3,40,30,16,1,90,2,27,7,2,0,38,0,0,0,0,0,0,128
"205","MIZORAM",2001,"Total",7,22,10,5,2,46,0,3,2,2,1,8,0,0,0,0,0,0,54
"206","MIZORAM",2002,"Total",0,27,19,8,2,56,0,5,2,3,0,10,0,0,0,0,0,0,66
"207","MIZORAM",2003,"Total",1,18,16,6,0,41,0,3,7,1,0,11,0,0,0,0,0,0,52
"208","MIZORAM",2004,"Total",0,29,17,7,0,53,0,6,1,0,0,7,0,0,0,0,0,0,60
"209","MIZORAM",2005,"Total",2,19,20,4,2,47,0,3,4,1,0,8,0,0,0,0,0,0,55
"210","MIZORAM",2006,"Total",0,31,22,3,4,60,0,5,2,3,0,10,0,0,0,0,0,0,70
"211","MIZORAM",2007,"Total",1,9,8,2,2,22,0,1,3,2,0,6,0,0,0,0,0,0,28
"212","MIZORAM",2008,"Total",0,12,16,7,0,35,0,2,3,1,0,6,0,0,0,0,0,0,41
"213","MIZORAM",2009,"Total",1,31,25,4,1,62,0,3,2,2,0,7,0,0,0,0,0,0,69
"214","MIZORAM",2010,"Total",4,30,25,6,2,67,0,8,1,0,0,9,0,0,0,0,0,0,76
"215","MIZORAM",2011,"Total",2,37,29,7,2,77,0,5,6,2,0,13,0,0,0,0,0,0,90
"216","MIZORAM",2012,"Total",7,70,57,15,8,157,3,7,1,4,1,16,0,0,0,0,0,0,173
"217","NAGALAND",2001,"Total",0,8,15,2,0,25,0,7,5,3,0,15,0,0,0,0,0,0,40
"218","NAGALAND",2002,"Total",1,2,15,1,0,19,2,3,3,0,0,8,0,0,0,0,0,0,27
"219","NAGALAND",2003,"Total",0,6,11,0,0,17,0,5,0,0,0,5,0,0,0,0,0,0,22
"220","NAGALAND",2004,"Total",0,10,13,2,0,25,0,4,2,0,0,6,0,0,0,0,0,0,31
"221","NAGALAND",2005,"Total",0,4,13,4,0,21,0,3,3,0,0,6,0,0,0,0,0,0,27
"222","NAGALAND",2006,"Total",1,9,6,3,0,19,0,4,4,1,0,9,0,0,0,0,0,0,28
"223","NAGALAND",2007,"Total",0,4,8,5,0,17,0,3,4,0,0,7,0,0,0,0,0,0,24
"224","NAGALAND",2008,"Total",0,2,20,10,0,32,0,8,2,0,0,10,0,0,0,0,0,0,42
"225","NAGALAND",2009,"Total",2,12,7,4,0,25,0,4,2,0,0,6,0,0,0,0,0,0,31
"226","NAGALAND",2010,"Total",0,4,6,1,0,11,0,1,0,0,0,1,0,0,0,0,0,0,12
"227","NAGALAND",2011,"Total",0,6,11,8,0,25,0,6,2,0,0,8,0,0,0,0,0,0,33
"228","NAGALAND",2012,"Total",0,11,8,5,0,24,1,4,1,0,0,6,0,0,0,0,0,0,30
"229","ODISHA",2001,"Total",36,708,709,492,144,2089,62,881,679,260,81,1963,0,0,0,0,0,0,4052
"230","ODISHA",2002,"Total",55,852,945,614,165,2631,69,783,566,266,73,1757,0,0,0,0,0,0,4388
"231","ODISHA",2003,"Total",67,926,909,661,177,2740,46,802,483,281,68,1680,0,0,0,0,0,0,4420
"232","ODISHA",2004,"Total",84,747,904,616,193,2544,79,785,496,227,84,1671,0,0,0,0,0,0,4215
"233","ODISHA",2005,"Total",58,726,919,618,233,2554,60,686,572,263,73,1654,0,0,0,0,0,0,4208
"234","ODISHA",2006,"Total",43,741,870,493,226,2373,59,747,565,247,74,1692,0,0,0,0,0,0,4065
"235","ODISHA",2007,"Total",77,776,848,541,246,2488,70,878,556,243,73,1820,0,0,0,0,0,0,4308
"236","ODISHA",2008,"Total",114,1044,1021,713,263,3155,55,720,596,259,119,1749,0,0,0,0,0,0,4904
"237","ODISHA",2009,"Total",69,846,914,528,210,2567,67,783,597,265,86,1798,0,0,0,0,0,0,4365
"238","ODISHA",2010,"Total",99,797,842,533,159,2430,77,853,554,274,67,1825,0,0,0,0,0,0,4255
"239","ODISHA",2011,"Total",144,1016,1026,647,227,3060,121,872,705,356,127,2181,0,0,0,0,0,0,5241
"240","ODISHA",2012,"Total",144,867,964,679,242,2896,143,829,721,329,109,2131,0,0,0,0,0,0,5027
"241","PUNJAB",2001,"Total",1,129,64,135,67,396,0,149,66,19,18,252,0,0,0,0,0,0,648
"242","PUNJAB",2002,"Total",17,150,129,72,29,397,2,64,35,6,3,110,0,0,0,0,0,0,507
"243","PUNJAB",2003,"Total",3,214,156,92,41,506,5,56,50,10,4,125,0,0,0,0,0,0,631
"244","PUNJAB",2004,"Total",4,186,183,104,39,516,14,58,39,13,5,129,0,0,0,0,0,0,645
"245","PUNJAB",2005,"Total",0,164,167,112,39,482,2,42,40,20,2,106,0,0,0,0,0,0,588
"246","PUNJAB",2006,"Total",11,216,211,124,48,610,16,79,49,16,2,162,0,0,0,0,0,0,772
"247","PUNJAB",2007,"Total",5,236,216,117,58,632,13,112,69,17,4,215,0,0,0,0,0,0,847
"248","PUNJAB",2008,"Total",8,204,249,130,52,643,10,106,83,18,9,226,0,0,0,0,0,0,869
"249","PUNJAB",2009,"Total",11,230,220,122,52,635,5,107,61,24,15,212,0,0,0,0,0,0,847
"250","PUNJAB",2010,"Total",10,259,259,127,64,719,3,104,61,21,12,201,0,0,0,0,0,0,920
"251","PUNJAB",2011,"Total",0,274,291,125,65,755,0,116,75,15,5,211,0,0,0,0,0,0,966
"252","PUNJAB",2012,"Total",7,299,299,125,54,784,2,121,100,21,2,246,0,0,0,0,0,0,1030
"253","RAJASTHAN",2001,"Total",86,677,713,363,120,1959,61,624,387,122,42,1236,0,0,0,0,0,0,3195
"254","RAJASTHAN",2002,"Total",65,717,763,442,105,2092,30,580,373,147,26,1156,0,0,0,0,0,0,3248
"255","RAJASTHAN",2003,"Total",66,824,879,450,170,2389,36,601,410,168,57,1272,0,0,0,0,0,0,3661
"256","RAJASTHAN",2004,"Total",66,851,931,499,139,2486,43,542,427,175,52,1239,0,0,0,0,0,0,3725
"257","RAJASTHAN",2005,"Total",88,932,1125,576,137,2858,50,574,463,212,21,1320,0,0,0,0,0,0,4178
"258","RAJASTHAN",2006,"Total",59,916,1172,629,134,2910,46,609,469,186,43,1353,0,0,0,0,0,0,4263
"259","RAJASTHAN",2007,"Total",78,1063,1181,705,127,3154,36,544,466,202,35,1283,0,0,0,0,0,0,4437
"260","RAJASTHAN",2008,"Total",118,1162,1415,748,159,3602,68,658,549,230,59,1564,0,0,0,0,0,0,5166
"261","RAJASTHAN",2009,"Total",99,1160,1342,725,185,3511,62,710,548,193,41,1554,0,0,0,0,0,0,5065
"262","RAJASTHAN",2010,"Total",90,1093,1288,738,156,3365,67,701,530,221,36,1555,0,0,0,0,0,0,4920
"263","RAJASTHAN",2011,"Total",63,1149,1056,639,109,3016,27,637,463,160,45,1332,0,0,0,0,0,0,4348
"264","RAJASTHAN",2012,"Total",68,1086,1160,759,154,3227,40,741,562,191,60,1594,0,0,0,0,0,0,4821
"265","SIKKIM",2001,"Total",0,27,27,5,3,62,2,14,16,0,0,32,0,0,0,0,0,0,94
"266","SIKKIM",2002,"Total",3,15,19,11,6,54,1,11,5,5,2,24,0,0,0,0,0,0,78
"267","SIKKIM",2003,"Total",1,25,16,14,12,68,0,9,8,11,9,37,0,0,0,0,0,0,105
"268","SIKKIM",2004,"Total",0,0,17,13,26,56,0,0,9,15,18,42,0,0,0,0,0,0,98
"269","SIKKIM",2005,"Total",2,26,17,13,4,62,2,14,19,7,5,47,0,0,0,0,0,0,109
"270","SIKKIM",2006,"Total",4,49,31,14,0,98,3,26,13,1,4,47,0,0,0,0,0,0,145
"271","SIKKIM",2007,"Total",5,41,24,12,2,84,7,19,8,4,0,38,0,0,0,0,0,0,122
"272","SIKKIM",2008,"Total",2,70,69,65,10,216,0,26,26,13,6,71,0,0,0,0,0,0,287
"273","SIKKIM",2009,"Total",3,65,23,23,8,122,3,57,29,23,7,119,0,0,0,0,0,0,241
"274","SIKKIM",2010,"Total",21,98,71,30,15,235,0,13,19,10,3,45,0,0,0,0,0,0,280
"275","SIKKIM",2011,"Total",4,40,36,25,2,107,2,32,22,18,3,77,0,0,0,0,0,0,184
"276","SIKKIM",2012,"Total",5,35,26,20,10,96,6,35,30,9,5,85,0,0,0,0,0,0,181
"277","TAMIL NADU",2001,"Total",146,2115,2682,1673,512,7128,145,1702,1444,658,213,4162,0,0,0,0,0,0,11290
"278","TAMIL NADU",2002,"Total",99,1993,2552,1796,543,6983,145,1859,1318,707,232,4261,0,0,0,0,0,0,11244
"279","TAMIL NADU",2003,"Total",137,1965,2518,1841,693,7154,166,1744,1577,926,305,4718,0,0,0,0,0,0,11872
"280","TAMIL NADU",2004,"Total",190,2020,2753,2170,813,7946,176,1814,1555,1021,327,4893,0,0,0,0,0,0,12839
"281","TAMIL NADU",2005,"Total",147,1966,2707,1967,720,7507,172,1735,1365,923,374,4569,0,0,0,0,0,0,12076
"282","TAMIL NADU",2006,"Total",26,1996,2797,1935,755,7509,80,1995,1621,870,306,4872,0,0,0,0,0,0,12381
"283","TAMIL NADU",2007,"Total",30,2311,3237,2237,872,8687,83,2102,1702,918,319,5124,0,0,0,0,0,0,13811
"284","TAMIL NADU",2008,"Total",30,2563,3265,2314,871,9043,83,2215,1781,964,339,5382,0,0,0,0,0,0,14425
"285","TAMIL NADU",2009,"Total",136,2361,3174,2249,1030,8950,144,2077,1769,1019,465,5474,0,0,0,0,0,0,14424
"286","TAMIL NADU",2010,"Total",199,2966,3512,2579,1296,10552,185,2504,1794,1029,497,6009,0,0,0,0,0,0,16561
"287","TAMIL NADU",2011,"Total",159,2736,3977,2405,1005,10282,196,2419,1826,826,414,5681,0,0,0,0,0,0,15963
"288","TAMIL NADU",2012,"Total",149,2763,3896,2651,1289,10748,182,2547,1777,1114,559,6179,0,0,0,0,0,0,16927
"289","TELANGANA",2001,"Total",0,0,0,0,0,0,0,0,0,0,0,0,0,0,0,0,0,0,0
"290","TELANGANA",2002,"Total",0,0,0,0,0,0,0,0,0,0,0,0,0,0,0,0,0,0,0
"291","TELANGANA",2003,"Total",0,0,0,0,0,0,0,0,0,0,0,0,0,0,0,0,0,0,0
"292","TELANGANA",2004,"Total",0,0,0,0,0,0,0,0,0,0,0,0,0,0,0,0,0,0,0
"293","TELANGANA",2005,"Total",0,0,0,0,0,0,0,0,0,0,0,0,0,0,0,0,0,0,0
"294","TELANGANA",2006,"Total",0,0,0,0,0,0,0,0,0,0,0,0,0,0,0,0,0,0,0
"295","TELANGANA",2007,"Total",0,0,0,0,0,0,0,0,0,0,0,0,0,0,0,0,0,0,0
"296","TELANGANA",2008,"Total",0,0,0,0,0,0,0,0,0,0,0,0,0,0,0,0,0,0,0
"297","TELANGANA",2009,"Total",0,0,0,0,0,0,0,0,0,0,0,0,0,0,0,0,0,0,0
"298","TELANGANA",2010,"Total",0,0,0,0,0,0,0,0,0,0,0,0,0,0,0,0,0,0,0
"299","TELANGANA",2011,"Total",0,0,0,0,0,0,0,0,0,0,0,0,0,0,0,0,0,0,0
"300","TELANGANA",2012,"Total",0,0,0,0,0,0,0,0,0,0,0,0,0,0,0,0,0,0,0
"301","TRIPURA",2001,"Total",18,131,194,87,33,463,12,108,187,62,22,391,0,0,0,0,0,0,854
"302","TRIPURA",2002,"Total",13,173,179,102,26,493,14,127,92,38,15,286,0,0,0,0,0,0,779
"303","TRIPURA",2003,"Total",7,198,188,91,4,488,8,140,142,62,4,356,0,0,0,0,0,0,844
"304","TRIPURA",2004,"Total",5,204,134,77,13,433,22,183,105,20,7,337,0,0,0,0,0,0,770
"305","TRIPURA",2005,"Total",10,149,127,83,32,401,16,174,78,38,8,314,0,0,0,0,0,0,715
"306","TRIPURA",2006,"Total",11,145,167,78,27,428,11,168,118,34,6,337,0,0,0,0,0,0,765
"307","TRIPURA",2007,"Total",26,148,141,94,10,419,22,116,100,41,7,286,0,0,0,0,0,0,705
"308","TRIPURA",2008,"Total",9,152,167,89,25,442,14,143,96,51,6,310,0,0,0,0,0,0,752
"309","TRIPURA",2009,"Total",9,187,154,95,22,467,10,158,62,31,10,271,0,0,0,0,0,0,738
"310","TRIPURA",2010,"Total",16,127,142,91,65,441,18,108,80,49,29,284,0,0,0,0,0,0,725
"311","TRIPURA",2011,"Total",5,202,133,68,39,447,5,133,53,38,27,256,0,0,0,0,0,0,703
"312","TRIPURA",2012,"Total",16,170,211,112,51,560,15,116,85,37,31,284,0,0,0,0,0,0,844
"313","UTTAR PRADESH",2001,"Total",73,716,545,330,137,1801,63,870,537,175,70,1715,0,0,0,0,0,0,3516
"314","UTTAR PRADESH",2002,"Total",55,853,766,462,190,2326,208,859,521,240,96,1924,0,0,0,0,0,0,4250
"315","UTTAR PRADESH",2003,"Total",82,763,622,363,157,1987,74,852,430,223,97,1676,0,0,0,0,0,0,3663
"316","UTTAR PRADESH",2004,"Total",85,737,647,355,130,1954,67,922,446,184,64,1683,0,0,0,0,0,0,3637
"317","UTTAR PRADESH",2005,"Total",58,567,613,369,165,1772,59,864,473,208,73,1677,0,0,0,0,0,0,3449
"318","UTTAR PRADESH",2006,"Total",65,629,673,276,118,1761,54,737,362,120,65,1338,0,0,0,0,0,0,3099
"319","UTTAR PRADESH",2007,"Total",50,695,628,465,216,2054,69,990,557,156,101,1873,0,0,0,0,0,0,3927
"320","UTTAR PRADESH",2008,"Total",60,768,758,419,174,2179,69,1083,519,151,87,1909,0,0,0,0,0,0,4088
"321","UTTAR PRADESH",2009,"Total",51,836,765,418,169,2239,62,1069,531,161,96,1919,0,0,0,0,0,0,4158
"322","UTTAR PRADESH",2010,"Total",46,672,580,347,142,1787,58,1027,505,172,79,1841,0,0,0,0,0,0,3628
"323","UTTAR PRADESH",2011,"Total",45,967,997,518,186,2713,59,1170,616,201,84,2130,0,0,0,0,0,0,4843
"324","UTTAR PRADESH",2012,"Total",31,845,842,574,203,2495,54,989,591,218,75,1927,0,0,0,0,0,0,4422
"325","UTTARAKHAND",2001,"Total",3,41,91,42,5,182,4,72,41,10,2,129,0,0,0,0,0,0,311
"326","UTTARAKHAND",2002,"Total",8,89,60,32,16,205,8,80,50,15,3,156,0,0,0,0,0,0,361
"327","UTTARAKHAND",2003,"Total",0,111,91,55,5,262,3,77,32,14,3,129,0,0,0,0,0,0,391
"328","UTTARAKHAND",2004,"Total",8,59,53,21,7,148,2,55,22,10,0,89,0,0,0,0,0,0,237
"329","UTTARAKHAND",2005,"Total",0,76,66,29,9,180,4,54,26,9,0,93,0,0,0,0,0,0,273
"330","UTTARAKHAND",2006,"Total",0,51,70,39,13,173,5,77,55,13,3,153,0,0,0,0,0,0,326
"331","UTTARAKHAND",2007,"Total",2,53,60,14,1,130,8,63,35,8,4,118,0,0,0,0,0,0,248
"332","UTTARAKHAND",2008,"Total",8,37,35,20,4,104,3,61,15,8,0,87,0,0,0,0,0,0,191
"333","UTTARAKHAND",2009,"Total",2,77,55,57,11,202,3,79,42,15,1,140,0,0,0,0,0,0,342
"334","UTTARAKHAND",2010,"Total",4,62,57,29,12,164,7,69,30,9,2,117,0,0,0,0,0,0,281
"335","UTTARAKHAND",2011,"Total",5,69,73,34,11,192,1,69,44,10,1,125,0,0,0,0,0,0,317
"336","UTTARAKHAND",2012,"Total",7,73,106,47,16,249,9,100,47,12,7,175,0,0,0,0,0,0,424
"337","WEST BENGAL",2001,"Total",283,2027,2426,2046,713,7495,283,2254,2015,1170,473,6195,0,0,0,0,0,0,13690
"338","WEST BENGAL",2002,"Total",283,2215,2354,1711,561,7124,294,2158,1988,1084,359,5883,0,0,0,0,0,0,13007
"339","WEST BENGAL",2003,"Total",61,2396,2618,1770,579,7424,98,2282,1895,1191,390,5856,0,0,0,0,0,0,13280
"340","WEST BENGAL",2004,"Total",284,2355,2550,1909,563,7661,289,2370,1936,916,252,5763,0,0,0,0,0,0,13424
"341","WEST BENGAL",2005,"Total",214,2962,2901,2008,529,8614,205,2780,1919,1178,319,6401,0,0,0,0,0,0,15015
"342","WEST BENGAL",2006,"Total",150,3037,3475,1893,565,9120,184,2998,1913,1234,276,6605,0,0,0,0,0,0,15725
"343","WEST BENGAL",2007,"Total",217,2646,3206,1940,496,8505,202,2730,2178,1013,232,6355,0,0,0,0,0,0,14860
"344","WEST BENGAL",2008,"Total",275,2806,3327,1593,368,8369,241,3004,2160,902,176,6483,0,0,0,0,0,0,14852
"345","WEST BENGAL",2009,"Total",235,2407,3409,1980,463,8494,218,2725,2131,884,196,6154,0,0,0,0,0,0,14648
"346","WEST BENGAL",2010,"Total",268,2676,3495,2304,558,9301,212,2626,2377,1231,290,6736,0,0,0,0,0,0,16037
"347","WEST BENGAL",2011,"Total",284,2521,3792,2296,731,9624,258,2713,2326,1161,410,6868,0,0,0,0,0,0,16492
"348","WEST BENGAL",2012,"Total",0,0,0,0,0,0,0,0,0,0,0,0,0,0,0,0,0,0,0
"349","TOTAL (STATES)",2001,"Total",1479,19525,23074,15179,5841,65098,1472,18465,12713,6110,2617,41377,0,0,0,0,0,0,106475
"350","TOTAL (STATES)",2002,"Total",1282,20455,24363,15719,6269,68088,1552,17993,12509,5847,2510,40411,0,0,0,0,0,0,108499
"351","TOTAL (STATES)",2003,"Total",1252,21187,24189,15899,6378,68905,1274,17710,12169,6148,2616,39917,0,0,0,0,0,0,108822
"352","TOTAL (STATES)",2004,"Total",1447,21128,25377,16817,6587,71356,1424,18077,12244,6024,2528,40297,0,0,0,0,0,0,111653
"353","TOTAL (STATES)",2005,"Total",1311,21304,25480,16969,6520,71584,1208,17970,12031,6323,2686,40218,0,0,0,0,0,0,111802
"354","TOTAL (STATES)",2006,"Total",1176,22162,27261,17081,6523,74203,1239,18973,12681,6212,2507,41612,0,0,0,0,0,0,115815
"355","TOTAL (STATES)",2007,"Total",1167,22862,27980,18866,6924,77799,1268,19181,13073,6417,2569,42508,0,0,0,0,0,0,120307
"356","TOTAL (STATES)",2008,"Total",1146,23867,29045,18577,6578,79213,1198,19749,13856,6325,2561,43689,0,0,0,0,0,0,122902
"357","TOTAL (STATES)",2009,"Total",1483,23133,28865,19341,7215,80037,1418,19659,13950,6940,2866,44833,0,0,0,0,0,0,124870
"358","TOTAL (STATES)",2010,"Total",1615,25813,29901,20513,7845,85687,1461,20695,14182,7065,3136,46539,0,0,0,0,0,0,132226
"359","TOTAL (STATES)",2011,"Total",1552,25807,30821,20212,7673,86065,1431,20905,14615,6961,2998,46910,0,0,0,0,0,0,132975
"360","TOTAL (STATES)",2012,"Total",1089,22607,27846,18918,7473,77933,1156,17840,11889,6141,2751,39777,0,0,0,0,0,0,117710
"361","A & N ISLANDS",2001,"Total",2,25,23,21,8,79,2,31,9,5,3,50,0,0,0,0,0,0,129
"362","A & N ISLANDS",2002,"Total",2,27,28,21,13,91,2,28,14,6,3,53,0,0,0,0,0,0,144
"363","A & N ISLANDS",2003,"Total",1,23,23,17,6,70,4,28,8,2,1,43,0,0,0,0,0,0,113
"364","A & N ISLANDS",2004,"Total",0,34,24,14,9,81,1,23,13,3,1,41,0,0,0,0,0,0,122
"365","A & N ISLANDS",2005,"Total",5,15,24,25,17,86,3,27,8,10,5,53,0,0,0,0,0,0,139
"366","A & N ISLANDS",2006,"Total",4,21,34,25,12,96,1,21,10,3,2,37,0,0,0,0,0,0,133
"367","A & N ISLANDS",2007,"Total",0,36,26,27,11,100,6,30,10,8,2,56,0,0,0,0,0,0,156
"368","A & N ISLANDS",2008,"Total",0,31,32,21,14,98,0,23,13,5,4,45,0,0,0,0,0,0,143
"369","A & N ISLANDS",2009,"Total",1,31,23,25,6,86,7,19,14,4,1,45,0,0,0,0,0,0,131
"370","A & N ISLANDS",2010,"Total",4,39,33,18,18,112,0,28,11,2,3,44,0,0,0,0,0,0,156
"371","A & N ISLANDS",2011,"Total",1,28,35,20,10,94,4,19,11,6,2,42,0,0,0,0,0,0,136
"372","A & N ISLANDS",2012,"Total",2,22,26,20,10,80,1,21,12,3,4,41,0,0,0,0,0,0,121
"373","CHANDIGARH",2001,"Total",0,20,15,2,2,39,0,18,11,2,0,31,0,0,0,0,0,0,70
"374","CHANDIGARH",2002,"Total",1,23,26,3,0,53,1,23,7,1,2,34,0,0,0,0,0,0,87
"375","CHANDIGARH",2003,"Total",0,30,27,8,3,68,1,22,8,2,2,35,0,0,0,0,0,0,103
"376","CHANDIGARH",2004,"Total",0,23,21,7,1,52,0,19,2,2,0,23,0,0,0,0,0,0,75
"377","CHANDIGARH",2005,"Total",2,33,18,10,0,63,1,15,6,4,0,26,0,0,0,0,0,0,89
"378","CHANDIGARH",2006,"Total",0,26,26,3,1,56,2,14,6,1,1,24,0,0,0,0,0,0,80
"379","CHANDIGARH",2007,"Total",2,26,21,8,3,60,0,11,8,1,2,22,0,0,0,0,0,0,82
"380","CHANDIGARH",2008,"Total",0,22,19,16,1,58,0,16,7,2,0,25,0,0,0,0,0,0,83
"381","CHANDIGARH",2009,"Total",0,16,18,8,2,44,1,18,9,1,2,31,0,0,0,0,0,0,75
"382","CHANDIGARH",2010,"Total",0,14,12,4,1,31,2,25,10,2,1,40,0,0,0,0,0,0,71
"383","CHANDIGARH",2011,"Total",0,24,19,13,1,57,0,31,14,3,0,48,0,0,0,0,0,0,105
"384","CHANDIGARH",2012,"Total",2,33,31,8,1,75,1,29,8,0,1,39,0,0,0,0,0,0,114
"385","D & N HAVELI",2001,"Total",0,10,10,7,8,35,1,9,4,1,0,15,0,0,0,0,0,0,50
"386","D & N HAVELI",2002,"Total",1,9,8,9,5,32,0,11,3,2,2,18,0,0,0,0,0,0,50
"387","D & N HAVELI",2003,"Total",2,8,8,7,5,30,0,6,7,9,0,22,0,0,0,0,0,0,52
"388","D & N HAVELI",2004,"Total",0,7,6,4,3,20,0,12,5,1,1,19,0,0,0,0,0,0,39
"389","D & N HAVELI",2005,"Total",0,16,13,6,6,41,0,12,8,7,1,28,0,0,0,0,0,0,69
"390","D & N HAVELI",2006,"Total",0,8,5,3,7,23,1,8,6,2,2,19,0,0,0,0,0,0,42
"391","D & N HAVELI",2007,"Total",0,15,14,7,8,44,0,19,8,4,1,32,0,0,0,0,0,0,76
"392","D & N HAVELI",2008,"Total",1,11,11,8,1,32,0,15,6,6,1,28,0,0,0,0,0,0,60
"393","D & N HAVELI",2009,"Total",0,10,10,8,2,30,0,14,4,1,7,26,0,0,0,0,0,0,56
"394","D & N HAVELI",2010,"Total",0,14,12,6,5,37,0,18,4,4,0,26,0,0,0,0,0,0,63
"395","D & N HAVELI",2011,"Total",0,23,8,9,1,41,0,13,5,3,1,22,0,0,0,0,0,0,63
"396","D & N HAVELI",2012,"Total",0,17,16,5,3,41,0,18,2,2,3,25,0,0,0,0,0,0,66
"397","DAMAN & DIU",2001,"Total",0,4,6,0,0,10,0,4,0,0,0,4,0,0,0,0,0,0,14
"398","DAMAN & DIU",2002,"Total",0,4,9,1,1,15,0,1,1,0,0,2,0,0,0,0,0,0,17
"399","DAMAN & DIU",2003,"Total",1,7,8,2,0,18,0,3,2,1,0,6,0,0,0,0,0,0,24
"400","DAMAN & DIU",2004,"Total",0,1,3,1,0,5,0,8,0,0,0,8,0,0,0,0,0,0,13
"401","DAMAN & DIU",2005,"Total",1,10,4,10,0,25,0,5,2,0,0,7,0,0,0,0,0,0,32
"402","DAMAN & DIU",2006,"Total",0,7,5,1,1,14,3,4,1,0,0,8,0,0,0,0,0,0,22
"403","DAMAN & DIU",2007,"Total",0,3,1,2,0,6,0,7,2,0,0,9,0,0,0,0,0,0,15
"404","DAMAN & DIU",2008,"Total",0,4,4,6,0,14,0,1,0,1,3,5,0,0,0,0,0,0,19
"405","DAMAN & DIU",2009,"Total",0,8,2,3,2,15,1,1,5,1,0,8,0,0,0,0,0,0,23
"406","DAMAN & DIU",2010,"Total",3,8,6,2,0,19,0,10,2,0,0,12,0,0,0,0,0,0,31
"407","DAMAN & DIU",2011,"Total",1,7,6,4,0,18,0,13,1,1,0,15,0,0,0,0,0,0,33
"408","DAMAN & DIU",2012,"Total",0,6,13,6,0,25,1,5,5,0,0,11,0,0,0,0,0,0,36
"409","DELHI (UT)",2001,"Total",15,315,260,115,25,730,28,282,157,31,11,509,0,0,0,0,0,0,1239
"410","DELHI (UT)",2002,"Total",15,301,218,93,16,643,16,241,126,23,4,410,0,0,0,0,0,0,1053
"411","DELHI (UT)",2003,"Total",18,328,278,90,27,741,19,235,112,41,5,412,0,0,0,0,0,0,1153
"412","DELHI (UT)",2004,"Total",19,342,298,120,20,799,17,283,117,24,16,457,0,0,0,0,0,0,1256
"413","DELHI (UT)",2005,"Total",8,370,264,111,24,777,13,281,140,26,8,468,0,0,0,0,0,0,1245
"414","DELHI (UT)",2006,"Total",9,449,340,139,23,960,16,335,148,28,5,532,0,0,0,0,0,0,1492
"415","DELHI (UT)",2007,"Total",13,431,375,115,32,966,15,346,128,18,8,515,0,0,0,0,0,0,1481
"416","DELHI (UT)",2008,"Total",16,371,286,97,25,795,18,347,115,25,3,508,0,0,0,0,0,0,1303
"417","DELHI (UT)",2009,"Total",15,457,325,108,28,933,19,360,125,33,7,544,0,0,0,0,0,0,1477
"418","DELHI (UT)",2010,"Total",16,429,339,130,47,961,24,363,150,36,9,582,0,0,0,0,0,0,1543
"419","DELHI (UT)",2011,"Total",18,622,367,127,34,1168,19,343,135,38,13,548,0,0,0,0,0,0,1716
"420","DELHI (UT)",2012,"Total",26,621,426,137,36,1246,31,409,159,41,13,653,0,0,0,0,0,0,1899
"421","LAKSHADWEEP",2001,"Total",0,0,0,0,0,0,0,0,0,0,0,0,0,0,0,0,0,0,0
"422","LAKSHADWEEP",2002,"Total",0,0,0,0,0,0,0,0,0,0,0,0,0,0,0,0,0,0,0
"423","LAKSHADWEEP",2003,"Total",0,0,0,0,1,1,0,1,0,0,0,1,0,0,0,0,0,0,2
"424","LAKSHADWEEP",2004,"Total",0,0,0,0,0,0,0,0,0,0,0,0,0,0,0,0,0,0,0
"425","LAKSHADWEEP",2005,"Total",0,0,0,0,0,0,0,0,0,0,0,0,0,0,0,0,0,0,0
"426","LAKSHADWEEP",2006,"Total",0,0,1,0,0,1,0,1,0,0,0,1,0,0,0,0,0,0,2
"427","LAKSHADWEEP",2007,"Total",0,0,1,0,0,1,0,0,0,2,0,2,0,0,0,0,0,0,3
"428","LAKSHADWEEP",2008,"Total",0,0,0,0,0,0,0,0,0,0,0,0,0,0,0,0,0,0,0
"429","LAKSHADWEEP",2009,"Total",0,0,0,0,0,0,0,0,1,0,0,1,0,0,0,0,0,0,1
"430","LAKSHADWEEP",2010,"Total",0,0,0,0,0,0,0,0,1,0,0,1,0,0,0,0,0,0,1
"431","LAKSHADWEEP",2011,"Total",0,0,0,0,0,0,0,0,0,0,0,0,0,0,0,0,0,0,0
"432","LAKSHADWEEP",2012,"Total",0,0,1,0,0,1,0,0,0,0,0,0,0,0,0,0,0,0,1
"433","PUDUCHERRY",2001,"Total",2,82,115,84,40,323,6,120,51,22,7,206,0,0,0,0,0,0,529
"434","PUDUCHERRY",2002,"Total",5,98,159,109,39,410,3,74,41,23,16,157,0,0,0,0,0,0,567
"435","PUDUCHERRY",2003,"Total",4,114,146,88,36,388,0,126,32,18,18,194,0,0,0,0,0,0,582
"436","PUDUCHERRY",2004,"Total",1,82,121,102,32,338,4,97,65,20,15,201,0,0,0,0,0,0,539
"437","PUDUCHERRY",2005,"Total",1,75,129,105,30,340,2,101,56,19,20,198,0,0,0,0,0,0,538
"438","PUDUCHERRY",2006,"Total",5,84,137,93,30,349,8,103,38,15,13,177,0,0,0,0,0,0,526
"439","PUDUCHERRY",2007,"Total",2,73,133,88,23,319,6,120,52,8,12,198,0,0,0,0,0,0,517
"440","PUDUCHERRY",2008,"Total",2,90,122,94,26,334,0,105,46,9,13,173,0,0,0,0,0,0,507
"441","PUDUCHERRY",2009,"Total",2,91,92,103,38,326,4,103,45,27,13,192,0,0,0,0,0,0,518
"442","PUDUCHERRY",2010,"Total",2,70,141,95,25,333,3,99,42,12,19,175,0,0,0,0,0,0,508
"443","PUDUCHERRY",2011,"Total",2,93,144,122,35,396,7,86,34,17,17,161,0,0,0,0,0,0,557
"444","PUDUCHERRY",2012,"Total",1,92,127,103,49,372,4,73,54,20,18,169,0,0,0,0,0,0,541
"445","TOTAL (UTs)",2001,"Total",19,456,429,229,83,1216,37,464,232,61,21,815,0,0,0,0,0,0,2031
"446","TOTAL (UTs)",2002,"Total",24,462,448,236,74,1244,22,378,192,55,27,674,0,0,0,0,0,0,1918
"447","TOTAL (UTs)",2003,"Total",26,510,490,212,78,1316,24,421,169,73,26,713,0,0,0,0,0,0,2029
"448","TOTAL (UTs)",2004,"Total",20,489,473,248,65,1295,22,442,202,50,33,749,0,0,0,0,0,0,2044
"449","TOTAL (UTs)",2005,"Total",17,519,452,267,77,1332,19,441,220,66,34,780,0,0,0,0,0,0,2112
"450","TOTAL (UTs)",2006,"Total",18,595,548,264,74,1499,31,486,209,49,23,798,0,0,0,0,0,0,2297
"451","TOTAL (UTs)",2007,"Total",17,584,571,247,77,1496,27,533,208,41,25,834,0,0,0,0,0,0,2330
"452","TOTAL (UTs)",2008,"Total",19,529,474,242,67,1331,18,507,187,48,24,784,0,0,0,0,0,0,2115
"453","TOTAL (UTs)",2009,"Total",18,613,470,255,78,1434,32,515,203,67,30,847,0,0,0,0,0,0,2281
"454","TOTAL (UTs)",2010,"Total",25,574,543,255,96,1493,29,543,220,56,32,880,0,0,0,0,0,0,2373
"455","TOTAL (UTs)",2011,"Total",22,797,579,295,81,1774,30,505,200,68,33,836,0,0,0,0,0,0,2610
"456","TOTAL (UTs)",2012,"Total",31,791,640,279,99,1840,38,555,240,66,39,938,0,0,0,0,0,0,2778
"457","TOTAL (ALL INDIA)",2001,"Total",1498,19981,23503,15408,5924,66314,1509,18929,12945,6171,2638,42192,0,0,0,0,0,0,108506
"458","TOTAL (ALL INDIA)",2002,"Total",1306,20917,24811,15955,6343,69332,1574,18371,12701,5902,2537,41085,0,0,0,0,0,0,110417
"459","TOTAL (ALL INDIA)",2003,"Total",1278,21697,24679,16111,6456,70221,1298,18131,12338,6221,2642,40630,0,0,0,0,0,0,110851
"460","TOTAL (ALL INDIA)",2004,"Total",1467,21617,25850,17065,6652,72651,1446,18519,12446,6074,2561,41046,0,0,0,0,0,0,113697
"461","TOTAL (ALL INDIA)",2005,"Total",1328,21823,25932,17236,6597,72916,1227,18411,12251,6389,2720,40998,0,0,0,0,0,0,113914
"462","TOTAL (ALL INDIA)",2006,"Total",1194,22757,27809,17345,6597,75702,1270,19459,12890,6261,2530,42410,0,0,0,0,0,0,118112
"463","TOTAL (ALL INDIA)",2007,"Total",1184,23446,28551,19113,7001,79295,1295,19714,13281,6458,2594,43342,0,0,0,0,0,0,122637
"464","TOTAL (ALL INDIA)",2008,"Total",1165,24396,29519,18819,6645,80544,1216,20256,14043,6373,2585,44473,0,0,0,0,0,0,125017
"465","TOTAL (ALL INDIA)",2009,"Total",1501,23746,29335,19596,7293,81471,1450,20174,14153,7007,2896,45680,0,0,0,0,0,0,127151
"466","TOTAL (ALL INDIA)",2010,"Total",1640,26387,30444,20768,7941,87180,1490,21238,14402,7121,3168,47419,0,0,0,0,0,0,134599
"467","TOTAL (ALL INDIA)",2011,"Total",1574,26604,31400,20507,7754,87839,1461,21410,14815,7029,3031,47746,0,0,0,0,0,0,135585
"468","TOTAL (ALL INDIA)",2012,"Total",1120,23398,28486,19197,7572,79773,1194,18395,12129,6207,2790,40715,0,0,0,0,0,0,120488
"469","TOTAL (ALL INDIA)",2013,"Total",1546,26716,32099,21825,8357,90543,1345,19652,13507,6660,3092,44256,0,0,0,0,0,0,134799
"470","TOTAL (STATES)",2013,"Total",1518,25949,31396,21418,8198,88479,1316,19096,13283,6598,3058,43351,0,0,0,0,0,0,131830
"471","TOTAL (UTs)",2013,"Total",28,767,703,407,159,2064,29,556,224,62,34,905,0,0,0,0,0,0,2969
"472","ANDHRA PRADESH",2013,"Total",68,2847,3648,2439,900,9902,81,1923,1500,774,427,4705,0,0,0,0,0,0,14607
"473","ARUNACHAL PRADESH",2013,"Total",7,56,65,33,10,171,4,31,19,3,1,58,0,0,0,0,0,0,229
"474","ASSAM",2013,"Total",11,823,1090,604,30,2558,7,399,393,183,13,995,0,0,0,0,0,0,3553
"475","BIHAR",2013,"Total",26,176,253,126,49,630,47,181,160,32,7,427,0,0,0,0,0,0,1057
"476","CHHATTISGARH",2013,"Total",82,1301,1277,697,291,3648,92,865,459,250,122,1788,0,0,0,0,0,0,5436
"477","GOA",2013,"Total",0,82,80,48,20,230,5,46,32,7,8,98,0,0,0,0,0,0,328
"478","GUJARAT",2013,"Total",45,1495,1663,1007,322,4532,40,1257,756,389,192,2634,0,0,0,0,0,0,7166
"479","HARYANA",2013,"Total",58,771,871,627,175,2502,43,411,218,101,41,814,0,0,0,0,0,0,3316
"480","HIMACHAL PRADESH",2013,"Total",5,142,122,71,24,364,6,90,53,31,10,190,0,0,0,0,0,0,554
"481","JAMMU & KASHMIR",2013,"Total",1,38,69,44,16,168,3,65,52,9,5,134,0,0,0,0,0,0,302
"482","JHARKHAND",2013,"Total",50,318,295,249,72,984,22,206,151,80,17,476,0,0,0,0,0,0,1460
"483","KARNATAKA",2013,"Total",112,2199,2815,1907,700,7733,113,1471,1093,575,281,3533,0,0,0,0,0,0,11266
"484","KERALA",2013,"Total",38,1124,2073,2192,1274,6701,43,524,491,463,424,1945,0,0,0,0,0,0,8646
"485","MADHYA PRADESH",2013,"Total",191,2063,1834,1082,500,5670,158,2048,1011,381,178,3776,0,0,0,0,0,0,9446
"486","MAHARASHTRA",2013,"Total",91,3561,4367,2710,1163,11892,106,2385,1363,544,332,4730,0,0,0,0,0,0,16622
"487","MANIPUR",2013,"Total",1,7,10,3,1,22,2,10,2,1,0,15,0,0,0,0,0,0,37
"488","MEGHALAYA",2013,"Total",3,51,28,11,3,96,6,24,9,2,0,41,0,0,0,0,0,0,137
"489","MIZORAM",2013,"Total",3,44,20,11,1,79,2,7,4,3,0,16,0,0,0,0,0,0,95
"490","NAGALAND",2013,"Total",1,7,15,1,1,25,0,7,2,1,2,12,0,0,0,0,0,0,37
"491","ODISHA",2013,"Total",153,938,1040,770,371,3272,139,732,632,348,129,1980,0,0,0,0,0,0,5252
"492","PUNJAB",2013,"Total",6,292,224,131,60,713,6,151,63,27,12,259,0,0,0,0,0,0,972
"493","RAJASTHAN",2013,"Total",47,1114,1291,774,151,3377,27,612,514,268,62,1483,0,0,0,0,0,0,4860
"494","SIKKIM",2013,"Total",5,49,48,16,7,125,3,37,11,5,3,59,0,0,0,0,0,0,184
"495","TAMIL NADU",2013,"Total",190,2816,3816,3046,1314,11182,155,2286,1633,890,455,5419,0,0,0,0,0,0,16601
"496","TELANGANA",2013,"Total",0,0,0,0,0,0,0,0,0,0,0,0,0,0,0,0,0,0,0
"497","TRIPURA",2013,"Total",24,214,217,135,46,636,23,148,69,52,33,325,0,0,0,0,0,0,961
"498","UTTAR PRADESH",2013,"Total",112,1037,1126,689,199,3163,62,1107,625,272,57,2123,0,0,0,0,0,0,5286
"499","UTTARAKHAND",2013,"Total",4,94,92,43,11,244,7,59,39,13,3,121,0,0,0,0,0,0,365
"500","WEST BENGAL",2013,"Total",184,2290,2947,1952,487,7860,114,2014,1929,894,244,5195,0,0,0,0,0,0,13055
"501","A & N ISLANDS",2013,"Total",4,35,29,28,15,111,2,22,11,4,1,40,0,0,0,0,0,0,151
"502","CHANDIGARH",2013,"Total",0,28,18,11,2,59,1,26,9,2,0,38,0,0,0,0,0,0,97
"503","D & N HAVELI",2013,"Total",0,24,12,17,2,55,0,13,5,5,6,29,0,0,0,0,0,0,84
"504","DAMAN & DIU",2013,"Total",0,8,2,3,0,13,0,8,5,3,0,16,0,0,0,0,0,0,29
"505","DELHI (UT)",2013,"Total",21,588,510,198,100,1417,24,420,153,36,9,642,0,0,0,0,0,0,2059
"506","LAKSHADWEEP",2013,"Total",0,0,0,0,1,1,0,1,1,0,0,2,0,0,0,0,0,0,3
"507","PUDUCHERRY",2013,"Total",3,84,132,150,39,408,2,66,40,12,18,138,0,0,0,0,0,0,546
"508","ANDHRA PRADESH",2014,"Total",19,1432,1622,846,301,4220,36,963,550,227,104,1880,0,1,0,0,0,1,6101
"509","ARUNACHAL PRADESH",2014,"Total",4,54,34,16,2,110,2,36,7,1,0,46,0,0,0,0,0,0,156
"510","ASSAM",2014,"Total",7,1019,915,510,59,2510,4,595,313,114,10,1036,0,0,0,0,0,0,3546
"511","BIHAR",2014,"Total",11,161,134,62,54,422,4,165,101,25,2,297,0,0,0,0,0,0,719
"512","CHHATTISGARH",2014,"Total",55,1471,1222,766,249,3763,43,1039,480,245,113,1920,0,0,0,0,0,0,5683
"513","GOA",2014,"Total",1,64,68,52,18,203,2,39,23,13,11,88,0,0,0,0,0,0,291
"514","GUJARAT",2014,"Total",28,1769,1707,829,270,4603,26,1334,765,337,160,2622,0,0,0,0,0,0,7225
"515","HARYANA",2014,"Total",32,963,913,478,136,2522,18,384,192,62,25,681,0,0,0,0,0,0,3203
"516","HIMACHAL PRADESH",2014,"Total",6,154,150,64,22,396,4,114,79,38,13,248,0,0,0,0,0,0,644
"517","JAMMU & KASHMIR",2014,"Total",3,58,54,27,8,150,0,75,26,7,0,108,0,0,0,0,0,0,258
"518","JHARKHAND",2014,"Total",21,412,273,159,25,890,24,250,98,26,12,410,0,0,0,0,0,0,1300
"519","KARNATAKA",2014,"Total",54,2803,2739,1611,477,7684,39,1557,877,595,191,3259,0,1,1,0,0,2,10945
"520","KERALA",2014,"Total",30,1126,1931,1992,1333,6412,23,649,493,434,435,2034,0,0,0,0,0,0,8446
"521","MADHYA PRADESH",2014,"Total",86,2439,1665,854,297,5341,59,2273,903,327,136,3698,0,0,0,0,0,0,9039
"522","MAHARASHTRA",2014,"Total",45,3976,4284,2490,1033,11828,70,2423,1198,482,303,4476,0,2,1,0,0,3,16307
"523","MANIPUR",2014,"Total",2,12,9,7,1,31,1,13,5,0,0,19,0,0,0,0,0,0,50
"524","MEGHALAYA",2014,"Total",2,31,25,13,4,75,3,15,5,0,1,24,0,0,0,0,0,0,99
"525","MIZORAM",2014,"Total",4,41,38,12,5,100,0,11,1,3,1,16,0,0,0,0,0,0,116
"526","NAGALAND",2014,"Total",0,4,3,1,1,9,0,3,1,0,0,4,0,0,0,0,0,0,13
"527","ODISHA",2014,"Total",25,985,680,474,164,2328,36,951,515,278,52,1832,0,0,0,0,0,0,4160
"528","PUNJAB",2014,"Total",5,316,231,132,26,710,2,121,76,27,7,233,0,0,0,0,0,0,943
"529","RAJASTHAN",2014,"Total",42,1405,1115,532,141,3235,35,660,389,111,29,1224,0,0,0,0,0,0,4459
"530","SIKKIM",2014,"Total",6,62,51,33,9,161,6,36,25,12,4,83,0,0,0,0,0,0,244
"531","TAMIL NADU",2014,"Total",101,3443,3736,2655,1028,10963,171,2413,1409,766,396,5155,0,4,0,0,0,4,16122
"532","TELANGANA",2014,"Total",25,2157,2372,1495,620,6669,38,1256,851,460,349,2954,0,0,0,0,0,0,9623
"533","TRIPURA",2014,"Total",14,195,139,100,44,492,7,147,66,32,18,270,0,0,0,0,0,0,762
"534","UTTAR PRADESH",2014,"Total",43,997,708,278,73,2099,39,1016,328,76,26,1485,0,5,0,1,0,6,3590
"535","UTTARAKHAND",2014,"Total",1,104,29,11,6,151,1,37,15,3,0,56,0,0,0,0,0,0,207
"536","WEST BENGAL",2014,"Total",203,3445,3140,1547,551,8886,102,2900,1725,493,204,5424,0,0,0,0,0,0,14310
"537","A & N ISLANDS",2014,"Total",1,35,36,24,19,115,2,26,4,2,6,40,0,0,0,0,0,0,155
"538","CHANDIGARH",2014,"Total",0,31,23,11,1,66,0,28,8,3,0,39,0,0,0,0,0,0,105
"539","D & N HAVELI",2014,"Total",1,19,12,8,5,45,0,24,4,1,2,31,0,0,0,0,0,0,76
"540","DAMAN & DIU",2014,"Total",0,11,8,2,1,22,0,3,2,0,0,5,0,0,0,0,0,0,27
"541","DELHI (UT)",2014,"Total",18,731,415,205,55,1424,23,446,148,30,24,671,0,0,0,0,0,0,2095
"542","LAKSHADWEEP",2014,"Total",0,1,1,0,0,2,0,0,1,0,0,1,0,0,0,0,0,0,3
"543","PUDUCHERRY",2014,"Total",4,99,177,143,69,492,1,73,40,18,20,152,0,0,0,0,0,0,644
"544","TOTAL (STATES)",2014,"Total",875,31098,29987,18046,6957,86963,795,21475,11516,5194,2602,41582,0,13,2,1,0,16,128561
"545","TOTAL (UTs)",2014,"Total",24,927,672,393,150,2166,26,600,207,54,52,939,0,0,0,0,0,0,3105
"546","TOTAL (ALL INDIA)",2014,"Total",899,32025,30659,18439,7107,89129,821,22075,11723,5248,2654,42521,0,13,2,1,0,16,131666
